w_zip,h_zip,SE01,SE02,SE03,total
10001,10001,304,239,680,1223
10001,10002,417,367,763,1547
10001,10003,417,177,1029,1623
10001,10004,43,24,113,180
10001,10005,22,25,189,236
10001,10006,22,9,70,101
10001,10007,42,18,111,171
10001,10009,419,309,1111,1839
10001,10010,196,108,642,946
10001,10011,458,258,1336,2052
10001,10012,132,90,442,664
10001,10013,161,69,444,674
10001,10014,265,136,694,1095
10001,10016,241,174,1118,1533
10001,10017,127,45,297,469
10001,10018,143,78,185,406
10001,10019,413,210,788,1411
10001,10021,121,77,584,782
10001,10022,155,87,482,724
10001,10023,392,163,903,1458
10001,10024,384,172,923,1479
10001,10025,664,375,1184,2223
10001,10026,324,286,442,1052
10001,10027,417,402,532,1351
10001,10028,157,107,638,902
10001,10029,504,561,512,1577
10001,10030,261,208,254,723
10001,10031,490,531,531,1552
10001,10032,453,492,420,1365
10001,10033,370,353,417,1140
10001,10034,259,283,326,868
10001,10035,255,292,237,784
10001,10036,456,173,507,1136
10001,10037,131,149,153,433
10001,10038,94,102,362,558
10001,10039,268,206,150,624
10001,10040,322,280,316,918
10001,10044,46,47,109,202
10001,10065,133,67,461,661
10001,10069,28,14,75,117
10001,10075,102,54,426,582
10001,10119,1,1,5,7
10001,10128,271,194,755,1220
10001,10162,6,4,40,50
10001,10173,2,0,0,2
10001,10199,0,0,3,3
10001,10280,38,21,166,225
10001,10282,9,9,49,67
10001,10301,168,181,258,607
10001,10302,46,78,66,190
10001,10303,84,122,111,317
10001,10304,152,190,187,529
10001,10305,110,97,238,445
10001,10306,135,106,273,514
10001,10307,39,15,55,109
10001,10308,76,39,121,236
10001,10309,71,51,140,262
10001,10310,86,88,114,288
10001,10312,117,99,252,468
10001,10314,239,198,435,872
10001,10451,241,359,169,769
10001,10452,412,651,258,1321
10001,10453,390,667,234,1291
10001,10454,187,298,94,579
10001,10455,231,354,138,723
10001,10456,551,759,248,1558
10001,10457,414,585,223,1222
10001,10458,342,457,218,1017
10001,10459,227,362,170,759
10001,10460,255,409,193,857
10001,10461,156,198,252,606
10001,10462,305,383,311,999
10001,10463,238,252,354,844
10001,10464,20,17,38,75
10001,10465,139,118,178,435
10001,10466,225,306,207,738
10001,10467,385,474,322,1181
10001,10468,290,392,252,934
10001,10469,222,255,192,669
10001,10470,68,87,59,214
10001,10471,96,69,137,302
10001,10472,273,406,217,896
10001,10473,251,328,268,847
10001,10474,50,56,38,144
10001,10475,135,169,156,460
10001,11001,17,14,10,41
10001,11004,33,37,48,118
10001,11005,5,3,6,14
10001,11040,3,0,10,13
10001,11101,182,162,503,847
10001,11102,252,213,489,954
10001,11103,309,225,626,1160
10001,11104,175,158,350,683
10001,11105,285,187,472,944
10001,11106,244,230,520,994
10001,11109,23,19,171,213
10001,11201,350,254,1179,1783
10001,11203,402,620,333,1355
10001,11204,199,241,319,759
10001,11205,254,221,578,1053
10001,11206,535,519,929,1983
10001,11207,491,717,415,1623
10001,11208,404,664,314,1382
10001,11209,251,238,758,1247
10001,11210,236,377,347,960
10001,11211,440,410,1722,2572
10001,11212,442,704,281,1427
10001,11213,391,469,488,1348
10001,11214,243,282,415,940
10001,11215,418,286,1366,2070
10001,11216,413,405,916,1734
10001,11217,219,200,788,1207
10001,11218,295,277,643,1215
10001,11219,142,178,285,605
10001,11220,228,356,400,984
10001,11221,553,575,781,1909
10001,11222,301,225,971,1497
10001,11223,217,215,420,852
10001,11224,138,145,124,407
10001,11225,415,460,649,1524
10001,11226,645,922,801,2368
10001,11228,137,123,248,508
10001,11229,169,234,455,858
10001,11230,271,313,577,1161
10001,11231,174,168,633,975
10001,11232,93,116,247,456
10001,11233,415,539,409,1363
10001,11234,295,335,452,1082
10001,11235,159,184,397,740
10001,11236,381,564,376,1321
10001,11237,285,299,547,1131
10001,11238,366,328,1164,1858
10001,11239,73,55,44,172
10001,11354,200,245,235,680
10001,11355,297,305,287,889
10001,11356,56,87,84,227
10001,11357,101,78,233,412
10001,11358,110,143,215,468
10001,11359,2,1,3,6
10001,11360,32,30,97,159
10001,11361,51,71,146,268
10001,11362,30,48,91,169
10001,11363,9,19,34,62
10001,11364,75,97,177,349
10001,11365,134,141,223,498
10001,11366,34,20,86,140
10001,11367,118,127,205,450
10001,11368,329,550,331,1210
10001,11369,151,165,201,517
10001,11370,84,104,147,335
10001,11371,1,0,0,1
10001,11372,334,368,458,1160
10001,11373,366,605,443,1414
10001,11374,171,213,427,811
10001,11375,258,204,796,1258
10001,11377,415,540,731,1686
10001,11378,147,124,222,493
10001,11379,150,117,284,551
10001,11385,483,515,778,1776
10001,11411,77,90,93,260
10001,11412,120,164,110,394
10001,11413,130,202,169,501
10001,11414,76,48,157,281
10001,11415,79,69,222,370
10001,11416,82,149,114,345
10001,11417,92,158,187,437
10001,11418,122,186,239,547
10001,11419,123,306,208,637
10001,11420,131,241,233,605
10001,11421,136,218,195,549
10001,11422,130,145,136,411
10001,11423,92,148,119,359
10001,11426,32,40,77,149
10001,11427,76,62,91,229
10001,11428,68,85,91,244
10001,11429,87,135,85,307
10001,11430,1,2,3,6
10001,11432,203,249,241,693
10001,11433,106,146,107,359
10001,11434,165,264,212,641
10001,11435,169,248,251,668
10001,11436,42,86,51,179
10001,11691,165,239,142,546
10001,11692,82,130,50,262
10001,11693,45,40,68,153
10001,11694,53,36,115,204
10001,11697,18,9,22,49
10002,10001,21,26,26,73
10002,10002,894,907,469,2270
10002,10003,45,46,71,162
10002,10004,2,7,8,17
10002,10005,3,7,10,20
10002,10006,4,1,5,10
10002,10007,6,5,16,27
10002,10009,166,209,161,536
10002,10010,19,30,27,76
10002,10011,28,39,51,118
10002,10012,42,32,26,100
10002,10013,86,82,60,228
10002,10014,20,12,25,57
10002,10016,21,24,50,95
10002,10017,7,14,9,30
10002,10018,8,11,15,34
10002,10019,37,35,37,109
10002,10021,9,6,27,42
10002,10022,15,26,28,69
10002,10023,28,28,37,93
10002,10024,5,18,28,51
10002,10025,41,43,65,149
10002,10026,24,42,38,104
10002,10027,41,63,59,163
10002,10028,16,27,26,69
10002,10029,93,105,55,253
10002,10030,21,28,40,89
10002,10031,24,64,31,119
10002,10032,33,60,30,123
10002,10033,36,65,39,140
10002,10034,25,47,24,96
10002,10035,38,52,25,115
10002,10036,24,34,21,79
10002,10037,13,24,18,55
10002,10038,70,53,35,158
10002,10039,12,33,26,71
10002,10040,20,46,20,86
10002,10044,5,2,13,20
10002,10065,10,6,26,42
10002,10069,3,3,4,10
10002,10075,8,4,25,37
10002,10128,35,30,52,117
10002,10162,0,0,1,1
10002,10280,7,3,7,17
10002,10282,0,1,5,6
10002,10301,17,22,35,74
10002,10302,7,7,19,33
10002,10303,7,17,24,48
10002,10304,29,21,35,85
10002,10305,29,34,36,99
10002,10306,10,24,37,71
10002,10307,2,3,10,15
10002,10308,6,6,22,34
10002,10309,7,9,23,39
10002,10310,9,17,28,54
10002,10312,14,12,33,59
10002,10314,29,54,82,165
10002,10451,18,36,30,84
10002,10452,31,51,23,105
10002,10453,31,51,27,109
10002,10454,12,32,16,60
10002,10455,18,39,39,96
10002,10456,28,43,28,99
10002,10457,18,53,24,95
10002,10458,22,42,20,84
10002,10459,21,29,30,80
10002,10460,17,30,17,64
10002,10461,13,16,24,53
10002,10462,16,47,35,98
10002,10463,18,29,30,77
10002,10464,2,3,2,7
10002,10465,16,15,25,56
10002,10466,6,18,18,42
10002,10467,22,56,38,116
10002,10468,19,59,15,93
10002,10469,14,24,26,64
10002,10470,1,5,5,11
10002,10471,9,8,6,23
10002,10472,13,30,23,66
10002,10473,12,32,18,62
10002,10474,2,8,7,17
10002,10475,15,15,24,54
10002,11001,0,2,3,5
10002,11004,1,5,8,14
10002,11040,0,0,1,1
10002,11101,23,33,32,88
10002,11102,25,24,52,101
10002,11103,28,44,44,116
10002,11104,11,17,39,67
10002,11105,24,28,42,94
10002,11106,16,43,40,99
10002,11109,4,1,4,9
10002,11201,47,57,85,189
10002,11203,43,63,102,208
10002,11204,158,180,80,418
10002,11205,53,45,70,168
10002,11206,123,136,130,389
10002,11207,64,107,93,264
10002,11208,73,113,92,278
10002,11209,42,75,86,203
10002,11210,33,56,59,148
10002,11211,75,108,162,345
10002,11212,66,81,70,217
10002,11213,46,64,68,178
10002,11214,152,182,100,434
10002,11215,26,42,113,181
10002,11216,62,88,108,258
10002,11217,19,44,60,123
10002,11218,46,83,86,215
10002,11219,138,133,61,332
10002,11220,227,209,67,503
10002,11221,97,147,140,384
10002,11222,52,63,89,204
10002,11223,111,116,84,311
10002,11224,34,36,39,109
10002,11225,32,69,75,176
10002,11226,75,106,107,288
10002,11228,67,91,62,220
10002,11229,120,115,93,328
10002,11230,73,71,68,212
10002,11231,36,23,57,116
10002,11232,34,42,33,109
10002,11233,46,73,93,212
10002,11234,54,79,138,271
10002,11235,77,71,47,195
10002,11236,44,61,114,219
10002,11237,85,106,72,263
10002,11238,43,59,126,228
10002,11239,10,10,9,29
10002,11354,59,52,37,148
10002,11355,98,116,70,284
10002,11356,26,18,15,59
10002,11357,27,29,38,94
10002,11358,25,26,29,80
10002,11359,0,3,0,3
10002,11360,12,13,6,31
10002,11361,7,20,23,50
10002,11362,3,11,17,31
10002,11363,2,8,5,15
10002,11364,20,32,23,75
10002,11365,34,27,29,90
10002,11366,1,4,8,13
10002,11367,24,17,19,60
10002,11368,57,104,59,220
10002,11369,14,26,30,70
10002,11370,15,20,19,54
10002,11371,0,1,0,1
10002,11372,50,61,58,169
10002,11373,133,145,68,346
10002,11374,44,29,47,120
10002,11375,30,61,78,169
10002,11377,81,90,101,272
10002,11378,30,36,35,101
10002,11379,30,39,50,119
10002,11385,112,160,114,386
10002,11411,1,3,10,14
10002,11412,5,8,22,35
10002,11413,4,9,14,27
10002,11414,4,7,14,25
10002,11415,15,15,12,42
10002,11416,28,32,31,91
10002,11417,22,39,42,103
10002,11418,33,30,30,93
10002,11419,12,44,44,100
10002,11420,11,27,37,75
10002,11421,42,65,43,150
10002,11422,4,8,13,25
10002,11423,6,12,11,29
10002,11426,7,5,13,25
10002,11427,9,9,20,38
10002,11428,6,6,6,18
10002,11429,5,11,17,33
10002,11432,26,29,28,83
10002,11433,3,14,19,36
10002,11434,7,27,26,60
10002,11435,17,22,29,68
10002,11436,5,9,8,22
10002,11691,24,17,20,61
10002,11692,10,13,19,42
10002,11693,6,10,9,25
10002,11694,2,14,16,32
10002,11697,0,3,6,9
10003,10001,62,49,221,332
10003,10002,267,276,479,1022
10003,10003,411,331,1196,1938
10003,10004,17,16,47,80
10003,10005,12,28,75,115
10003,10006,9,9,37,55
10003,10007,10,9,67,86
10003,10009,319,298,830,1447
10003,10010,83,74,501,658
10003,10011,144,153,617,914
10003,10012,83,63,607,753
10003,10013,74,45,244,363
10003,10014,101,107,364,572
10003,10016,123,102,623,848
10003,10017,30,25,153,208
10003,10018,22,18,64,104
10003,10019,87,93,391,571
10003,10021,55,63,344,462
10003,10022,60,46,223,329
10003,10023,120,77,399,596
10003,10024,116,101,412,629
10003,10025,201,207,538,946
10003,10026,121,138,248,507
10003,10027,185,190,285,660
10003,10028,91,68,367,526
10003,10029,190,309,320,819
10003,10030,104,113,140,357
10003,10031,175,222,272,669
10003,10032,181,211,239,631
10003,10033,141,178,218,537
10003,10034,93,132,140,365
10003,10035,96,131,122,349
10003,10036,82,65,222,369
10003,10037,53,82,104,239
10003,10038,72,46,196,314
10003,10039,74,106,109,289
10003,10040,108,122,168,398
10003,10044,16,10,41,67
10003,10065,49,42,242,333
10003,10069,14,8,38,60
10003,10075,47,42,214,303
10003,10119,1,0,0,1
10003,10128,102,122,493,717
10003,10162,4,5,18,27
10003,10280,23,11,88,122
10003,10282,2,4,30,36
10003,10301,63,35,185,283
10003,10302,22,30,61,113
10003,10303,27,29,91,147
10003,10304,44,54,135,233
10003,10305,33,42,191,266
10003,10306,25,46,207,278
10003,10307,4,6,29,39
10003,10308,14,9,71,94
10003,10309,12,18,101,131
10003,10310,22,32,119,173
10003,10312,30,38,183,251
10003,10314,73,85,295,453
10003,10451,99,138,113,350
10003,10452,134,221,150,505
10003,10453,137,239,120,496
10003,10454,83,125,72,280
10003,10455,75,121,103,299
10003,10456,182,281,152,615
10003,10457,104,201,106,411
10003,10458,123,169,131,423
10003,10459,72,146,93,311
10003,10460,90,151,121,362
10003,10461,44,94,162,300
10003,10462,101,131,221,453
10003,10463,55,107,166,328
10003,10464,3,13,15,31
10003,10465,40,57,141,238
10003,10466,59,111,106,276
10003,10467,103,181,152,436
10003,10468,89,170,140,399
10003,10469,74,98,127,299
10003,10470,15,32,31,78
10003,10471,30,33,64,127
10003,10472,109,168,118,395
10003,10473,81,108,177,366
10003,10474,18,37,15,70
10003,10475,38,60,133,231
10003,11001,3,1,12,16
10003,11004,9,15,38,62
10003,11005,0,1,2,3
10003,11040,0,0,5,5
10003,11101,103,83,235,421
10003,11102,99,141,262,502
10003,11103,109,126,298,533
10003,11104,80,83,191,354
10003,11105,137,141,321,599
10003,11106,90,133,295,518
10003,11109,19,5,52,76
10003,11201,189,122,675,986
10003,11203,151,188,297,636
10003,11204,90,97,192,379
10003,11205,99,96,291,486
10003,11206,247,278,449,974
10003,11207,168,284,316,768
10003,11208,171,214,202,587
10003,11209,137,115,437,689
10003,11210,103,136,250,489
10003,11211,208,257,861,1326
10003,11212,123,188,203,514
10003,11213,137,163,270,570
10003,11214,130,137,260,527
10003,11215,163,176,788,1127
10003,11216,172,216,457,845
10003,11217,91,94,393,578
10003,11218,115,147,359,621
10003,11219,83,98,111,292
10003,11220,169,188,299,656
10003,11221,250,328,438,1016
10003,11222,115,106,404,625
10003,11223,86,91,207,384
10003,11224,34,51,105,190
10003,11225,143,199,416,758
10003,11226,239,328,488,1055
10003,11228,76,64,180,320
10003,11229,93,118,294,505
10003,11230,124,115,292,531
10003,11231,75,80,352,507
10003,11232,65,66,124,255
10003,11233,190,247,285,722
10003,11234,116,163,431,710
10003,11235,58,86,239,383
10003,11236,131,179,335,645
10003,11237,156,215,323,694
10003,11238,157,164,669,990
10003,11239,27,31,46,104
10003,11354,87,97,123,307
10003,11355,177,130,153,460
10003,11356,23,33,74,130
10003,11357,41,42,146,229
10003,11358,51,41,108,200
10003,11359,1,2,0,3
10003,11360,10,13,55,78
10003,11361,26,21,70,117
10003,11362,17,14,42,73
10003,11363,2,2,13,17
10003,11364,32,26,81,139
10003,11365,47,35,94,176
10003,11366,14,6,43,63
10003,11367,38,42,99,179
10003,11368,148,228,164,540
10003,11369,36,105,115,256
10003,11370,32,59,98,189
10003,11371,0,1,0,1
10003,11372,119,185,312,616
10003,11373,249,352,309,910
10003,11374,77,69,239,385
10003,11375,138,113,459,710
10003,11377,191,319,379,889
10003,11378,63,95,129,287
10003,11379,53,79,186,318
10003,11385,237,314,470,1021
10003,11411,25,36,69,130
10003,11412,30,35,61,126
10003,11413,51,46,96,193
10003,11414,21,27,85,133
10003,11415,34,49,105,188
10003,11416,38,52,69,159
10003,11417,54,64,90,208
10003,11418,58,82,96,236
10003,11419,53,78,104,235
10003,11420,57,59,133,249
10003,11421,79,92,123,294
10003,11422,34,32,102,168
10003,11423,23,44,60,127
10003,11426,23,12,44,79
10003,11427,24,22,53,99
10003,11428,13,29,47,89
10003,11429,21,47,68,136
10003,11430,0,3,1,4
10003,11432,72,69,138,279
10003,11433,28,35,48,111
10003,11434,36,65,105,206
10003,11435,49,76,163,288
10003,11436,13,14,27,54
10003,11691,48,65,73,186
10003,11692,19,31,32,82
10003,11693,12,13,36,61
10003,11694,28,20,56,104
10003,11697,3,4,16,23
10004,10001,15,31,158,204
10004,10002,131,199,359,689
10004,10003,33,40,442,515
10004,10004,13,11,159,183
10004,10005,7,16,255,278
10004,10006,5,4,79,88
10004,10007,1,7,89,97
10004,10009,53,100,436,589
10004,10010,15,33,269,317
10004,10011,20,50,444,514
10004,10012,13,23,189,225
10004,10013,15,42,216,273
10004,10014,18,20,266,304
10004,10016,12,32,479,523
10004,10017,10,8,180,198
10004,10018,13,11,69,93
10004,10019,21,57,355,433
10004,10021,23,23,304,350
10004,10022,12,23,274,309
10004,10023,28,31,438,497
10004,10024,27,40,367,434
10004,10025,71,89,519,679
10004,10026,41,72,164,277
10004,10027,85,91,161,337
10004,10028,20,26,388,434
10004,10029,100,156,208,464
10004,10030,30,66,79,175
10004,10031,86,156,174,416
10004,10032,81,156,126,363
10004,10033,62,118,134,314
10004,10034,48,106,101,255
10004,10035,62,83,86,231
10004,10036,15,50,199,264
10004,10037,26,27,74,127
10004,10038,16,31,276,323
10004,10039,22,49,55,126
10004,10040,60,116,118,294
10004,10044,1,8,38,47
10004,10065,12,17,179,208
10004,10069,7,4,53,64
10004,10075,5,13,198,216
10004,10103,0,0,1,1
10004,10119,0,0,1,1
10004,10128,23,34,473,530
10004,10162,1,1,12,14
10004,10280,6,13,197,216
10004,10282,2,2,50,54
10004,10301,39,81,204,324
10004,10302,14,22,74,110
10004,10303,26,45,81,152
10004,10304,32,103,186,321
10004,10305,27,68,224,319
10004,10306,32,67,317,416
10004,10307,4,19,69,92
10004,10308,13,31,204,248
10004,10309,19,35,182,236
10004,10310,24,34,95,153
10004,10312,24,60,329,413
10004,10314,48,107,418,573
10004,10451,54,115,71,240
10004,10452,101,237,91,429
10004,10453,125,210,93,428
10004,10454,43,102,38,183
10004,10455,56,104,48,208
10004,10456,130,229,109,468
10004,10457,111,175,77,363
10004,10458,74,131,65,270
10004,10459,61,93,48,202
10004,10460,66,118,68,252
10004,10461,26,44,103,173
10004,10462,59,104,154,317
10004,10463,53,62,142,257
10004,10464,1,2,10,13
10004,10465,23,37,97,157
10004,10466,47,70,86,203
10004,10467,62,134,124,320
10004,10468,72,112,110,294
10004,10469,46,68,94,208
10004,10470,10,21,25,56
10004,10471,13,21,47,81
10004,10472,69,141,76,286
10004,10473,48,86,121,255
10004,10474,11,23,16,50
10004,10475,21,54,98,173
10004,11001,0,2,21,23
10004,11004,8,7,32,47
10004,11005,1,0,11,12
10004,11040,0,1,5,6
10004,11101,21,42,174,237
10004,11102,30,43,185,258
10004,11103,27,51,195,273
10004,11104,7,28,134,169
10004,11105,17,38,200,255
10004,11106,29,34,225,288
10004,11109,3,3,62,68
10004,11201,53,63,760,876
10004,11203,84,162,199,445
10004,11204,69,132,175,376
10004,11205,27,61,206,294
10004,11206,59,168,255,482
10004,11207,110,215,200,525
10004,11208,110,193,156,459
10004,11209,49,87,496,632
10004,11210,47,107,208,362
10004,11211,47,72,559,678
10004,11212,106,242,129,477
10004,11213,62,134,217,413
10004,11214,71,197,313,581
10004,11215,26,62,722,810
10004,11216,56,100,355,511
10004,11217,27,79,356,462
10004,11218,49,104,276,429
10004,11219,44,108,130,282
10004,11220,62,165,217,444
10004,11221,69,151,337,557
10004,11222,21,39,256,316
10004,11223,46,159,253,458
10004,11224,59,116,101,276
10004,11225,59,130,304,493
10004,11226,136,235,314,685
10004,11228,47,71,181,299
10004,11229,73,133,319,525
10004,11230,52,126,273,451
10004,11231,18,45,230,293
10004,11232,18,49,85,152
10004,11233,63,134,214,411
10004,11234,67,134,364,565
10004,11235,74,143,278,495
10004,11236,82,175,214,471
10004,11237,31,81,144,256
10004,11238,39,71,442,552
10004,11239,10,21,34,65
10004,11354,38,39,133,210
10004,11355,32,81,154,267
10004,11356,6,15,58,79
10004,11357,14,19,136,169
10004,11358,9,31,88,128
10004,11359,1,0,1,2
10004,11360,10,8,61,79
10004,11361,6,13,67,86
10004,11362,2,8,44,54
10004,11363,2,6,21,29
10004,11364,8,17,89,114
10004,11365,18,29,111,158
10004,11366,2,10,45,57
10004,11367,18,33,90,141
10004,11368,59,154,130,343
10004,11369,26,55,82,163
10004,11370,16,33,54,103
10004,11371,0,0,1,1
10004,11372,44,82,200,326
10004,11373,72,123,204,399
10004,11374,19,53,209,281
10004,11375,20,61,423,504
10004,11377,48,121,245,414
10004,11378,13,39,107,159
10004,11379,11,25,173,209
10004,11385,43,138,370,551
10004,11411,8,17,53,78
10004,11412,27,35,80,142
10004,11413,26,45,106,177
10004,11414,14,18,122,154
10004,11415,12,23,90,125
10004,11416,16,45,85,146
10004,11417,8,44,79,131
10004,11418,19,45,81,145
10004,11419,19,55,97,171
10004,11420,22,63,133,218
10004,11421,31,69,123,223
10004,11422,20,42,82,144
10004,11423,18,30,96,144
10004,11426,3,8,54,65
10004,11427,7,15,63,85
10004,11428,9,20,48,77
10004,11429,5,29,49,83
10004,11430,2,0,1,3
10004,11432,47,72,120,239
10004,11433,25,41,46,112
10004,11434,28,75,131,234
10004,11435,36,65,107,208
10004,11436,6,19,31,56
10004,11691,21,62,69,152
10004,11692,12,24,24,60
10004,11693,6,18,47,71
10004,11694,5,10,68,83
10004,11697,1,6,21,28
10005,10001,12,18,109,139
10005,10002,49,77,266,392
10005,10003,19,21,288,328
10005,10004,4,7,105,116
10005,10005,18,21,234,273
10005,10006,0,4,71,75
10005,10007,5,1,60,66
10005,10009,33,34,297,364
10005,10010,9,15,183,207
10005,10011,24,32,364,420
10005,10012,14,9,100,123
10005,10013,9,12,145,166
10005,10014,6,21,204,231
10005,10016,20,34,335,389
10005,10017,10,7,104,121
10005,10018,4,2,42,48
10005,10019,30,26,237,293
10005,10021,10,19,173,202
10005,10022,12,13,190,215
10005,10023,20,18,318,356
10005,10024,21,24,258,303
10005,10025,37,64,350,451
10005,10026,18,29,104,151
10005,10027,35,36,145,216
10005,10028,25,15,228,268
10005,10029,63,55,167,285
10005,10030,22,46,53,121
10005,10031,47,56,129,232
10005,10032,45,43,74,162
10005,10033,42,40,79,161
10005,10034,29,34,86,149
10005,10035,22,27,67,116
10005,10036,13,20,151,184
10005,10037,9,12,54,75
10005,10038,23,23,286,332
10005,10039,20,30,40,90
10005,10040,22,40,58,120
10005,10044,3,19,35,57
10005,10065,10,13,159,182
10005,10069,2,1,34,37
10005,10075,4,9,123,136
10005,10119,0,0,2,2
10005,10128,21,23,321,365
10005,10162,0,0,13,13
10005,10280,3,2,130,135
10005,10282,2,0,26,28
10005,10301,24,29,113,166
10005,10302,23,5,48,76
10005,10303,34,19,61,114
10005,10304,36,33,130,199
10005,10305,32,40,112,184
10005,10306,36,56,233,325
10005,10307,6,11,36,53
10005,10308,10,21,113,144
10005,10309,10,14,109,133
10005,10310,17,20,70,107
10005,10312,27,34,249,310
10005,10314,43,57,269,369
10005,10451,32,46,60,138
10005,10452,72,93,69,234
10005,10453,61,86,56,203
10005,10454,37,45,39,121
10005,10455,41,43,30,114
10005,10456,74,91,48,213
10005,10457,77,71,37,185
10005,10458,47,63,43,153
10005,10459,33,41,43,117
10005,10460,49,66,37,152
10005,10461,24,31,79,134
10005,10462,43,68,98,209
10005,10463,30,37,104,171
10005,10464,2,2,6,10
10005,10465,13,7,69,89
10005,10466,33,57,44,134
10005,10467,54,73,59,186
10005,10468,49,48,72,169
10005,10469,31,66,48,145
10005,10470,9,7,13,29
10005,10471,8,12,38,58
10005,10472,41,50,49,140
10005,10473,32,61,70,163
10005,10474,4,3,7,14
10005,10475,19,45,52,116
10005,11001,1,2,15,18
10005,11004,4,5,29,38
10005,11005,1,0,0,1
10005,11040,2,1,2,5
10005,11101,15,27,118,160
10005,11102,16,24,112,152
10005,11103,14,31,116,161
10005,11104,12,19,117,148
10005,11105,18,30,134,182
10005,11106,23,37,135,195
10005,11109,1,1,42,44
10005,11201,30,35,559,624
10005,11203,75,102,133,310
10005,11204,19,51,146,216
10005,11205,18,35,146,199
10005,11206,69,80,165,314
10005,11207,74,95,105,274
10005,11208,70,98,93,261
10005,11209,38,46,327,411
10005,11210,45,65,127,237
10005,11211,59,59,329,447
10005,11212,83,109,84,276
10005,11213,53,105,133,291
10005,11214,30,71,205,306
10005,11215,16,34,399,449
10005,11216,29,63,202,294
10005,11217,25,31,267,323
10005,11218,28,51,190,269
10005,11219,39,44,60,143
10005,11220,38,53,126,217
10005,11221,60,75,200,335
10005,11222,12,25,175,212
10005,11223,19,83,124,226
10005,11224,44,103,59,206
10005,11225,52,66,188,306
10005,11226,70,129,199,398
10005,11228,16,19,121,156
10005,11229,36,88,199,323
10005,11230,30,62,200,292
10005,11231,4,20,186,210
10005,11232,15,17,75,107
10005,11233,48,69,125,242
10005,11234,59,89,261,409
10005,11235,55,110,203,368
10005,11236,50,96,159,305
10005,11237,21,33,89,143
10005,11238,19,53,346,418
10005,11239,5,13,9,27
10005,11354,24,17,62,103
10005,11355,28,52,93,173
10005,11356,8,18,24,50
10005,11357,21,15,86,122
10005,11358,8,12,61,81
10005,11359,0,0,1,1
10005,11360,4,4,40,48
10005,11361,9,9,52,70
10005,11362,3,6,32,41
10005,11363,4,2,15,21
10005,11364,7,16,55,78
10005,11365,17,18,93,128
10005,11366,6,10,35,51
10005,11367,19,13,79,111
10005,11368,54,66,99,219
10005,11369,13,19,41,73
10005,11370,14,28,49,91
10005,11372,23,44,129,196
10005,11373,54,96,130,280
10005,11374,21,30,154,205
10005,11375,18,31,309,358
10005,11377,46,77,166,289
10005,11378,15,22,67,104
10005,11379,8,22,86,116
10005,11385,47,79,215,341
10005,11411,13,25,33,71
10005,11412,21,44,62,127
10005,11413,24,29,51,104
10005,11414,6,12,58,76
10005,11415,4,12,64,80
10005,11416,17,35,51,103
10005,11417,20,29,50,99
10005,11418,17,38,72,127
10005,11419,25,61,78,164
10005,11420,22,49,74,145
10005,11421,25,51,66,142
10005,11422,25,27,34,86
10005,11423,18,29,54,101
10005,11426,0,10,25,35
10005,11427,8,13,41,62
10005,11428,5,6,23,34
10005,11429,15,11,38,64
10005,11430,2,1,0,3
10005,11432,48,47,97,192
10005,11433,15,24,32,71
10005,11434,42,79,77,198
10005,11435,34,63,92,189
10005,11436,11,16,25,52
10005,11691,16,38,49,103
10005,11692,8,19,22,49
10005,11693,8,10,23,41
10005,11694,6,16,55,77
10005,11697,1,4,17,22
10006,10001,9,12,56,77
10006,10002,17,32,134,183
10006,10003,16,17,154,187
10006,10004,4,8,44,56
10006,10005,1,10,44,55
10006,10006,5,12,39,56
10006,10007,1,0,39,40
10006,10009,11,29,107,147
10006,10010,2,13,84,99
10006,10011,10,13,162,185
10006,10012,2,9,68,79
10006,10013,6,9,61,76
10006,10014,5,2,86,93
10006,10016,7,8,143,158
10006,10017,3,2,43,48
10006,10018,5,5,19,29
10006,10019,13,14,139,166
10006,10021,1,11,68,80
10006,10022,3,5,45,53
10006,10023,8,10,151,169
10006,10024,10,11,118,139
10006,10025,31,23,165,219
10006,10026,17,11,44,72
10006,10027,29,30,66,125
10006,10028,9,4,106,119
10006,10029,44,34,77,155
10006,10030,12,14,22,48
10006,10031,17,22,49,88
10006,10032,37,30,39,106
10006,10033,12,31,59,102
10006,10034,12,15,40,67
10006,10035,21,17,37,75
10006,10036,14,11,55,80
10006,10037,5,8,17,30
10006,10038,6,8,91,105
10006,10039,17,16,19,52
10006,10040,25,19,36,80
10006,10044,1,0,18,19
10006,10065,8,10,68,86
10006,10069,0,0,17,17
10006,10075,4,14,53,71
10006,10128,2,12,140,154
10006,10162,0,1,5,6
10006,10280,3,7,60,70
10006,10282,0,2,20,22
10006,10301,7,20,56,83
10006,10302,1,1,16,18
10006,10303,6,5,20,31
10006,10304,6,13,38,57
10006,10305,9,18,54,81
10006,10306,6,13,78,97
10006,10307,1,2,15,18
10006,10308,1,13,37,51
10006,10309,4,9,46,59
10006,10310,4,4,32,40
10006,10312,9,8,80,97
10006,10314,9,14,121,144
10006,10451,34,35,17,86
10006,10452,68,53,29,150
10006,10453,51,41,15,107
10006,10454,18,29,8,55
10006,10455,23,28,10,61
10006,10456,50,67,24,141
10006,10457,44,41,16,101
10006,10458,35,29,21,85
10006,10459,45,31,13,89
10006,10460,23,23,15,61
10006,10461,13,18,23,54
10006,10462,24,30,33,87
10006,10463,27,25,58,110
10006,10464,1,0,3,4
10006,10465,10,6,21,37
10006,10466,26,11,22,59
10006,10467,31,29,41,101
10006,10468,33,29,29,91
10006,10469,20,14,21,55
10006,10470,6,2,4,12
10006,10471,8,9,20,37
10006,10472,20,27,30,77
10006,10473,25,24,30,79
10006,10474,8,13,4,25
10006,10475,11,12,18,41
10006,11001,0,1,1,2
10006,11004,0,3,6,9
10006,11101,8,5,61,74
10006,11102,12,17,41,70
10006,11103,12,9,82,103
10006,11104,8,12,54,74
10006,11105,13,14,64,91
10006,11106,12,9,46,67
10006,11109,5,1,24,30
10006,11201,21,23,258,302
10006,11203,16,32,54,102
10006,11204,11,25,57,93
10006,11205,10,17,73,100
10006,11206,23,46,83,152
10006,11207,17,41,57,115
10006,11208,25,39,46,110
10006,11209,13,23,147,183
10006,11210,14,32,65,111
10006,11211,19,20,161,200
10006,11212,29,44,36,109
10006,11213,19,25,73,117
10006,11214,11,24,100,135
10006,11215,13,18,226,257
10006,11216,22,22,132,176
10006,11217,15,11,141,167
10006,11218,9,27,87,123
10006,11219,11,11,39,61
10006,11220,14,41,81,136
10006,11221,15,42,87,144
10006,11222,13,11,108,132
10006,11223,10,20,65,95
10006,11224,7,13,40,60
10006,11225,27,23,94,144
10006,11226,27,41,125,193
10006,11228,9,10,51,70
10006,11229,15,17,65,97
10006,11230,14,28,89,131
10006,11231,9,14,103,126
10006,11232,4,13,31,48
10006,11233,21,24,74,119
10006,11234,27,25,94,146
10006,11235,12,34,76,122
10006,11236,16,32,58,106
10006,11237,12,14,52,78
10006,11238,17,13,143,173
10006,11239,6,3,5,14
10006,11354,8,17,36,61
10006,11355,13,8,35,56
10006,11356,2,1,22,25
10006,11357,1,4,34,39
10006,11358,4,12,16,32
10006,11359,1,0,2,3
10006,11360,3,0,32,35
10006,11361,1,8,15,24
10006,11362,0,4,11,15
10006,11363,0,2,3,5
10006,11364,1,2,25,28
10006,11365,5,7,37,49
10006,11366,2,3,7,12
10006,11367,6,11,23,40
10006,11368,29,38,34,101
10006,11369,8,17,14,39
10006,11370,4,12,21,37
10006,11372,15,28,61,104
10006,11373,28,35,68,131
10006,11374,5,14,53,72
10006,11375,9,15,98,122
10006,11377,17,24,87,128
10006,11378,7,9,40,56
10006,11379,1,11,40,52
10006,11385,22,38,116,176
10006,11411,3,2,12,17
10006,11412,4,9,10,23
10006,11413,8,2,23,33
10006,11414,3,2,22,27
10006,11415,9,7,25,41
10006,11416,5,13,15,33
10006,11417,7,12,29,48
10006,11418,9,12,23,44
10006,11419,4,24,19,47
10006,11420,4,24,26,54
10006,11421,9,4,31,44
10006,11422,2,5,12,19
10006,11423,3,11,14,28
10006,11426,2,1,11,14
10006,11427,2,4,16,22
10006,11428,2,5,5,12
10006,11429,3,5,12,20
10006,11432,3,15,34,52
10006,11433,7,5,10,22
10006,11434,6,7,16,29
10006,11435,13,12,17,42
10006,11436,0,1,6,7
10006,11691,8,12,23,43
10006,11692,4,2,11,17
10006,11693,5,2,14,21
10006,11694,0,1,13,14
10006,11697,0,0,1,1
10007,10001,23,25,70,118
10007,10002,84,90,228,402
10007,10003,25,15,194,234
10007,10004,7,6,35,48
10007,10005,2,5,57,64
10007,10006,1,3,29,33
10007,10007,11,21,84,116
10007,10009,43,57,181,281
10007,10010,9,13,96,118
10007,10011,21,21,176,218
10007,10012,12,21,68,101
10007,10013,24,40,115,179
10007,10014,15,14,109,138
10007,10016,18,28,157,203
10007,10017,6,6,62,74
10007,10018,9,9,32,50
10007,10019,20,29,123,172
10007,10021,20,6,132,158
10007,10022,3,11,79,93
10007,10023,20,22,199,241
10007,10024,14,14,168,196
10007,10025,67,71,229,367
10007,10026,37,34,90,161
10007,10027,57,69,138,264
10007,10028,18,14,135,167
10007,10029,76,117,170,363
10007,10030,49,45,45,139
10007,10031,43,120,102,265
10007,10032,55,89,90,234
10007,10033,39,66,70,175
10007,10034,30,69,71,170
10007,10035,37,76,70,183
10007,10036,20,15,71,106
10007,10037,23,27,54,104
10007,10038,27,33,112,172
10007,10039,30,46,51,127
10007,10040,38,70,75,183
10007,10044,4,6,16,26
10007,10065,12,9,67,88
10007,10069,4,5,17,26
10007,10075,3,6,76,85
10007,10128,24,25,187,236
10007,10162,0,1,4,5
10007,10280,12,7,75,94
10007,10282,3,1,17,21
10007,10301,30,31,144,205
10007,10302,10,11,56,77
10007,10303,17,17,96,130
10007,10304,21,40,106,167
10007,10305,24,30,137,191
10007,10306,30,37,166,233
10007,10307,2,7,44,53
10007,10308,12,14,89,115
10007,10309,6,18,107,131
10007,10310,25,19,89,133
10007,10312,11,49,202,262
10007,10314,62,68,331,461
10007,10451,51,50,64,165
10007,10452,67,106,97,270
10007,10453,78,105,76,259
10007,10454,42,64,43,149
10007,10455,33,60,61,154
10007,10456,80,108,89,277
10007,10457,50,96,58,204
10007,10458,43,82,60,185
10007,10459,54,51,54,159
10007,10460,43,51,55,149
10007,10461,17,14,71,102
10007,10462,28,62,83,173
10007,10463,26,46,95,167
10007,10464,0,1,12,13
10007,10465,17,18,68,103
10007,10466,35,56,88,179
10007,10467,48,68,108,224
10007,10468,51,62,79,192
10007,10469,36,35,95,166
10007,10470,12,14,12,38
10007,10471,6,7,39,52
10007,10472,38,44,89,171
10007,10473,28,50,66,144
10007,10474,8,12,12,32
10007,10475,17,31,74,122
10007,11001,0,1,3,4
10007,11004,7,4,23,34
10007,11005,1,0,4,5
10007,11040,2,1,3,6
10007,11101,32,30,97,159
10007,11102,18,33,93,144
10007,11103,19,39,110,168
10007,11104,14,22,82,118
10007,11105,20,32,97,149
10007,11106,33,33,103,169
10007,11109,1,0,20,21
10007,11201,39,34,337,410
10007,11203,85,86,187,358
10007,11204,33,62,106,201
10007,11205,37,56,124,217
10007,11206,75,121,220,416
10007,11207,85,137,218,440
10007,11208,93,139,169,401
10007,11209,45,62,261,368
10007,11210,57,65,167,289
10007,11211,42,70,266,378
10007,11212,75,126,187,388
10007,11213,56,88,167,311
10007,11214,58,73,187,318
10007,11215,33,36,304,373
10007,11216,67,69,217,353
10007,11217,25,35,170,230
10007,11218,29,62,199,290
10007,11219,35,39,88,162
10007,11220,56,82,124,262
10007,11221,60,92,227,379
10007,11222,12,35,151,198
10007,11223,44,53,155,252
10007,11224,24,45,118,187
10007,11225,57,54,189,300
10007,11226,86,121,250,457
10007,11228,27,38,120,185
10007,11229,58,44,199,301
10007,11230,45,60,178,283
10007,11231,32,40,165,237
10007,11232,26,21,68,115
10007,11233,53,104,177,334
10007,11234,62,117,261,440
10007,11235,40,34,187,261
10007,11236,92,112,199,403
10007,11237,31,38,106,175
10007,11238,19,64,282,365
10007,11239,14,12,35,61
10007,11354,38,29,67,134
10007,11355,31,43,82,156
10007,11356,12,12,33,57
10007,11357,13,13,80,106
10007,11358,11,19,57,87
10007,11360,6,7,33,46
10007,11361,8,8,44,60
10007,11362,7,4,24,35
10007,11363,2,4,10,16
10007,11364,8,12,60,80
10007,11365,23,23,72,118
10007,11366,3,9,15,27
10007,11367,20,15,58,93
10007,11368,32,77,111,220
10007,11369,18,30,55,103
10007,11370,9,16,53,78
10007,11371,0,0,1,1
10007,11372,27,46,106,179
10007,11373,56,107,170,333
10007,11374,16,28,107,151
10007,11375,27,43,236,306
10007,11377,55,87,167,309
10007,11378,23,20,79,122
10007,11379,23,21,108,152
10007,11385,73,104,240,417
10007,11411,10,7,34,51
10007,11412,19,21,42,82
10007,11413,22,19,81,122
10007,11414,5,18,69,92
10007,11415,6,14,56,76
10007,11416,18,25,51,94
10007,11417,26,34,61,121
10007,11418,21,35,65,121
10007,11419,21,47,75,143
10007,11420,23,27,70,120
10007,11421,31,38,85,154
10007,11422,14,6,46,66
10007,11423,16,21,36,73
10007,11426,5,14,37,56
10007,11427,8,11,46,65
10007,11428,4,9,27,40
10007,11429,11,11,39,61
10007,11432,31,25,90,146
10007,11433,14,12,41,67
10007,11434,20,32,71,123
10007,11435,23,30,75,128
10007,11436,6,9,30,45
10007,11691,29,30,67,126
10007,11692,16,11,38,65
10007,11693,7,8,31,46
10007,11694,11,7,45,63
10007,11697,1,3,15,19
10009,10001,15,7,4,26
10009,10002,80,69,49,198
10009,10003,25,52,48,125
10009,10004,1,3,5,9
10009,10005,3,0,1,4
10009,10006,0,0,3,3
10009,10007,3,0,3,6
10009,10009,208,269,177,654
10009,10010,8,17,28,53
10009,10011,8,12,13,33
10009,10012,8,12,10,30
10009,10013,9,12,14,35
10009,10014,7,5,21,33
10009,10016,3,13,36,52
10009,10017,8,1,8,17
10009,10018,7,5,6,18
10009,10019,10,16,14,40
10009,10021,5,2,8,15
10009,10022,3,3,19,25
10009,10023,6,11,17,34
10009,10024,12,3,12,27
10009,10025,21,17,20,58
10009,10026,6,17,13,36
10009,10027,10,18,16,44
10009,10028,8,14,18,40
10009,10029,29,38,25,92
10009,10030,7,11,15,33
10009,10031,19,27,28,74
10009,10032,10,14,20,44
10009,10033,16,5,10,31
10009,10034,3,21,10,34
10009,10035,20,25,8,53
10009,10036,4,4,4,12
10009,10037,5,6,3,14
10009,10038,8,7,13,28
10009,10039,5,5,6,16
10009,10040,14,19,14,47
10009,10044,1,2,2,5
10009,10065,2,6,8,16
10009,10069,0,0,1,1
10009,10075,5,3,11,19
10009,10128,6,6,20,32
10009,10162,1,0,0,1
10009,10280,0,1,6,7
10009,10282,2,2,0,4
10009,10301,12,6,14,32
10009,10302,6,2,6,14
10009,10303,2,5,5,12
10009,10304,6,8,3,17
10009,10305,7,8,8,23
10009,10306,8,3,9,20
10009,10307,1,1,1,3
10009,10308,2,5,5,12
10009,10309,1,2,5,8
10009,10310,1,2,13,16
10009,10312,4,8,7,19
10009,10314,8,10,22,40
10009,10451,4,17,9,30
10009,10452,13,15,6,34
10009,10453,5,28,8,41
10009,10454,4,19,12,35
10009,10455,5,13,18,36
10009,10456,14,13,9,36
10009,10457,13,25,12,50
10009,10458,13,20,9,42
10009,10459,7,10,8,25
10009,10460,4,7,8,19
10009,10461,7,11,21,39
10009,10462,7,18,18,43
10009,10463,5,10,15,30
10009,10464,0,1,0,1
10009,10465,7,6,8,21
10009,10466,6,7,8,21
10009,10467,10,11,13,34
10009,10468,15,17,7,39
10009,10469,7,22,12,41
10009,10470,4,1,1,6
10009,10471,1,2,7,10
10009,10472,15,8,12,35
10009,10473,10,16,10,36
10009,10474,1,6,2,9
10009,10475,3,3,6,12
10009,11001,0,1,0,1
10009,11004,0,5,1,6
10009,11005,1,1,0,2
10009,11040,0,0,1,1
10009,11101,14,5,9,28
10009,11102,7,17,18,42
10009,11103,8,23,21,52
10009,11104,12,10,17,39
10009,11105,19,18,12,49
10009,11106,12,15,19,46
10009,11109,0,4,3,7
10009,11201,16,24,26,66
10009,11203,14,27,27,68
10009,11204,21,14,18,53
10009,11205,13,18,29,60
10009,11206,33,71,57,161
10009,11207,26,37,37,100
10009,11208,33,34,26,93
10009,11209,10,22,26,58
10009,11210,12,10,21,43
10009,11211,17,51,52,120
10009,11212,17,26,20,63
10009,11213,20,21,24,65
10009,11214,11,21,21,53
10009,11215,17,42,39,98
10009,11216,16,23,22,61
10009,11217,17,11,27,55
10009,11218,14,23,33,70
10009,11219,24,29,14,67
10009,11220,31,50,17,98
10009,11221,42,41,41,124
10009,11222,23,24,37,84
10009,11223,15,9,14,38
10009,11224,6,10,8,24
10009,11225,17,25,26,68
10009,11226,27,43,38,108
10009,11228,10,7,9,26
10009,11229,8,10,10,28
10009,11230,12,18,18,48
10009,11231,8,12,16,36
10009,11232,5,13,12,30
10009,11233,22,30,22,74
10009,11234,11,26,23,60
10009,11235,13,8,7,28
10009,11236,31,27,28,86
10009,11237,32,34,38,104
10009,11238,15,22,34,71
10009,11239,3,5,1,9
10009,11354,16,9,7,32
10009,11355,24,14,6,44
10009,11356,3,3,4,10
10009,11357,9,4,4,17
10009,11358,5,10,11,26
10009,11359,0,1,1,2
10009,11360,3,7,0,10
10009,11361,1,8,6,15
10009,11362,0,1,1,2
10009,11364,2,13,7,22
10009,11365,4,5,4,13
10009,11366,5,0,3,8
10009,11367,6,6,11,23
10009,11368,17,25,24,66
10009,11369,8,14,10,32
10009,11370,8,14,14,36
10009,11371,0,0,1,1
10009,11372,19,26,29,74
10009,11373,31,42,22,95
10009,11374,4,22,5,31
10009,11375,21,20,20,61
10009,11377,25,48,40,113
10009,11378,6,16,12,34
10009,11379,11,11,18,40
10009,11385,29,64,40,133
10009,11411,2,1,4,7
10009,11412,2,8,7,17
10009,11413,3,3,8,14
10009,11414,0,4,15,19
10009,11415,4,10,7,21
10009,11416,12,10,17,39
10009,11417,5,9,8,22
10009,11418,10,12,9,31
10009,11419,5,9,11,25
10009,11420,9,12,9,30
10009,11421,19,12,5,36
10009,11422,2,5,3,10
10009,11423,5,6,3,14
10009,11426,0,3,0,3
10009,11427,3,3,1,7
10009,11428,3,3,1,7
10009,11429,1,4,1,6
10009,11430,1,0,0,1
10009,11432,7,10,12,29
10009,11433,0,5,5,10
10009,11434,4,15,9,28
10009,11435,7,8,5,20
10009,11436,1,1,4,6
10009,11691,0,4,12,16
10009,11692,3,1,5,9
10009,11693,2,2,4,8
10009,11694,8,3,5,16
10010,10001,68,56,269,393
10010,10002,146,111,458,715
10010,10003,209,85,817,1111
10010,10004,9,6,55,70
10010,10005,10,7,119,136
10010,10006,3,2,59,64
10010,10007,13,10,81,104
10010,10009,142,148,694,984
10010,10010,123,116,715,954
10010,10011,125,95,788,1008
10010,10012,66,47,328,441
10010,10013,53,33,262,348
10010,10014,91,53,459,603
10010,10016,122,109,1012,1243
10010,10017,37,17,211,265
10010,10018,36,12,106,154
10010,10019,126,61,447,634
10010,10021,47,35,351,433
10010,10022,36,39,319,394
10010,10023,127,81,503,711
10010,10024,103,70,533,706
10010,10025,185,140,562,887
10010,10026,95,59,242,396
10010,10027,125,143,241,509
10010,10028,57,33,458,548
10010,10029,97,160,301,558
10010,10030,63,75,103,241
10010,10031,127,168,221,516
10010,10032,85,123,170,378
10010,10033,92,93,209,394
10010,10034,76,75,154,305
10010,10035,53,67,125,245
10010,10036,124,57,260,441
10010,10037,19,31,78,128
10010,10038,42,32,209,283
10010,10039,57,64,68,189
10010,10040,65,78,150,293
10010,10044,20,17,48,85
10010,10065,36,36,296,368
10010,10069,13,7,44,64
10010,10075,29,34,223,286
10010,10128,63,74,630,767
10010,10162,0,0,16,16
10010,10280,11,6,106,123
10010,10282,2,3,26,31
10010,10301,34,36,109,179
10010,10302,12,17,19,48
10010,10303,15,29,37,81
10010,10304,30,50,65,145
10010,10305,17,43,116,176
10010,10306,32,28,122,182
10010,10307,5,7,28,40
10010,10308,8,14,59,81
10010,10309,13,14,58,85
10010,10310,14,28,49,91
10010,10312,29,24,132,185
10010,10314,67,47,189,303
10010,10451,58,114,79,251
10010,10452,93,141,96,330
10010,10453,88,146,95,329
10010,10454,27,96,51,174
10010,10455,51,96,57,204
10010,10456,103,177,101,381
10010,10457,71,157,83,311
10010,10458,59,119,89,267
10010,10459,52,85,70,207
10010,10460,50,95,78,223
10010,10461,43,49,118,210
10010,10462,83,110,167,360
10010,10463,49,72,163,284
10010,10464,5,4,15,24
10010,10465,29,36,89,154
10010,10466,47,69,57,173
10010,10467,66,101,132,299
10010,10468,56,111,108,275
10010,10469,45,58,67,170
10010,10470,10,13,23,46
10010,10471,11,28,73,112
10010,10472,54,87,87,228
10010,10473,55,98,68,221
10010,10474,7,22,12,41
10010,10475,26,36,71,133
10010,11001,0,3,11,14
10010,11003,1,1,0,2
10010,11004,7,6,35,48
10010,11005,1,0,1,2
10010,11040,2,1,6,9
10010,11101,62,70,291,423
10010,11102,87,75,321,483
10010,11103,85,96,320,501
10010,11104,46,70,188,304
10010,11105,75,68,282,425
10010,11106,79,69,297,445
10010,11109,5,8,96,109
10010,11201,152,86,755,993
10010,11203,71,123,137,331
10010,11204,60,68,136,264
10010,11205,76,66,263,405
10010,11206,119,146,425,690
10010,11207,92,163,145,400
10010,11208,78,156,118,352
10010,11209,79,97,353,529
10010,11210,67,96,145,308
10010,11211,159,160,992,1311
10010,11212,75,130,82,287
10010,11213,71,107,175,353
10010,11214,80,81,229,390
10010,11215,162,88,794,1044
10010,11216,146,109,389,644
10010,11217,93,69,470,632
10010,11218,108,92,340,540
10010,11219,66,65,115,246
10010,11220,81,91,216,388
10010,11221,141,158,398,697
10010,11222,99,73,441,613
10010,11223,45,93,172,310
10010,11224,35,41,58,134
10010,11225,111,114,289,514
10010,11226,139,165,381,685
10010,11228,32,57,128,217
10010,11229,70,74,189,333
10010,11230,116,110,294,520
10010,11231,78,49,370,497
10010,11232,23,48,129,200
10010,11233,78,115,197,390
10010,11234,101,97,231,429
10010,11235,52,67,144,263
10010,11236,69,123,154,346
10010,11237,73,99,262,434
10010,11238,148,109,630,887
10010,11239,11,16,11,38
10010,11354,44,71,121,236
10010,11355,82,82,127,291
10010,11356,23,33,51,107
10010,11357,31,33,110,174
10010,11358,35,28,109,172
10010,11359,1,0,0,1
10010,11360,9,9,61,79
10010,11361,16,20,69,105
10010,11362,7,12,31,50
10010,11363,4,2,19,25
10010,11364,22,21,70,113
10010,11365,26,29,99,154
10010,11366,12,11,45,68
10010,11367,38,44,116,198
10010,11368,71,194,167,432
10010,11369,40,79,86,205
10010,11370,24,35,78,137
10010,11371,0,1,2,3
10010,11372,96,132,291,519
10010,11373,131,228,291,650
10010,11374,50,48,194,292
10010,11375,61,83,447,591
10010,11377,128,188,379,695
10010,11378,37,51,116,204
10010,11379,31,44,124,199
10010,11385,116,188,405,709
10010,11411,16,24,46,86
10010,11412,15,34,30,79
10010,11413,40,37,56,133
10010,11414,20,19,46,85
10010,11415,26,36,97,159
10010,11416,19,45,52,116
10010,11417,11,34,89,134
10010,11418,25,51,89,165
10010,11419,27,56,89,172
10010,11420,34,52,118,204
10010,11421,35,61,104,200
10010,11422,28,25,36,89
10010,11423,17,26,38,81
10010,11426,12,20,39,71
10010,11427,25,17,39,81
10010,11428,18,14,37,69
10010,11429,21,32,45,98
10010,11432,50,48,93,191
10010,11433,26,30,31,87
10010,11434,29,42,51,122
10010,11435,39,55,116,210
10010,11436,7,18,17,42
10010,11691,21,41,72,134
10010,11692,23,23,25,71
10010,11693,9,9,16,34
10010,11694,22,13,57,92
10010,11697,4,7,16,27
10011,10001,85,75,331,491
10011,10002,168,201,444,813
10011,10003,114,87,696,897
10011,10004,13,13,58,84
10011,10005,10,20,111,141
10011,10006,4,13,51,68
10011,10007,5,4,62,71
10011,10009,144,164,621,929
10011,10010,52,65,375,492
10011,10011,301,289,1326,1916
10011,10012,64,40,298,402
10011,10013,42,41,215,298
10011,10014,114,121,568,803
10011,10016,54,87,543,684
10011,10017,24,22,134,180
10011,10018,28,14,93,135
10011,10019,108,112,507,727
10011,10021,37,38,274,349
10011,10022,36,19,245,300
10011,10023,99,88,547,734
10011,10024,119,65,499,683
10011,10025,148,196,599,943
10011,10026,87,85,172,344
10011,10027,124,161,260,545
10011,10028,57,55,348,460
10011,10029,182,204,227,613
10011,10030,70,123,139,332
10011,10031,157,197,239,593
10011,10032,140,181,193,514
10011,10033,116,164,207,487
10011,10034,76,120,142,338
10011,10035,72,100,113,285
10011,10036,99,75,333,507
10011,10037,49,38,83,170
10011,10038,52,47,233,332
10011,10039,59,66,86,211
10011,10040,75,87,148,310
10011,10044,15,13,34,62
10011,10065,34,25,218,277
10011,10069,12,10,46,68
10011,10075,27,32,185,244
10011,10119,0,0,2,2
10011,10128,57,71,376,504
10011,10162,2,2,8,12
10011,10280,15,6,87,108
10011,10282,2,2,13,17
10011,10301,26,44,117,187
10011,10302,14,14,35,63
10011,10303,20,30,40,90
10011,10304,43,54,90,187
10011,10305,45,37,99,181
10011,10306,31,55,131,217
10011,10307,2,9,37,48
10011,10308,18,17,48,83
10011,10309,15,19,55,89
10011,10310,24,28,54,106
10011,10312,24,23,102,149
10011,10314,65,95,219,379
10011,10451,77,102,72,251
10011,10452,117,182,90,389
10011,10453,92,199,97,388
10011,10454,44,98,55,197
10011,10455,44,82,69,195
10011,10456,133,237,104,474
10011,10457,94,136,117,347
10011,10458,76,144,91,311
10011,10459,51,120,81,252
10011,10460,79,88,90,257
10011,10461,46,70,123,239
10011,10462,110,127,175,412
10011,10463,58,101,158,317
10011,10464,5,3,8,16
10011,10465,38,40,92,170
10011,10466,42,76,81,199
10011,10467,70,140,130,340
10011,10468,90,126,123,339
10011,10469,59,86,92,237
10011,10470,12,17,29,58
10011,10471,15,34,55,104
10011,10472,76,131,77,284
10011,10473,71,107,108,286
10011,10474,15,26,18,59
10011,10475,36,48,73,157
10011,11001,6,7,12,25
10011,11003,0,0,1,1
10011,11004,7,13,32,52
10011,11005,4,2,2,8
10011,11040,2,1,5,8
10011,11101,57,79,230,366
10011,11102,80,91,262,433
10011,11103,100,102,320,522
10011,11104,68,85,174,327
10011,11105,77,105,243,425
10011,11106,82,112,276,470
10011,11109,9,0,78,87
10011,11201,117,103,827,1047
10011,11203,112,122,148,382
10011,11204,77,135,149,361
10011,11205,66,94,296,456
10011,11206,160,250,436,846
10011,11207,150,194,217,561
10011,11208,110,164,159,433
10011,11209,91,111,339,541
10011,11210,63,97,151,311
10011,11211,175,219,1036,1430
10011,11212,76,168,93,337
10011,11213,107,148,205,460
10011,11214,94,130,204,428
10011,11215,114,138,737,989
10011,11216,119,179,402,700
10011,11217,79,93,483,655
10011,11218,89,120,349,558
10011,11219,79,101,123,303
10011,11220,130,184,184,498
10011,11221,204,251,384,839
10011,11222,107,107,512,726
10011,11223,78,116,142,336
10011,11224,38,43,54,135
10011,11225,104,160,285,549
10011,11226,198,264,385,847
10011,11228,51,73,120,244
10011,11229,71,83,175,329
10011,11230,63,101,188,352
10011,11231,63,72,370,505
10011,11232,46,77,114,237
10011,11233,113,163,196,472
10011,11234,73,120,214,407
10011,11235,54,77,121,252
10011,11236,110,168,145,423
10011,11237,105,173,350,628
10011,11238,112,109,643,864
10011,11239,18,9,39,66
10011,11354,84,75,78,237
10011,11355,133,127,102,362
10011,11356,19,38,32,89
10011,11357,28,39,93,160
10011,11358,23,40,109,172
10011,11359,3,2,1,6
10011,11360,7,24,55,86
10011,11361,13,26,74,113
10011,11362,6,9,28,43
10011,11363,5,5,16,26
10011,11364,11,25,65,101
10011,11365,34,50,94,178
10011,11366,7,14,27,48
10011,11367,34,49,68,151
10011,11368,138,170,124,432
10011,11369,43,72,93,208
10011,11370,36,64,75,175
10011,11372,94,138,194,426
10011,11373,183,264,272,719
10011,11374,57,54,194,305
10011,11375,68,104,404,576
10011,11377,156,282,330,768
10011,11378,41,66,113,220
10011,11379,33,47,128,208
10011,11385,196,233,376,805
10011,11411,13,21,24,58
10011,11412,18,17,41,76
10011,11413,30,30,40,100
10011,11414,13,11,62,86
10011,11415,19,24,94,137
10011,11416,26,54,78,158
10011,11417,32,58,79,169
10011,11418,38,55,97,190
10011,11419,35,78,91,204
10011,11420,39,66,85,190
10011,11421,42,91,89,222
10011,11422,28,28,41,97
10011,11423,23,28,45,96
10011,11426,14,13,26,53
10011,11427,25,18,32,75
10011,11428,11,19,33,63
10011,11429,17,26,39,82
10011,11430,0,1,2,3
10011,11432,45,47,105,197
10011,11433,19,32,37,88
10011,11434,36,60,50,146
10011,11435,47,65,98,210
10011,11436,8,15,22,45
10011,11691,39,60,84,183
10011,11692,14,16,32,62
10011,11693,9,7,25,41
10011,11694,11,17,32,60
10011,11697,4,5,10,19
10012,10001,49,43,94,186
10012,10002,156,159,357,672
10012,10003,110,106,397,613
10012,10004,10,13,45,68
10012,10005,25,11,84,120
10012,10006,22,2,36,60
10012,10007,4,2,58,64
10012,10009,143,161,421,725
10012,10010,46,40,212,298
10012,10011,85,93,393,571
10012,10012,108,135,487,730
10012,10013,61,75,210,346
10012,10014,53,58,245,356
10012,10016,42,49,291,382
10012,10017,17,14,62,93
10012,10018,13,10,49,72
10012,10019,57,64,196,317
10012,10021,23,31,155,209
10012,10022,15,15,140,170
10012,10023,62,64,222,348
10012,10024,51,39,192,282
10012,10025,105,107,295,507
10012,10026,48,53,111,212
10012,10027,87,106,110,303
10012,10028,26,30,191,247
10012,10029,111,128,138,377
10012,10030,42,59,62,163
10012,10031,86,129,162,377
10012,10032,102,118,97,317
10012,10033,56,77,102,235
10012,10034,52,57,68,177
10012,10035,51,50,73,174
10012,10036,32,40,126,198
10012,10037,33,21,40,94
10012,10038,34,42,143,219
10012,10039,36,49,47,132
10012,10040,41,45,96,182
10012,10044,9,9,29,47
10012,10065,28,24,126,178
10012,10069,7,9,26,42
10012,10075,18,17,107,142
10012,10119,1,0,1,2
10012,10128,43,62,235,340
10012,10162,4,2,9,15
10012,10280,16,7,46,69
10012,10282,5,1,10,16
10012,10301,23,40,59,122
10012,10302,8,6,19,33
10012,10303,17,16,17,50
10012,10304,32,36,49,117
10012,10305,30,30,40,100
10012,10306,28,30,53,111
10012,10307,2,5,16,23
10012,10308,7,5,9,21
10012,10309,16,14,15,45
10012,10310,15,20,15,50
10012,10312,12,14,51,77
10012,10314,45,43,74,162
10012,10451,35,65,19,119
10012,10452,43,125,45,213
10012,10453,68,120,48,236
10012,10454,39,74,25,138
10012,10455,35,52,18,105
10012,10456,83,113,49,245
10012,10457,74,86,44,204
10012,10458,55,101,24,180
10012,10459,45,63,19,127
10012,10460,37,61,21,119
10012,10461,18,31,38,87
10012,10462,46,64,55,165
10012,10463,29,56,55,140
10012,10464,2,1,4,7
10012,10465,13,25,28,66
10012,10466,40,42,15,97
10012,10467,63,61,52,176
10012,10468,52,68,55,175
10012,10469,37,39,26,102
10012,10470,13,7,7,27
10012,10471,14,22,28,64
10012,10472,40,70,36,146
10012,10473,56,61,37,154
10012,10474,4,11,2,17
10012,10475,24,29,18,71
10012,11001,3,3,1,7
10012,11004,5,4,4,13
10012,11005,0,1,1,2
10012,11040,0,1,2,3
10012,11101,48,60,142,250
10012,11102,53,54,159,266
10012,11103,88,77,167,332
10012,11104,41,40,127,208
10012,11105,55,54,155,264
10012,11106,52,66,143,261
10012,11109,12,9,32,53
10012,11201,114,115,477,706
10012,11203,70,78,60,208
10012,11204,46,69,96,211
10012,11205,90,69,184,343
10012,11206,190,192,361,743
10012,11207,92,109,112,313
10012,11208,58,108,53,219
10012,11209,72,68,175,315
10012,11210,53,63,72,188
10012,11211,154,171,754,1079
10012,11212,63,71,47,181
10012,11213,98,92,110,300
10012,11214,51,96,121,268
10012,11215,117,124,529,770
10012,11216,128,130,311,569
10012,11217,60,69,252,381
10012,11218,55,106,216,377
10012,11219,55,61,59,175
10012,11220,83,109,138,330
10012,11221,186,184,270,640
10012,11222,93,89,376,558
10012,11223,56,63,79,198
10012,11224,21,44,35,100
10012,11225,115,105,168,388
10012,11226,162,184,235,581
10012,11228,27,49,62,138
10012,11229,51,74,83,208
10012,11230,64,90,124,278
10012,11231,75,69,231,375
10012,11232,26,43,80,149
10012,11233,126,120,119,365
10012,11234,78,76,95,249
10012,11235,24,38,87,149
10012,11236,75,109,53,237
10012,11237,130,137,262,529
10012,11238,108,115,399,622
10012,11239,12,11,12,35
10012,11354,32,34,41,107
10012,11355,51,70,63,184
10012,11356,10,15,14,39
10012,11357,10,20,31,61
10012,11358,24,26,41,91
10012,11359,2,0,0,2
10012,11360,8,9,28,45
10012,11361,8,12,19,39
10012,11362,9,11,22,42
10012,11363,3,3,7,13
10012,11364,16,7,42,65
10012,11365,21,25,32,78
10012,11366,5,11,17,33
10012,11367,18,29,32,79
10012,11368,56,132,71,259
10012,11369,30,50,36,116
10012,11370,17,31,29,77
10012,11371,2,0,2,4
10012,11372,55,95,122,272
10012,11373,86,120,132,338
10012,11374,38,50,117,205
10012,11375,51,56,191,298
10012,11377,87,137,156,380
10012,11378,28,58,55,141
10012,11379,19,26,55,100
10012,11385,122,198,218,538
10012,11411,21,17,14,52
10012,11412,12,15,12,39
10012,11413,22,31,28,81
10012,11414,11,17,22,50
10012,11415,21,19,28,68
10012,11416,27,22,34,83
10012,11417,28,27,22,77
10012,11418,23,35,40,98
10012,11419,29,33,43,105
10012,11420,21,33,35,89
10012,11421,38,49,47,134
10012,11422,11,17,22,50
10012,11423,15,20,21,56
10012,11426,7,10,10,27
10012,11427,12,21,18,51
10012,11428,12,16,17,45
10012,11429,15,12,13,40
10012,11430,1,1,0,2
10012,11432,21,50,42,113
10012,11433,7,22,14,43
10012,11434,23,39,12,74
10012,11435,36,36,42,114
10012,11436,12,7,3,22
10012,11691,29,28,20,77
10012,11692,5,6,13,24
10012,11693,4,3,5,12
10012,11694,12,23,16,51
10012,11697,2,1,6,9
10013,10001,48,69,328,445
10013,10002,660,765,960,2385
10013,10003,83,110,688,881
10013,10004,7,14,108,129
10013,10005,17,12,174,203
10013,10006,1,5,82,88
10013,10007,29,43,217,289
10013,10009,187,253,939,1379
10013,10010,27,49,413,489
10013,10011,106,127,863,1096
10013,10012,123,122,430,675
10013,10013,378,362,701,1441
10013,10014,52,63,578,693
10013,10016,76,94,643,813
10013,10017,9,23,181,213
10013,10018,25,23,118,166
10013,10019,82,115,501,698
10013,10021,41,40,386,467
10013,10022,45,28,290,363
10013,10023,82,84,626,792
10013,10024,50,88,620,758
10013,10025,140,181,861,1182
10013,10026,85,120,422,627
10013,10027,132,222,506,860
10013,10028,48,52,499,599
10013,10029,218,326,544,1088
10013,10030,66,94,280,440
10013,10031,131,241,503,875
10013,10032,119,202,392,713
10013,10033,97,188,346,631
10013,10034,82,126,284,492
10013,10035,102,139,235,476
10013,10036,55,98,342,495
10013,10037,46,72,240,358
10013,10038,96,165,383,644
10013,10039,62,98,212,372
10013,10040,77,121,354,552
10013,10044,16,22,76,114
10013,10065,32,43,276,351
10013,10069,9,11,71,91
10013,10075,31,31,229,291
10013,10119,0,0,3,3
10013,10128,93,91,632,816
10013,10162,1,1,19,21
10013,10173,0,1,0,1
10013,10280,17,22,210,249
10013,10282,6,9,73,88
10013,10301,66,157,585,808
10013,10302,23,57,294,374
10013,10303,46,117,353,516
10013,10304,112,192,392,696
10013,10305,97,191,550,838
10013,10306,95,208,879,1182
10013,10307,21,42,247,310
10013,10308,24,83,452,559
10013,10309,40,104,527,671
10013,10310,53,77,431,561
10013,10312,65,197,929,1191
10013,10314,138,378,1382,1898
10013,10451,78,200,327,605
10013,10452,130,271,311,712
10013,10453,105,307,380,792
10013,10454,61,144,185,390
10013,10455,76,169,204,449
10013,10456,149,366,403,918
10013,10457,113,249,290,652
10013,10458,100,218,270,588
10013,10459,94,188,202,484
10013,10460,91,203,284,578
10013,10461,35,102,357,494
10013,10462,80,178,409,667
10013,10463,81,142,465,688
10013,10464,0,11,38,49
10013,10465,26,75,318,419
10013,10466,57,125,318,500
10013,10467,102,231,427,760
10013,10468,87,209,365,661
10013,10469,66,113,351,530
10013,10470,26,40,86,152
10013,10471,25,51,157,233
10013,10472,74,159,305,538
10013,10473,66,141,330,537
10013,10474,15,58,52,125
10013,10475,35,79,331,445
10013,11001,3,9,39,51
10013,11004,20,26,113,159
10013,11005,2,5,18,25
10013,11040,3,4,18,25
10013,11101,59,105,410,574
10013,11102,72,126,355,553
10013,11103,87,174,498,759
10013,11104,48,64,346,458
10013,11105,79,144,468,691
10013,11106,77,149,493,719
10013,11109,5,7,96,108
10013,11201,134,159,1141,1434
10013,11203,134,285,862,1281
10013,11204,344,556,496,1396
10013,11205,100,173,621,894
10013,11206,206,443,863,1512
10013,11207,176,370,793,1339
10013,11208,174,376,641,1191
10013,11209,152,272,1155,1579
10013,11210,88,233,672,993
10013,11211,145,283,1195,1623
10013,11212,160,364,623,1147
10013,11213,126,253,619,998
10013,11214,500,667,751,1918
10013,11215,100,180,1317,1597
10013,11216,123,248,899,1270
10013,11217,75,120,750,945
10013,11218,123,236,830,1189
10013,11219,268,367,352,987
10013,11220,414,555,646,1615
10013,11221,183,429,931,1543
10013,11222,74,116,668,858
10013,11223,362,455,611,1428
10013,11224,124,215,376,715
10013,11225,112,269,789,1170
10013,11226,236,384,1019,1639
10013,11228,238,350,591,1179
10013,11229,289,367,852,1508
10013,11230,135,229,708,1072
10013,11231,70,143,652,865
10013,11232,100,114,301,515
10013,11233,149,324,792,1265
10013,11234,148,418,1263,1829
10013,11235,168,250,605,1023
10013,11236,156,315,919,1390
10013,11237,115,208,485,808
10013,11238,127,180,1171,1478
10013,11239,32,58,152,242
10013,11354,120,183,315,618
10013,11355,244,275,388,907
10013,11356,34,89,159,282
10013,11357,70,136,380,586
10013,11358,90,124,286,500
10013,11360,21,49,173,243
10013,11361,44,85,217,346
10013,11362,25,61,129,215
10013,11363,12,21,50,83
10013,11364,56,104,227,387
10013,11365,76,124,325,525
10013,11366,22,37,129,188
10013,11367,72,130,304,506
10013,11368,156,271,501,928
10013,11369,65,119,243,427
10013,11370,30,79,170,279
10013,11371,1,0,1,2
10013,11372,122,178,517,817
10013,11373,270,445,587,1302
10013,11374,89,145,418,652
10013,11375,100,195,898,1193
10013,11377,188,287,792,1267
10013,11378,71,176,443,690
10013,11379,76,168,472,716
10013,11385,221,441,1054,1716
10013,11411,17,49,217,283
10013,11412,37,75,229,341
10013,11413,41,85,365,491
10013,11414,25,98,299,422
10013,11415,21,51,235,307
10013,11416,43,90,229,362
10013,11417,52,120,281,453
10013,11418,42,113,291,446
10013,11419,37,123,258,418
10013,11420,53,123,330,506
10013,11421,111,187,347,645
10013,11422,38,56,261,355
10013,11423,23,69,216,308
10013,11426,15,30,139,184
10013,11427,23,62,184,269
10013,11428,16,48,131,195
10013,11429,19,64,182,265
10013,11430,0,0,3,3
10013,11432,82,172,379,633
10013,11433,34,74,240,348
10013,11434,35,123,436,594
10013,11435,54,114,375,543
10013,11436,24,32,118,174
10013,11691,69,107,301,477
10013,11692,33,63,150,246
10013,11693,15,39,131,185
10013,11694,25,62,316,403
10013,11697,5,9,94,108
10014,10001,43,39,136,218
10014,10002,65,102,254,421
10014,10003,47,56,314,417
10014,10004,3,3,39,45
10014,10005,5,6,65,76
10014,10006,5,8,25,38
10014,10007,4,11,36,51
10014,10009,55,109,329,493
10014,10010,24,33,157,214
10014,10011,94,69,453,616
10014,10012,32,35,193,260
10014,10013,34,40,166,240
10014,10014,127,130,502,759
10014,10016,26,53,265,344
10014,10017,10,9,82,101
10014,10018,10,6,41,57
10014,10019,49,42,213,304
10014,10021,23,8,139,170
10014,10022,21,28,97,146
10014,10023,43,49,229,321
10014,10024,41,49,203,293
10014,10025,60,85,281,426
10014,10026,42,44,102,188
10014,10027,57,90,121,268
10014,10028,32,36,141,209
10014,10029,59,107,136,302
10014,10030,43,72,71,186
10014,10031,76,112,163,351
10014,10032,65,93,109,267
10014,10033,40,75,86,201
10014,10034,43,74,74,191
10014,10035,42,46,84,172
10014,10036,39,42,128,209
10014,10037,28,27,60,115
10014,10038,27,28,92,147
10014,10039,30,40,51,121
10014,10040,35,49,118,202
10014,10044,5,6,19,30
10014,10065,16,11,92,119
10014,10069,2,7,15,24
10014,10075,17,15,93,125
10014,10119,0,0,1,1
10014,10128,35,33,183,251
10014,10162,1,0,7,8
10014,10280,2,6,69,77
10014,10282,3,8,20,31
10014,10301,16,22,71,109
10014,10302,4,12,19,35
10014,10303,12,18,23,53
10014,10304,19,22,44,85
10014,10305,24,19,65,108
10014,10306,6,13,76,95
10014,10307,2,4,22,28
10014,10308,3,10,28,41
10014,10309,6,12,35,53
10014,10310,10,13,47,70
10014,10312,6,14,68,88
10014,10314,32,28,87,147
10014,10451,41,60,52,153
10014,10452,41,97,71,209
10014,10453,47,128,55,230
10014,10454,16,61,21,98
10014,10455,20,62,26,108
10014,10456,64,130,63,257
10014,10457,43,83,45,171
10014,10458,43,95,64,202
10014,10459,35,69,25,129
10014,10460,31,62,60,153
10014,10461,15,36,54,105
10014,10462,32,53,85,170
10014,10463,34,55,100,189
10014,10464,2,2,7,11
10014,10465,19,26,43,88
10014,10466,19,41,48,108
10014,10467,45,92,97,234
10014,10468,51,76,78,205
10014,10469,33,34,53,120
10014,10470,15,8,16,39
10014,10471,8,17,36,61
10014,10472,37,79,56,172
10014,10473,31,64,64,159
10014,10474,7,18,4,29
10014,10475,9,18,31,58
10014,11001,1,2,5,8
10014,11004,5,5,10,20
10014,11005,2,3,0,5
10014,11040,1,0,1,2
10014,11101,23,34,108,165
10014,11102,34,63,119,216
10014,11103,63,70,182,315
10014,11104,25,38,90,153
10014,11105,48,47,151,246
10014,11106,43,68,124,235
10014,11109,0,5,33,38
10014,11201,52,50,417,519
10014,11203,45,94,71,210
10014,11204,40,57,93,190
10014,11205,32,40,175,247
10014,11206,85,126,280,491
10014,11207,71,114,109,294
10014,11208,44,99,85,228
10014,11209,39,48,180,267
10014,11210,31,67,73,171
10014,11211,75,104,497,676
10014,11212,47,103,71,221
10014,11213,44,101,109,254
10014,11214,46,64,115,225
10014,11215,57,76,406,539
10014,11216,70,123,293,486
10014,11217,34,34,262,330
10014,11218,23,46,193,262
10014,11219,37,38,48,123
10014,11220,73,85,107,265
10014,11221,95,178,246,519
10014,11222,39,44,275,358
10014,11223,25,45,96,166
10014,11224,13,29,36,78
10014,11225,49,94,163,306
10014,11226,88,148,209,445
10014,11228,27,46,56,129
10014,11229,31,42,115,188
10014,11230,36,52,118,206
10014,11231,30,40,221,291
10014,11232,28,26,55,109
10014,11233,58,112,127,297
10014,11234,41,68,98,207
10014,11235,21,42,84,147
10014,11236,42,80,99,221
10014,11237,52,88,178,318
10014,11238,47,78,362,487
10014,11239,5,10,13,28
10014,11354,17,26,52,95
10014,11355,39,40,66,145
10014,11356,4,14,28,46
10014,11357,17,16,64,97
10014,11358,14,25,55,94
10014,11359,0,0,1,1
10014,11360,2,2,22,26
10014,11361,9,7,36,52
10014,11362,3,7,22,32
10014,11363,1,1,4,6
10014,11364,13,14,40,67
10014,11365,14,14,60,88
10014,11366,6,6,11,23
10014,11367,9,21,32,62
10014,11368,31,115,96,242
10014,11369,18,58,36,112
10014,11370,15,36,31,82
10014,11371,0,0,1,1
10014,11372,29,84,155,268
10014,11373,67,128,143,338
10014,11374,19,23,82,124
10014,11375,20,47,170,237
10014,11377,83,129,183,395
10014,11378,36,30,60,126
10014,11379,10,41,58,109
10014,11385,76,135,241,452
10014,11411,3,8,22,33
10014,11412,11,23,34,68
10014,11413,10,20,28,58
10014,11414,6,12,19,37
10014,11415,9,14,48,71
10014,11416,18,29,31,78
10014,11417,15,24,49,88
10014,11418,18,29,39,86
10014,11419,18,39,31,88
10014,11420,18,32,41,91
10014,11421,20,55,47,122
10014,11422,8,18,20,46
10014,11423,7,16,33,56
10014,11426,5,5,12,22
10014,11427,5,14,26,45
10014,11428,3,13,31,47
10014,11429,6,18,25,49
10014,11430,1,1,2,4
10014,11432,33,42,47,122
10014,11433,19,23,32,74
10014,11434,18,32,50,100
10014,11435,34,35,53,122
10014,11436,10,15,16,41
10014,11691,12,25,26,63
10014,11692,2,21,21,44
10014,11693,9,9,18,36
10014,11694,12,5,32,49
10014,11697,2,3,8,13
10016,10001,44,56,274,374
10016,10002,156,211,584,951
10016,10003,71,97,762,930
10016,10004,12,15,93,120
10016,10005,5,7,113,125
10016,10006,5,5,63,73
10016,10007,6,12,61,79
10016,10009,120,208,843,1171
10016,10010,44,139,747,930
10016,10011,71,98,697,866
10016,10012,29,36,314,379
10016,10013,37,64,256,357
10016,10014,39,55,398,492
10016,10016,217,300,1790,2307
10016,10017,22,44,340,406
10016,10018,18,21,116,155
10016,10019,64,98,578,740
10016,10021,38,77,552,667
10016,10022,36,68,462,566
10016,10023,64,112,586,762
10016,10024,67,83,585,735
10016,10025,120,198,729,1047
10016,10026,56,118,259,433
10016,10027,98,177,349,624
10016,10028,60,64,637,761
10016,10029,180,298,566,1044
10016,10030,49,83,130,262
10016,10031,129,160,342,631
10016,10032,135,158,309,602
10016,10033,88,156,289,533
10016,10034,54,121,230,405
10016,10035,71,137,197,405
10016,10036,45,90,354,489
10016,10037,46,52,142,240
10016,10038,28,48,242,318
10016,10039,47,102,143,292
10016,10040,75,133,207,415
10016,10044,17,23,114,154
10016,10065,41,31,450,522
10016,10069,5,12,59,76
10016,10075,31,38,378,447
10016,10119,0,0,1,1
10016,10128,68,125,915,1108
10016,10162,1,2,28,31
10016,10280,10,9,107,126
10016,10282,4,4,33,41
10016,10301,38,75,210,323
10016,10302,12,21,62,95
10016,10303,24,42,111,177
10016,10304,48,60,160,268
10016,10305,34,53,238,325
10016,10306,27,53,248,328
10016,10307,7,9,50,66
10016,10308,11,17,104,132
10016,10309,9,22,115,146
10016,10310,17,36,132,185
10016,10312,28,46,208,282
10016,10314,59,112,455,626
10016,10451,59,134,217,410
10016,10452,103,229,278,610
10016,10453,118,240,220,578
10016,10454,55,134,96,285
10016,10455,57,114,122,293
10016,10456,134,249,264,647
10016,10457,92,219,211,522
10016,10458,69,188,189,446
10016,10459,61,157,147,365
10016,10460,72,158,168,398
10016,10461,57,120,279,456
10016,10462,94,183,348,625
10016,10463,62,124,277,463
10016,10464,6,7,22,35
10016,10465,35,70,212,317
10016,10466,41,91,209,341
10016,10467,90,164,302,556
10016,10468,71,194,263,528
10016,10469,47,98,203,348
10016,10470,18,32,63,113
10016,10471,18,37,121,176
10016,10472,91,199,229,519
10016,10473,69,126,207,402
10016,10474,14,37,33,84
10016,10475,39,61,196,296
10016,11001,3,2,25,30
10016,11004,10,13,80,103
10016,11005,1,3,7,11
10016,11040,0,3,15,18
10016,11101,57,89,404,550
10016,11102,45,89,364,498
10016,11103,65,120,414,599
10016,11104,54,112,303,469
10016,11105,47,117,398,562
10016,11106,61,133,428,622
10016,11109,18,16,153,187
10016,11201,65,95,786,946
10016,11203,91,195,424,710
10016,11204,79,124,289,492
10016,11205,41,70,290,401
10016,11206,137,206,532,875
10016,11207,134,277,332,743
10016,11208,107,200,359,666
10016,11209,80,155,645,880
10016,11210,60,135,345,540
10016,11211,106,160,914,1180
10016,11212,95,204,293,592
10016,11213,63,123,302,488
10016,11214,98,185,450,733
10016,11215,64,111,794,969
10016,11216,107,148,430,685
10016,11217,37,75,485,597
10016,11218,72,118,467,657
10016,11219,83,138,203,424
10016,11220,144,218,500,862
10016,11221,113,217,446,776
10016,11222,65,116,458,639
10016,11223,86,133,328,547
10016,11224,30,70,158,258
10016,11225,83,142,422,647
10016,11226,113,282,619,1014
10016,11228,46,82,295,423
10016,11229,64,87,406,557
10016,11230,67,113,442,622
10016,11231,38,48,336,422
10016,11232,29,72,156,257
10016,11233,81,165,282,528
10016,11234,84,159,573,816
10016,11235,56,103,385,544
10016,11236,115,189,490,794
10016,11237,73,141,318,532
10016,11238,77,120,608,805
10016,11239,11,26,57,94
10016,11354,73,129,183,385
10016,11355,154,198,253,605
10016,11356,19,43,91,153
10016,11357,41,56,185,282
10016,11358,38,59,202,299
10016,11359,1,0,4,5
10016,11360,22,18,132,172
10016,11361,10,39,134,183
10016,11362,11,18,86,115
10016,11363,5,8,32,45
10016,11364,24,39,170,233
10016,11365,49,68,190,307
10016,11366,11,26,101,138
10016,11367,33,50,213,296
10016,11368,114,263,333,710
10016,11369,47,95,180,322
10016,11370,27,66,151,244
10016,11371,2,0,1,3
10016,11372,88,164,467,719
10016,11373,178,348,526,1052
10016,11374,72,88,425,585
10016,11375,91,107,808,1006
10016,11377,173,315,645,1133
10016,11378,46,96,254,396
10016,11379,44,64,269,377
10016,11385,134,279,717,1130
10016,11411,14,38,99,151
10016,11412,32,47,137,216
10016,11413,43,67,190,300
10016,11414,20,20,146,186
10016,11415,29,42,167,238
10016,11416,19,69,128,216
10016,11417,28,58,136,222
10016,11418,29,76,183,288
10016,11419,45,91,177,313
10016,11420,42,84,187,313
10016,11421,59,104,221,384
10016,11422,16,43,156,215
10016,11423,22,51,132,205
10016,11426,16,18,106,140
10016,11427,32,48,111,191
10016,11428,21,30,116,167
10016,11429,26,46,100,172
10016,11430,0,3,2,5
10016,11432,62,113,251,426
10016,11433,26,47,79,152
10016,11434,42,98,203,343
10016,11435,43,92,238,373
10016,11436,14,33,75,122
10016,11691,26,52,100,178
10016,11692,9,24,43,76
10016,11693,7,16,51,74
10016,11694,8,38,96,142
10016,11697,8,4,17,29
10017,10001,45,47,427,519
10017,10002,70,155,634,859
10017,10003,56,82,1198,1336
10017,10004,13,9,120,142
10017,10005,14,11,252,277
10017,10006,3,7,93,103
10017,10007,2,7,207,216
10017,10009,115,136,976,1227
10017,10010,52,46,881,979
10017,10011,50,81,1213,1344
10017,10012,30,33,420,483
10017,10013,24,41,468,533
10017,10014,31,37,713,781
10017,10016,99,150,1999,2248
10017,10017,63,96,943,1102
10017,10018,10,15,190,215
10017,10019,63,111,1045,1219
10017,10021,38,77,1011,1126
10017,10022,55,61,953,1069
10017,10023,74,102,1203,1379
10017,10024,65,82,1011,1158
10017,10025,131,168,1177,1476
10017,10026,61,145,366,572
10017,10027,111,162,456,729
10017,10028,44,78,1164,1286
10017,10029,170,262,625,1057
10017,10030,58,98,199,355
10017,10031,106,181,386,673
10017,10032,79,163,319,561
10017,10033,83,154,329,566
10017,10034,82,130,273,485
10017,10035,62,141,220,423
10017,10036,58,82,659,799
10017,10037,35,60,181,276
10017,10038,23,39,424,486
10017,10039,64,84,130,278
10017,10040,73,110,262,445
10017,10044,17,19,211,247
10017,10065,47,52,802,901
10017,10069,8,10,115,133
10017,10075,32,43,648,723
10017,10103,0,0,1,1
10017,10128,73,115,1438,1626
10017,10162,0,2,43,45
10017,10173,0,0,3,3
10017,10199,0,0,1,1
10017,10280,6,11,230,247
10017,10282,2,5,71,78
10017,10301,47,76,217,340
10017,10302,11,22,61,94
10017,10303,24,50,99,173
10017,10304,32,61,168,261
10017,10305,29,62,243,334
10017,10306,29,69,273,371
10017,10307,4,12,65,81
10017,10308,12,17,143,172
10017,10309,18,26,169,213
10017,10310,28,48,116,192
10017,10312,37,40,311,388
10017,10314,67,92,476,635
10017,10451,87,132,199,418
10017,10452,127,258,273,658
10017,10453,132,228,253,613
10017,10454,56,99,104,259
10017,10455,52,125,146,323
10017,10456,132,264,208,604
10017,10457,114,206,195,515
10017,10458,102,221,267,590
10017,10459,83,137,129,349
10017,10460,74,164,197,435
10017,10461,63,118,321,502
10017,10462,102,239,479,820
10017,10463,79,125,475,679
10017,10464,2,4,23,29
10017,10465,47,77,216,340
10017,10466,70,142,196,408
10017,10467,127,243,383,753
10017,10468,99,199,319,617
10017,10469,85,104,280,469
10017,10470,14,40,77,131
10017,10471,19,36,178,233
10017,10472,78,220,195,493
10017,10473,75,126,214,415
10017,10474,28,30,36,94
10017,10475,43,87,168,298
10017,11001,7,8,23,38
10017,11003,0,0,1,1
10017,11004,14,14,78,106
10017,11005,1,0,6,7
10017,11040,2,1,11,14
10017,11101,36,90,657,783
10017,11102,53,93,438,584
10017,11103,71,129,590,790
10017,11104,43,104,402,549
10017,11105,65,92,538,695
10017,11106,52,110,566,728
10017,11109,13,14,268,295
10017,11201,74,95,1102,1271
10017,11203,122,222,329,673
10017,11204,35,80,286,401
10017,11205,56,83,291,430
10017,11206,107,201,470,778
10017,11207,108,251,342,701
10017,11208,120,219,301,640
10017,11209,56,124,733,913
10017,11210,82,155,341,578
10017,11211,102,116,1056,1274
10017,11212,118,226,221,565
10017,11213,79,161,287,527
10017,11214,65,113,375,553
10017,11215,71,92,943,1106
10017,11216,88,124,468,680
10017,11217,50,82,565,697
10017,11218,72,109,472,653
10017,11219,67,78,200,345
10017,11220,70,155,373,598
10017,11221,130,193,459,782
10017,11222,42,79,549,670
10017,11223,46,72,305,423
10017,11224,37,60,136,233
10017,11225,89,146,483,718
10017,11226,150,304,565,1019
10017,11228,26,58,299,383
10017,11229,41,72,363,476
10017,11230,68,118,482,668
10017,11231,47,53,453,553
10017,11232,20,58,174,252
10017,11233,105,188,303,596
10017,11234,85,144,478,707
10017,11235,45,59,306,410
10017,11236,102,242,360,704
10017,11237,51,94,344,489
10017,11238,72,93,684,849
10017,11239,13,31,45,89
10017,11354,61,102,253,416
10017,11355,80,114,368,562
10017,11356,10,35,83,128
10017,11357,45,30,272,347
10017,11358,36,57,233,326
10017,11359,0,1,7,8
10017,11360,18,16,150,184
10017,11361,18,37,204,259
10017,11362,11,11,106,128
10017,11363,8,6,42,56
10017,11364,19,47,219,285
10017,11365,33,67,231,331
10017,11366,16,8,117,141
10017,11367,38,49,248,335
10017,11368,100,218,364,682
10017,11369,37,77,169,283
10017,11370,30,51,166,247
10017,11371,0,0,2,2
10017,11372,105,155,562,822
10017,11373,141,309,577,1027
10017,11374,59,94,576,729
10017,11375,70,143,1075,1288
10017,11377,138,273,783,1194
10017,11378,40,52,317,409
10017,11379,43,58,381,482
10017,11385,112,308,799,1219
10017,11411,20,40,85,145
10017,11412,26,48,86,160
10017,11413,40,65,156,261
10017,11414,17,27,172,216
10017,11415,14,42,169,225
10017,11416,24,56,126,206
10017,11417,25,60,177,262
10017,11418,44,99,203,346
10017,11419,42,102,233,377
10017,11420,41,94,212,347
10017,11421,43,97,249,389
10017,11422,34,65,117,216
10017,11423,21,49,117,187
10017,11426,16,20,102,138
10017,11427,36,46,155,237
10017,11428,17,40,119,176
10017,11429,29,43,123,195
10017,11430,0,0,4,4
10017,11432,55,118,296,469
10017,11433,32,43,75,150
10017,11434,47,73,142,262
10017,11435,52,92,299,443
10017,11436,11,21,31,63
10017,11691,47,71,96,214
10017,11692,19,32,59,110
10017,11693,12,9,43,64
10017,11694,10,18,92,120
10017,11697,5,11,39,55
10018,10001,68,120,410,598
10018,10002,209,274,735,1218
10018,10003,104,99,750,953
10018,10004,15,12,92,119
10018,10005,25,19,172,216
10018,10006,10,4,54,68
10018,10007,10,14,89,113
10018,10009,138,183,841,1162
10018,10010,61,76,442,579
10018,10011,104,141,958,1203
10018,10012,31,44,321,396
10018,10013,51,56,326,433
10018,10014,65,82,548,695
10018,10016,79,135,1007,1221
10018,10017,36,43,287,366
10018,10018,88,112,385,585
10018,10019,122,189,767,1078
10018,10021,50,68,562,680
10018,10022,31,52,490,573
10018,10023,118,140,892,1150
10018,10024,101,126,747,974
10018,10025,211,264,961,1436
10018,10026,129,179,287,595
10018,10027,181,304,428,913
10018,10028,62,66,595,723
10018,10029,265,353,448,1066
10018,10030,104,162,206,472
10018,10031,198,406,495,1099
10018,10032,232,351,359,942
10018,10033,190,272,413,875
10018,10034,113,195,249,557
10018,10035,127,159,185,471
10018,10036,110,163,550,823
10018,10037,68,95,129,292
10018,10038,42,72,295,409
10018,10039,85,138,172,395
10018,10040,146,220,305,671
10018,10044,17,23,102,142
10018,10065,44,67,428,539
10018,10069,16,11,69,96
10018,10075,41,39,374,454
10018,10119,0,0,2,2
10018,10128,72,121,823,1016
10018,10162,1,2,22,25
10018,10280,9,11,149,169
10018,10282,0,7,34,41
10018,10301,60,76,190,326
10018,10302,20,44,71,135
10018,10303,44,74,126,244
10018,10304,46,91,169,306
10018,10305,41,58,221,320
10018,10306,51,76,207,334
10018,10307,13,8,63,84
10018,10308,26,21,104,151
10018,10309,24,31,155,210
10018,10310,26,47,95,168
10018,10312,43,74,265,382
10018,10314,83,117,393,593
10018,10451,141,261,162,564
10018,10452,263,418,221,902
10018,10453,251,398,223,872
10018,10454,116,197,102,415
10018,10455,122,213,146,481
10018,10456,278,513,212,1003
10018,10457,222,384,215,821
10018,10458,190,346,271,807
10018,10459,115,272,130,517
10018,10460,164,290,144,598
10018,10461,82,157,256,495
10018,10462,186,308,343,837
10018,10463,136,200,375,711
10018,10464,11,8,33,52
10018,10465,58,97,169,324
10018,10466,105,194,185,484
10018,10467,210,350,316,876
10018,10468,181,319,249,749
10018,10469,100,179,205,484
10018,10470,24,64,53,141
10018,10471,22,45,142,209
10018,10472,156,296,190,642
10018,10473,132,253,170,555
10018,10474,33,52,22,107
10018,10475,66,103,150,319
10018,11001,7,13,15,35
10018,11004,12,20,61,93
10018,11005,2,1,3,6
10018,11040,4,5,4,13
10018,11101,89,120,413,622
10018,11102,118,161,416,695
10018,11103,121,191,544,856
10018,11104,77,140,360,577
10018,11105,91,148,469,708
10018,11106,107,176,499,782
10018,11109,5,16,154,175
10018,11201,99,139,836,1074
10018,11203,166,357,289,812
10018,11204,128,156,285,569
10018,11205,102,134,364,600
10018,11206,213,343,580,1136
10018,11207,252,413,338,1003
10018,11208,184,427,289,900
10018,11209,114,165,634,913
10018,11210,138,205,271,614
10018,11211,187,240,1121,1548
10018,11212,184,363,226,773
10018,11213,172,259,286,717
10018,11214,153,212,409,774
10018,11215,122,168,900,1190
10018,11216,159,292,567,1018
10018,11217,91,118,576,785
10018,11218,93,181,450,724
10018,11219,123,122,204,449
10018,11220,170,225,305,700
10018,11221,220,370,568,1158
10018,11222,108,124,583,815
10018,11223,124,168,349,641
10018,11224,58,105,106,269
10018,11225,168,291,442,901
10018,11226,277,534,582,1393
10018,11228,71,105,228,404
10018,11229,102,170,418,690
10018,11230,144,247,483,874
10018,11231,56,69,488,613
10018,11232,46,79,185,310
10018,11233,179,303,334,816
10018,11234,146,214,429,789
10018,11235,73,144,343,560
10018,11236,179,313,288,780
10018,11237,113,205,354,672
10018,11238,138,189,790,1117
10018,11239,23,37,27,87
10018,11354,137,155,234,526
10018,11355,168,270,370,808
10018,11356,44,64,111,219
10018,11357,59,81,238,378
10018,11358,71,104,261,436
10018,11359,0,0,2,2
10018,11360,17,31,128,176
10018,11361,28,68,152,248
10018,11362,14,40,106,160
10018,11363,5,10,32,47
10018,11364,30,81,208,319
10018,11365,78,116,249,443
10018,11366,24,42,76,142
10018,11367,75,78,202,355
10018,11368,207,393,305,905
10018,11369,95,116,181,392
10018,11370,36,71,137,244
10018,11371,1,3,1,5
10018,11372,151,259,490,900
10018,11373,289,488,602,1379
10018,11374,73,129,411,613
10018,11375,125,167,782,1074
10018,11377,253,470,702,1425
10018,11378,88,123,256,467
10018,11379,57,88,316,461
10018,11385,164,373,693,1230
10018,11411,28,44,64,136
10018,11412,36,87,76,199
10018,11413,44,94,130,268
10018,11414,29,32,136,197
10018,11415,58,53,191,302
10018,11416,39,89,116,244
10018,11417,59,115,175,349
10018,11418,58,148,202,408
10018,11419,52,159,181,392
10018,11420,59,120,221,400
10018,11421,73,155,188,416
10018,11422,37,70,85,192
10018,11423,29,73,105,207
10018,11426,14,37,64,115
10018,11427,38,71,119,228
10018,11428,37,57,108,202
10018,11429,36,80,94,210
10018,11430,1,0,5,6
10018,11432,83,170,219,472
10018,11433,34,85,73,192
10018,11434,67,137,129,333
10018,11435,87,128,262,477
10018,11436,27,39,33,99
10018,11691,50,117,105,272
10018,11692,28,49,61,138
10018,11693,24,32,60,116
10018,11694,19,18,97,134
10018,11697,4,9,23,36
10019,10001,78,73,582,733
10019,10002,179,159,812,1150
10019,10003,209,86,1432,1727
10019,10004,12,9,150,171
10019,10005,14,16,281,311
10019,10006,9,2,94,105
10019,10007,20,6,239,265
10019,10009,181,188,1028,1397
10019,10010,102,75,844,1021
10019,10011,213,116,1752,2081
10019,10012,55,52,582,689
10019,10013,73,47,682,802
10019,10014,123,62,1003,1188
10019,10016,138,111,1484,1733
10019,10017,55,34,553,642
10019,10018,73,26,218,317
10019,10019,400,355,2699,3454
10019,10021,93,84,1119,1296
10019,10022,80,67,966,1113
10019,10023,247,182,2188,2617
10019,10024,247,131,1628,2006
10019,10025,364,253,1793,2410
10019,10026,139,131,525,795
10019,10027,185,238,596,1019
10019,10028,91,92,1149,1332
10019,10029,193,300,601,1094
10019,10030,111,140,268,519
10019,10031,265,295,600,1160
10019,10032,252,283,506,1041
10019,10033,189,237,554,980
10019,10034,141,163,400,704
10019,10035,84,131,264,479
10019,10036,290,139,1017,1446
10019,10037,67,95,213,375
10019,10038,39,47,481,567
10019,10039,90,106,170,366
10019,10040,154,182,428,764
10019,10044,31,22,161,214
10019,10065,70,47,860,977
10019,10069,15,10,163,188
10019,10075,55,54,700,809
10019,10103,0,0,1,1
10019,10119,0,1,5,6
10019,10128,125,119,1510,1754
10019,10162,1,3,46,50
10019,10280,16,13,276,305
10019,10282,3,2,103,108
10019,10301,58,66,247,371
10019,10302,26,30,65,121
10019,10303,24,50,108,182
10019,10304,37,58,137,232
10019,10305,42,50,213,305
10019,10306,45,37,252,334
10019,10307,17,13,68,98
10019,10308,18,22,125,165
10019,10309,24,19,146,189
10019,10310,38,19,105,162
10019,10312,54,45,318,417
10019,10314,81,86,397,564
10019,10451,93,171,220,484
10019,10452,127,296,307,730
10019,10453,157,288,289,734
10019,10454,74,152,120,346
10019,10455,54,119,152,325
10019,10456,148,336,304,788
10019,10457,116,246,251,613
10019,10458,133,279,340,752
10019,10459,56,160,141,357
10019,10460,89,186,175,450
10019,10461,82,157,366,605
10019,10462,110,251,525,886
10019,10463,126,210,643,979
10019,10464,6,12,27,45
10019,10465,48,91,232,371
10019,10466,83,160,225,468
10019,10467,176,349,484,1009
10019,10468,139,284,405,828
10019,10469,95,146,325,566
10019,10470,28,31,105,164
10019,10471,34,41,230,305
10019,10472,84,172,194,450
10019,10473,75,161,239,475
10019,10474,17,41,40,98
10019,10475,48,62,191,301
10019,11001,1,3,19,23
10019,11003,0,1,0,1
10019,11004,8,27,67,102
10019,11005,1,2,4,7
10019,11040,1,3,2,6
10019,11101,92,100,705,897
10019,11102,110,138,651,899
10019,11103,177,165,680,1022
10019,11104,111,119,463,693
10019,11105,111,129,672,912
10019,11106,139,178,666,983
10019,11109,17,17,217,251
10019,11201,145,97,1451,1693
10019,11203,79,182,328,589
10019,11204,49,80,277,406
10019,11205,90,80,385,555
10019,11206,155,228,553,936
10019,11207,117,203,280,600
10019,11208,104,204,269,577
10019,11209,115,120,713,948
10019,11210,71,133,308,512
10019,11211,150,183,1272,1605
10019,11212,98,195,213,506
10019,11213,99,131,298,528
10019,11214,54,87,362,503
10019,11215,201,142,1237,1580
10019,11216,155,172,592,919
10019,11217,106,100,810,1016
10019,11218,112,141,531,784
10019,11219,86,94,197,377
10019,11220,103,126,377,606
10019,11221,163,227,513,903
10019,11222,75,91,724,890
10019,11223,57,76,255,388
10019,11224,38,55,132,225
10019,11225,119,169,484,772
10019,11226,189,329,618,1136
10019,11228,53,71,239,363
10019,11229,41,84,294,419
10019,11230,95,143,433,671
10019,11231,90,95,585,770
10019,11232,51,59,173,283
10019,11233,118,180,365,663
10019,11234,86,124,475,685
10019,11235,45,57,300,402
10019,11236,112,192,388,692
10019,11237,88,136,392,616
10019,11238,134,124,828,1086
10019,11239,8,26,55,89
10019,11354,76,92,257,425
10019,11355,106,126,344,576
10019,11356,22,34,114,170
10019,11357,56,51,266,373
10019,11358,35,52,226,313
10019,11359,2,0,0,2
10019,11360,22,30,123,175
10019,11361,26,16,161,203
10019,11362,16,26,82,124
10019,11363,2,5,38,45
10019,11364,31,31,168,230
10019,11365,21,45,243,309
10019,11366,25,17,97,139
10019,11367,37,56,222,315
10019,11368,98,289,451,838
10019,11369,59,105,219,383
10019,11370,32,89,177,298
10019,11371,0,1,4,5
10019,11372,141,238,585,964
10019,11373,216,403,729,1348
10019,11374,88,111,566,765
10019,11375,117,144,1135,1396
10019,11377,250,401,902,1553
10019,11378,61,95,275,431
10019,11379,60,82,376,518
10019,11385,185,265,735,1185
10019,11411,11,31,70,112
10019,11412,29,30,91,150
10019,11413,31,62,116,209
10019,11414,14,33,144,191
10019,11415,37,47,213,297
10019,11416,31,72,143,246
10019,11417,60,60,199,319
10019,11418,52,85,212,349
10019,11419,40,74,172,286
10019,11420,55,73,198,326
10019,11421,64,90,257,411
10019,11422,31,32,96,159
10019,11423,30,52,112,194
10019,11426,17,22,95,134
10019,11427,18,19,131,168
10019,11428,17,24,107,148
10019,11429,25,28,100,153
10019,11430,0,0,4,4
10019,11432,58,123,287,468
10019,11433,30,44,73,147
10019,11434,41,67,158,266
10019,11435,67,127,317,511
10019,11436,14,25,50,89
10019,11691,35,50,127,212
10019,11692,9,16,39,64
10019,11693,6,10,38,54
10019,11694,22,13,96,131
10019,11697,5,3,17,25
10020,10001,4,7,62,73
10020,10002,7,8,129,144
10020,10003,13,5,188,206
10020,10004,0,0,18,18
10020,10005,1,1,42,44
10020,10006,0,0,9,9
10020,10007,1,2,45,48
10020,10009,8,13,115,136
10020,10010,3,1,115,119
10020,10011,11,8,187,206
10020,10012,3,2,64,69
10020,10013,3,5,85,93
10020,10014,9,1,110,120
10020,10016,7,8,203,218
10020,10017,2,3,101,106
10020,10018,4,0,47,51
10020,10019,19,19,283,321
10020,10021,2,5,112,119
10020,10022,4,6,137,147
10020,10023,11,5,294,310
10020,10024,14,10,176,200
10020,10025,25,14,181,220
10020,10026,6,9,41,56
10020,10027,7,7,58,72
10020,10028,9,8,143,160
10020,10029,13,13,62,88
10020,10030,3,3,28,34
10020,10031,14,12,65,91
10020,10032,10,18,46,74
10020,10033,10,11,55,76
10020,10034,4,5,31,40
10020,10035,8,9,25,42
10020,10036,6,11,175,192
10020,10037,2,4,17,23
10020,10038,2,2,55,59
10020,10039,10,4,21,35
10020,10040,7,13,50,70
10020,10044,1,2,42,45
10020,10065,4,4,95,103
10020,10069,1,0,27,28
10020,10075,3,1,69,73
10020,10128,8,10,183,201
10020,10162,0,0,4,4
10020,10173,0,0,1,1
10020,10280,1,1,36,38
10020,10282,0,0,15,15
10020,10301,2,1,28,31
10020,10302,3,2,7,12
10020,10303,3,0,14,17
10020,10304,5,3,21,29
10020,10305,0,4,44,48
10020,10306,0,4,34,38
10020,10307,2,3,7,12
10020,10308,1,1,16,18
10020,10309,0,0,15,15
10020,10310,1,4,15,20
10020,10312,1,1,43,45
10020,10314,4,2,59,65
10020,10451,6,11,14,31
10020,10452,17,13,29,59
10020,10453,10,15,17,42
10020,10454,5,7,6,18
10020,10455,6,5,16,27
10020,10456,12,15,28,55
10020,10457,13,16,14,43
10020,10458,11,11,32,54
10020,10459,10,17,12,39
10020,10460,8,10,15,33
10020,10461,5,9,40,54
10020,10462,8,18,49,75
10020,10463,19,12,72,103
10020,10464,0,0,3,3
10020,10465,3,4,21,28
10020,10466,6,7,20,33
10020,10467,12,25,45,82
10020,10468,9,15,24,48
10020,10469,6,7,38,51
10020,10470,1,1,8,10
10020,10471,3,3,26,32
10020,10472,10,9,21,40
10020,10473,11,13,20,44
10020,10474,1,1,2,4
10020,10475,7,5,18,30
10020,11001,1,0,1,2
10020,11004,0,0,10,10
10020,11101,6,9,84,99
10020,11102,4,7,68,79
10020,11103,6,7,91,104
10020,11104,4,4,51,59
10020,11105,3,6,83,92
10020,11106,9,9,95,113
10020,11109,0,0,41,41
10020,11201,8,10,195,213
10020,11203,9,16,20,45
10020,11204,5,4,38,47
10020,11205,3,4,46,53
10020,11206,12,11,51,74
10020,11207,8,8,28,44
10020,11208,10,12,26,48
10020,11209,14,10,101,125
10020,11210,6,13,27,46
10020,11211,9,8,156,173
10020,11212,9,12,24,45
10020,11213,12,6,29,47
10020,11214,3,3,55,61
10020,11215,7,5,172,184
10020,11216,10,13,54,77
10020,11217,7,6,61,74
10020,11218,7,11,62,80
10020,11219,2,3,26,31
10020,11220,5,11,35,51
10020,11221,10,14,46,70
10020,11222,7,2,90,99
10020,11223,0,6,38,44
10020,11224,2,5,26,33
10020,11225,13,14,47,74
10020,11226,13,18,51,82
10020,11228,3,4,30,37
10020,11229,2,5,58,65
10020,11230,7,11,40,58
10020,11231,4,3,55,62
10020,11232,5,3,17,25
10020,11233,11,10,22,43
10020,11234,6,4,59,69
10020,11235,3,6,41,50
10020,11236,8,11,36,55
10020,11237,11,11,31,53
10020,11238,12,4,99,115
10020,11239,0,2,2,4
10020,11354,6,6,42,54
10020,11355,3,7,46,56
10020,11356,4,1,16,21
10020,11357,2,2,37,41
10020,11358,1,4,30,35
10020,11360,1,2,10,13
10020,11361,1,3,23,27
10020,11362,2,1,16,19
10020,11363,0,1,4,5
10020,11364,1,1,36,38
10020,11365,2,5,30,37
10020,11366,3,2,10,15
10020,11367,4,2,39,45
10020,11368,12,18,51,81
10020,11369,3,8,27,38
10020,11370,2,4,24,30
10020,11372,9,14,75,98
10020,11373,10,25,100,135
10020,11374,2,6,63,71
10020,11375,7,13,174,194
10020,11377,13,19,127,159
10020,11378,2,5,39,46
10020,11379,1,7,37,45
10020,11385,17,15,81,113
10020,11411,1,1,6,8
10020,11412,2,1,10,13
10020,11413,5,2,10,17
10020,11414,0,2,21,23
10020,11415,2,2,25,29
10020,11416,1,7,13,21
10020,11417,1,1,26,28
10020,11418,7,4,26,37
10020,11419,1,9,23,33
10020,11420,6,4,39,49
10020,11421,5,7,31,43
10020,11422,0,1,12,13
10020,11423,4,3,16,23
10020,11426,1,1,10,12
10020,11427,3,4,11,18
10020,11428,3,0,25,28
10020,11429,3,3,14,20
10020,11432,3,5,27,35
10020,11433,5,5,12,22
10020,11434,4,4,19,27
10020,11435,5,10,39,54
10020,11436,0,3,10,13
10020,11691,6,7,12,25
10020,11692,1,1,3,5
10020,11693,1,1,4,6
10020,11694,1,0,18,19
10020,11697,1,0,2,3
10021,10001,20,7,41,68
10021,10002,37,49,109,195
10021,10003,33,34,137,204
10021,10004,3,2,20,25
10021,10005,3,4,27,34
10021,10006,2,0,8,10
10021,10007,4,2,18,24
10021,10009,30,48,147,225
10021,10010,15,20,89,124
10021,10011,22,34,125,181
10021,10012,9,6,31,46
10021,10013,11,8,36,55
10021,10014,9,12,55,76
10021,10016,29,36,140,205
10021,10017,12,5,56,73
10021,10018,4,6,17,27
10021,10019,34,28,92,154
10021,10021,105,157,609,871
10021,10022,31,23,124,178
10021,10023,28,62,164,254
10021,10024,35,45,172,252
10021,10025,58,93,191,342
10021,10026,16,27,56,99
10021,10027,35,41,98,174
10021,10028,53,43,299,395
10021,10029,66,106,228,400
10021,10030,12,22,42,76
10021,10031,30,49,97,176
10021,10032,34,59,71,164
10021,10033,30,60,88,178
10021,10034,20,38,64,122
10021,10035,29,37,75,141
10021,10036,16,22,53,91
10021,10037,12,6,33,51
10021,10038,13,6,44,63
10021,10039,23,25,32,80
10021,10040,35,39,58,132
10021,10044,12,11,25,48
10021,10065,40,47,232,319
10021,10069,1,9,15,25
10021,10075,47,59,252,358
10021,10128,39,65,360,464
10021,10162,1,7,23,31
10021,10280,8,1,14,23
10021,10282,0,2,6,8
10021,10301,14,11,38,63
10021,10302,5,4,20,29
10021,10303,4,6,34,44
10021,10304,6,16,45,67
10021,10305,11,12,51,74
10021,10306,11,23,62,96
10021,10307,1,5,21,27
10021,10308,5,9,26,40
10021,10309,6,8,42,56
10021,10310,4,6,30,40
10021,10312,11,23,79,113
10021,10314,24,49,115,188
10021,10451,18,52,65,135
10021,10452,38,79,86,203
10021,10453,45,51,89,185
10021,10454,15,43,36,94
10021,10455,19,23,58,100
10021,10456,34,77,67,178
10021,10457,35,46,66,147
10021,10458,19,61,69,149
10021,10459,18,43,54,115
10021,10460,26,39,57,122
10021,10461,8,35,118,161
10021,10462,32,73,151,256
10021,10463,21,60,93,174
10021,10464,1,3,9,13
10021,10465,15,25,76,116
10021,10466,9,33,62,104
10021,10467,26,56,119,201
10021,10468,34,62,100,196
10021,10469,24,27,66,117
10021,10470,5,7,22,34
10021,10471,15,13,41,69
10021,10472,46,67,74,187
10021,10473,16,53,59,128
10021,10474,9,4,10,23
10021,10475,14,24,84,122
10021,11001,1,1,7,9
10021,11004,1,7,12,20
10021,11005,0,1,2,3
10021,11040,0,4,4,8
10021,11101,17,34,73,124
10021,11102,22,41,108,171
10021,11103,35,64,166,265
10021,11104,25,37,96,158
10021,11105,32,32,124,188
10021,11106,26,34,121,181
10021,11109,2,3,23,28
10021,11201,27,21,131,179
10021,11203,11,44,90,145
10021,11204,5,18,33,56
10021,11205,16,13,46,75
10021,11206,42,41,79,162
10021,11207,28,54,128,210
10021,11208,22,48,81,151
10021,11209,15,31,72,118
10021,11210,17,26,62,105
10021,11211,26,36,157,219
10021,11212,16,67,66,149
10021,11213,30,43,84,157
10021,11214,18,26,61,105
10021,11215,26,32,119,177
10021,11216,30,34,97,161
10021,11217,18,27,79,124
10021,11218,23,21,49,93
10021,11219,13,14,46,73
10021,11220,24,31,57,112
10021,11221,35,41,81,157
10021,11222,30,23,106,159
10021,11223,15,11,40,66
10021,11224,11,6,25,42
10021,11225,13,24,75,112
10021,11226,21,57,101,179
10021,11228,7,11,32,50
10021,11229,16,15,45,76
10021,11230,22,18,61,101
10021,11231,11,27,77,115
10021,11232,12,13,19,44
10021,11233,16,45,52,113
10021,11234,4,47,73,124
10021,11235,13,13,48,74
10021,11236,19,42,103,164
10021,11237,17,41,58,116
10021,11238,18,20,98,136
10021,11239,6,12,15,33
10021,11354,26,30,61,117
10021,11355,52,49,77,178
10021,11356,5,16,24,45
10021,11357,25,22,58,105
10021,11358,18,23,37,78
10021,11359,1,2,0,3
10021,11360,4,5,17,26
10021,11361,7,10,20,37
10021,11362,4,14,15,33
10021,11363,1,3,5,9
10021,11364,7,10,15,32
10021,11365,15,22,40,77
10021,11366,7,2,14,23
10021,11367,20,20,56,96
10021,11368,52,90,97,239
10021,11369,26,30,77,133
10021,11370,16,35,54,105
10021,11372,54,66,146,266
10021,11373,91,139,168,398
10021,11374,27,35,112,174
10021,11375,47,48,193,288
10021,11377,81,119,204,404
10021,11378,29,41,115,185
10021,11379,14,32,96,142
10021,11385,53,113,204,370
10021,11411,4,8,25,37
10021,11412,3,10,32,45
10021,11413,5,16,47,68
10021,11414,4,9,28,41
10021,11415,6,11,31,48
10021,11416,5,23,37,65
10021,11417,6,9,30,45
10021,11418,18,20,58,96
10021,11419,11,23,51,85
10021,11420,6,21,74,101
10021,11421,12,24,63,99
10021,11422,6,13,26,45
10021,11423,7,27,21,55
10021,11426,3,4,18,25
10021,11427,7,8,33,48
10021,11428,3,7,24,34
10021,11429,6,17,28,51
10021,11432,22,26,75,123
10021,11433,3,18,26,47
10021,11434,6,25,54,85
10021,11435,19,26,54,99
10021,11436,4,11,16,31
10021,11691,3,5,36,44
10021,11692,0,4,11,15
10021,11693,1,3,5,9
10021,11694,2,3,15,20
10021,11697,0,0,4,4
10022,10001,50,59,499,608
10022,10002,102,138,739,979
10022,10003,129,93,1365,1587
10022,10004,12,11,157,180
10022,10005,10,20,275,305
10022,10006,8,7,103,118
10022,10007,14,19,212,245
10022,10009,98,133,972,1203
10022,10010,78,52,949,1079
10022,10011,111,103,1539,1753
10022,10012,31,32,559,622
10022,10013,61,54,546,661
10022,10014,63,70,1030,1163
10022,10016,83,113,1800,1996
10022,10017,36,59,725,820
10022,10018,27,18,189,234
10022,10019,123,133,1344,1600
10022,10021,66,83,1353,1502
10022,10022,146,173,1763,2082
10022,10023,101,111,1383,1595
10022,10024,123,67,1144,1334
10022,10025,175,136,1158,1469
10022,10026,68,86,370,524
10022,10027,93,142,448,683
10022,10028,71,100,1406,1577
10022,10029,127,246,630,1003
10022,10030,49,66,152,267
10022,10031,111,179,375,665
10022,10032,75,166,309,550
10022,10033,84,152,356,592
10022,10034,52,117,271,440
10022,10035,70,110,234,414
10022,10036,134,74,659,867
10022,10037,26,69,127,222
10022,10038,16,37,424,477
10022,10039,38,69,112,219
10022,10040,62,112,242,416
10022,10044,16,27,205,248
10022,10065,80,112,1059,1251
10022,10069,9,9,117,135
10022,10075,55,50,831,936
10022,10119,0,0,3,3
10022,10128,124,116,1660,1900
10022,10162,2,4,41,47
10022,10173,1,0,2,3
10022,10280,6,5,270,281
10022,10282,2,2,95,99
10022,10301,31,29,179,239
10022,10302,12,20,48,80
10022,10303,6,30,58,94
10022,10304,24,28,139,191
10022,10305,17,41,172,230
10022,10306,23,29,245,297
10022,10307,9,10,52,71
10022,10308,14,10,118,142
10022,10309,7,20,133,160
10022,10310,20,17,80,117
10022,10312,15,35,235,285
10022,10314,40,78,377,495
10022,10451,64,135,149,348
10022,10452,99,190,192,481
10022,10453,79,215,150,444
10022,10454,54,104,90,248
10022,10455,51,95,87,233
10022,10456,102,211,190,503
10022,10457,77,169,186,432
10022,10458,64,158,204,426
10022,10459,52,113,136,301
10022,10460,60,136,108,304
10022,10461,52,121,313,486
10022,10462,106,178,421,705
10022,10463,87,105,502,694
10022,10464,8,15,15,38
10022,10465,40,43,188,271
10022,10466,49,112,200,361
10022,10467,110,197,369,676
10022,10468,86,182,225,493
10022,10469,56,109,223,388
10022,10470,15,22,88,125
10022,10471,26,48,206,280
10022,10472,79,146,195,420
10022,10473,76,99,190,365
10022,10474,15,30,21,66
10022,10475,38,58,167,263
10022,11001,3,5,12,20
10022,11003,0,0,1,1
10022,11004,5,20,55,80
10022,11005,0,5,6,11
10022,11040,0,2,12,14
10022,11101,59,79,638,776
10022,11102,73,95,576,744
10022,11103,85,162,621,868
10022,11104,53,90,349,492
10022,11105,65,113,580,758
10022,11106,93,124,648,865
10022,11109,13,12,193,218
10022,11201,87,71,1166,1324
10022,11203,75,149,271,495
10022,11204,26,69,187,282
10022,11205,49,56,313,418
10022,11206,104,161,473,738
10022,11207,80,174,223,477
10022,11208,96,178,202,476
10022,11209,78,129,543,750
10022,11210,60,101,258,419
10022,11211,95,148,1181,1424
10022,11212,70,137,138,345
10022,11213,70,134,261,465
10022,11214,55,69,290,414
10022,11215,66,95,840,1001
10022,11216,71,120,377,568
10022,11217,41,46,562,649
10022,11218,48,71,424,543
10022,11219,44,73,172,289
10022,11220,68,119,272,459
10022,11221,77,176,460,713
10022,11222,50,79,584,713
10022,11223,42,69,237,348
10022,11224,28,40,116,184
10022,11225,70,111,335,516
10022,11226,89,213,418,720
10022,11228,37,55,218,310
10022,11229,43,91,273,407
10022,11230,64,113,396,573
10022,11231,33,39,464,536
10022,11232,25,43,127,195
10022,11233,66,137,266,469
10022,11234,75,107,370,552
10022,11235,42,70,233,345
10022,11236,77,152,267,496
10022,11237,66,110,315,491
10022,11238,59,96,614,769
10022,11239,23,14,37,74
10022,11354,58,72,241,371
10022,11355,88,114,349,551
10022,11356,17,49,109,175
10022,11357,23,41,240,304
10022,11358,31,59,237,327
10022,11359,1,1,1,3
10022,11360,8,11,138,157
10022,11361,28,30,182,240
10022,11362,17,30,114,161
10022,11363,4,8,53,65
10022,11364,26,48,201,275
10022,11365,31,51,179,261
10022,11366,12,23,72,107
10022,11367,27,56,232,315
10022,11368,94,217,293,604
10022,11369,40,92,181,313
10022,11370,56,51,161,268
10022,11371,0,1,1,2
10022,11372,91,189,504,784
10022,11373,165,359,608,1132
10022,11374,58,132,508,698
10022,11375,75,153,1088,1316
10022,11377,145,285,762,1192
10022,11378,42,95,331,468
10022,11379,42,80,347,469
10022,11385,132,228,732,1092
10022,11411,22,20,82,124
10022,11412,22,31,59,112
10022,11413,39,60,102,201
10022,11414,23,34,122,179
10022,11415,15,49,156,220
10022,11416,23,37,96,156
10022,11417,35,48,143,226
10022,11418,42,61,156,259
10022,11419,42,77,136,255
10022,11420,31,81,200,312
10022,11421,39,78,206,323
10022,11422,27,36,105,168
10022,11423,18,42,117,177
10022,11426,13,13,88,114
10022,11427,19,25,111,155
10022,11428,19,31,101,151
10022,11429,18,36,72,126
10022,11430,2,0,1,3
10022,11432,40,98,241,379
10022,11433,20,41,58,119
10022,11434,40,69,102,211
10022,11435,36,104,250,390
10022,11436,18,21,37,76
10022,11691,21,49,64,134
10022,11692,14,13,24,51
10022,11693,14,20,50,84
10022,11694,10,12,103,125
10022,11697,1,3,44,48
10023,10001,39,28,70,137
10023,10002,58,83,153,294
10023,10003,41,33,124,198
10023,10004,4,4,13,21
10023,10005,3,2,19,24
10023,10006,0,1,5,6
10023,10007,12,4,21,37
10023,10009,74,73,153,300
10023,10010,20,27,74,121
10023,10011,69,37,153,259
10023,10012,22,18,54,94
10023,10013,24,20,91,135
10023,10014,34,27,101,162
10023,10016,48,31,132,211
10023,10017,18,18,37,73
10023,10018,14,12,35,61
10023,10019,100,100,257,457
10023,10021,46,39,127,212
10023,10022,29,19,72,120
10023,10023,352,255,704,1311
10023,10024,153,139,437,729
10023,10025,247,224,538,1009
10023,10026,87,112,153,352
10023,10027,137,136,202,475
10023,10028,52,46,152,250
10023,10029,129,177,188,494
10023,10030,57,70,93,220
10023,10031,134,152,211,497
10023,10032,152,153,217,522
10023,10033,123,141,215,479
10023,10034,91,122,151,364
10023,10035,51,75,77,203
10023,10036,75,64,132,271
10023,10037,21,51,69,141
10023,10038,18,22,56,96
10023,10039,45,64,70,179
10023,10040,90,131,168,389
10023,10044,14,6,34,54
10023,10065,26,19,94,139
10023,10069,17,23,63,103
10023,10075,28,23,80,131
10023,10103,0,0,1,1
10023,10128,78,60,186,324
10023,10162,3,3,5,11
10023,10280,8,5,26,39
10023,10282,2,2,8,12
10023,10301,36,19,49,104
10023,10302,13,16,32,61
10023,10303,21,16,33,70
10023,10304,23,25,70,118
10023,10305,17,28,69,114
10023,10306,30,52,94,176
10023,10307,8,10,25,43
10023,10308,15,21,56,92
10023,10309,21,18,44,83
10023,10310,21,25,31,77
10023,10312,30,30,110,170
10023,10314,57,39,149,245
10023,10451,57,110,115,282
10023,10452,76,128,141,345
10023,10453,71,155,117,343
10023,10454,34,66,50,150
10023,10455,46,63,64,173
10023,10456,76,157,130,363
10023,10457,66,145,115,326
10023,10458,58,105,98,261
10023,10459,52,96,71,219
10023,10460,45,85,72,202
10023,10461,27,29,90,146
10023,10462,62,92,113,267
10023,10463,73,92,203,368
10023,10464,1,4,14,19
10023,10465,18,36,78,132
10023,10466,37,88,86,211
10023,10467,65,108,116,289
10023,10468,52,101,120,273
10023,10469,34,67,95,196
10023,10470,7,19,26,52
10023,10471,32,27,65,124
10023,10472,48,79,90,217
10023,10473,32,61,94,187
10023,10474,11,20,9,40
10023,10475,15,53,85,153
10023,11001,1,1,12,14
10023,11003,0,0,1,1
10023,11004,6,6,14,26
10023,11005,2,2,5,9
10023,11040,1,2,7,10
10023,11101,26,35,82,143
10023,11102,59,60,160,279
10023,11103,75,70,172,317
10023,11104,38,45,103,186
10023,11105,69,56,175,300
10023,11106,60,80,145,285
10023,11109,3,4,27,34
10023,11201,64,44,213,321
10023,11203,38,77,91,206
10023,11204,19,37,68,124
10023,11205,35,35,107,177
10023,11206,62,92,141,295
10023,11207,41,81,107,229
10023,11208,45,72,89,206
10023,11209,21,53,114,188
10023,11210,37,42,70,149
10023,11211,78,81,200,359
10023,11212,49,79,80,208
10023,11213,45,74,114,233
10023,11214,27,43,84,154
10023,11215,71,70,210,351
10023,11216,53,81,147,281
10023,11217,42,57,121,220
10023,11218,37,28,72,137
10023,11219,36,35,72,143
10023,11220,41,46,76,163
10023,11221,80,114,176,370
10023,11222,29,41,134,204
10023,11223,45,31,79,155
10023,11224,17,23,55,95
10023,11225,29,55,93,177
10023,11226,55,116,116,287
10023,11228,17,13,56,86
10023,11229,30,38,77,145
10023,11230,50,57,86,193
10023,11231,38,36,117,191
10023,11232,15,18,40,73
10023,11233,46,66,94,206
10023,11234,30,53,101,184
10023,11235,27,29,74,130
10023,11236,36,68,107,211
10023,11237,36,53,94,183
10023,11238,69,69,186,324
10023,11239,5,14,12,31
10023,11354,41,46,78,165
10023,11355,62,87,73,222
10023,11356,20,28,45,93
10023,11357,22,38,88,148
10023,11358,22,28,45,95
10023,11360,16,10,45,71
10023,11361,11,15,37,63
10023,11362,7,8,25,40
10023,11363,3,2,7,12
10023,11364,13,19,47,79
10023,11365,20,19,53,92
10023,11366,2,5,14,21
10023,11367,29,20,59,108
10023,11368,64,124,145,333
10023,11369,30,54,72,156
10023,11370,19,40,63,122
10023,11371,0,0,1,1
10023,11372,88,101,179,368
10023,11373,87,161,154,402
10023,11374,18,36,112,166
10023,11375,64,41,139,244
10023,11377,106,139,228,473
10023,11378,51,52,104,207
10023,11379,23,46,112,181
10023,11385,95,137,247,479
10023,11411,7,12,20,39
10023,11412,13,26,36,75
10023,11413,10,22,38,70
10023,11414,11,23,26,60
10023,11415,15,16,19,50
10023,11416,11,18,26,55
10023,11417,11,21,32,64
10023,11418,31,36,37,104
10023,11419,15,30,53,98
10023,11420,21,33,40,94
10023,11421,15,31,52,98
10023,11422,11,20,42,73
10023,11423,10,17,37,64
10023,11426,9,9,19,37
10023,11427,14,11,26,51
10023,11428,12,13,16,41
10023,11429,9,15,33,57
10023,11432,35,47,86,168
10023,11433,11,19,38,68
10023,11434,23,47,77,147
10023,11435,26,46,67,139
10023,11436,7,13,22,42
10023,11691,13,29,56,98
10023,11692,4,6,20,30
10023,11693,2,7,11,20
10023,11694,6,15,25,46
10023,11697,0,2,7,9
10024,10001,12,21,31,64
10024,10002,36,47,41,124
10024,10003,12,25,49,86
10024,10004,4,5,10,19
10024,10005,9,3,8,20
10024,10006,1,0,4,5
10024,10007,0,1,2,3
10024,10009,35,38,56,129
10024,10010,13,7,35,55
10024,10011,25,27,66,118
10024,10012,11,7,14,32
10024,10013,11,13,12,36
10024,10014,6,17,16,39
10024,10016,17,30,49,96
10024,10017,11,4,11,26
10024,10018,8,9,17,34
10024,10019,41,37,68,146
10024,10021,11,17,52,80
10024,10022,9,13,32,54
10024,10023,58,73,132,263
10024,10024,201,248,475,924
10024,10025,150,173,331,654
10024,10026,44,73,95,212
10024,10027,75,82,95,252
10024,10028,24,13,83,120
10024,10029,87,116,100,303
10024,10030,32,60,38,130
10024,10031,77,139,134,350
10024,10032,73,92,76,241
10024,10033,53,76,90,219
10024,10034,40,78,63,181
10024,10035,21,44,45,110
10024,10036,26,41,33,100
10024,10037,22,29,22,73
10024,10038,6,13,25,44
10024,10039,19,45,31,95
10024,10040,46,73,93,212
10024,10044,4,1,9,14
10024,10065,13,15,36,64
10024,10069,5,1,14,20
10024,10075,7,9,44,60
10024,10128,30,33,85,148
10024,10162,1,1,3,5
10024,10280,5,3,5,13
10024,10282,1,0,0,1
10024,10301,9,13,20,42
10024,10302,5,7,8,20
10024,10303,4,14,12,30
10024,10304,9,15,27,51
10024,10305,9,17,18,44
10024,10306,5,17,22,44
10024,10307,0,5,9,14
10024,10308,6,3,18,27
10024,10309,11,5,19,35
10024,10310,3,6,8,17
10024,10312,4,13,34,51
10024,10314,14,27,32,73
10024,10451,33,54,39,126
10024,10452,47,89,52,188
10024,10453,44,97,50,191
10024,10454,19,52,22,93
10024,10455,26,47,49,122
10024,10456,47,115,65,227
10024,10457,45,76,47,168
10024,10458,24,73,43,140
10024,10459,21,61,28,110
10024,10460,21,65,36,122
10024,10461,32,35,36,103
10024,10462,33,63,78,174
10024,10463,37,64,90,191
10024,10464,2,0,8,10
10024,10465,15,21,42,78
10024,10466,41,61,57,159
10024,10467,56,95,66,217
10024,10468,37,84,52,173
10024,10469,22,53,51,126
10024,10470,6,21,20,47
10024,10471,10,13,31,54
10024,10472,32,68,43,143
10024,10473,30,56,56,142
10024,10474,8,12,6,26
10024,10475,24,30,28,82
10024,11001,1,2,1,4
10024,11004,3,3,7,13
10024,11101,17,24,42,83
10024,11102,25,35,48,108
10024,11103,33,56,65,154
10024,11104,19,32,29,80
10024,11105,32,25,74,131
10024,11106,19,45,47,111
10024,11109,0,0,6,6
10024,11201,24,22,100,146
10024,11203,12,39,52,103
10024,11204,13,23,34,70
10024,11205,15,23,28,66
10024,11206,57,57,59,173
10024,11207,33,48,44,125
10024,11208,23,55,40,118
10024,11209,13,27,36,76
10024,11210,14,30,38,82
10024,11211,34,52,69,155
10024,11212,35,37,47,119
10024,11213,32,47,40,119
10024,11214,13,30,26,69
10024,11215,24,25,92,141
10024,11216,27,46,52,125
10024,11217,18,25,48,91
10024,11218,11,17,25,53
10024,11219,16,21,18,55
10024,11220,22,27,34,83
10024,11221,38,63,58,159
10024,11222,34,29,68,131
10024,11223,14,23,27,64
10024,11224,4,6,14,24
10024,11225,17,31,37,85
10024,11226,19,68,50,137
10024,11228,10,14,14,38
10024,11229,16,26,31,73
10024,11230,18,23,32,73
10024,11231,8,13,34,55
10024,11232,6,10,18,34
10024,11233,16,52,32,100
10024,11234,17,31,34,82
10024,11235,15,15,26,56
10024,11236,19,49,45,113
10024,11237,18,61,32,111
10024,11238,29,24,65,118
10024,11239,4,8,8,20
10024,11354,29,27,35,91
10024,11355,55,40,31,126
10024,11356,12,10,22,44
10024,11357,15,19,28,62
10024,11358,9,20,14,43
10024,11359,0,1,0,1
10024,11360,9,11,10,30
10024,11361,3,13,14,30
10024,11362,2,9,6,17
10024,11363,0,4,1,5
10024,11364,5,9,16,30
10024,11365,7,15,24,46
10024,11366,3,3,4,10
10024,11367,15,14,21,50
10024,11368,43,87,55,185
10024,11369,26,28,27,81
10024,11370,14,22,19,55
10024,11371,0,2,0,2
10024,11372,34,49,60,143
10024,11373,75,75,77,227
10024,11374,22,20,58,100
10024,11375,30,35,53,118
10024,11377,79,91,97,267
10024,11378,27,26,45,98
10024,11379,16,19,63,98
10024,11385,56,95,94,245
10024,11411,2,7,6,15
10024,11412,3,15,16,34
10024,11413,9,9,12,30
10024,11414,7,9,11,27
10024,11415,4,11,12,27
10024,11416,8,10,18,36
10024,11417,2,7,15,24
10024,11418,7,16,18,41
10024,11419,8,24,24,56
10024,11420,13,21,25,59
10024,11421,4,24,25,53
10024,11422,5,3,18,26
10024,11423,9,11,10,30
10024,11426,1,4,5,10
10024,11427,7,3,10,20
10024,11428,4,10,12,26
10024,11429,3,10,9,22
10024,11432,10,25,24,59
10024,11433,6,13,15,34
10024,11434,17,17,23,57
10024,11435,10,24,17,51
10024,11436,2,6,9,17
10024,11691,4,11,9,24
10024,11692,5,3,6,14
10024,11693,1,1,1,3
10024,11694,4,5,4,13
10024,11697,0,1,0,1
10025,10001,7,21,27,55
10025,10002,43,65,64,172
10025,10003,23,20,42,85
10025,10004,3,3,6,12
10025,10005,0,2,9,11
10025,10006,1,1,5,7
10025,10007,1,2,4,7
10025,10009,24,44,52,120
10025,10010,7,13,25,45
10025,10011,18,37,60,115
10025,10012,14,9,31,54
10025,10013,7,10,21,38
10025,10014,10,6,34,50
10025,10016,18,22,58,98
10025,10017,5,7,15,27
10025,10018,4,11,10,25
10025,10019,23,30,166,219
10025,10021,8,16,25,49
10025,10022,9,16,33,58
10025,10023,27,38,161,226
10025,10024,46,72,162,280
10025,10025,335,424,720,1479
10025,10026,54,110,106,270
10025,10027,83,169,165,417
10025,10028,14,18,65,97
10025,10029,73,106,116,295
10025,10030,22,62,52,136
10025,10031,66,138,127,331
10025,10032,55,118,117,290
10025,10033,63,98,91,252
10025,10034,19,88,89,196
10025,10035,32,60,53,145
10025,10036,24,20,33,77
10025,10037,17,43,40,100
10025,10038,2,13,22,37
10025,10039,20,40,43,103
10025,10040,32,76,97,205
10025,10044,4,4,8,16
10025,10065,7,7,21,35
10025,10069,0,6,20,26
10025,10075,5,11,30,46
10025,10119,0,0,1,1
10025,10128,25,50,85,160
10025,10162,0,0,2,2
10025,10173,0,1,0,1
10025,10280,3,2,6,11
10025,10282,1,0,10,11
10025,10301,11,11,12,34
10025,10302,3,6,9,18
10025,10303,2,3,11,16
10025,10304,9,10,14,33
10025,10305,13,10,25,48
10025,10306,21,12,30,63
10025,10307,4,3,9,16
10025,10308,8,7,10,25
10025,10309,11,9,9,29
10025,10310,9,5,9,23
10025,10312,22,18,24,64
10025,10314,22,19,43,84
10025,10451,36,87,51,174
10025,10452,48,124,68,240
10025,10453,50,132,71,253
10025,10454,18,56,42,116
10025,10455,34,60,38,132
10025,10456,45,145,78,268
10025,10457,41,122,70,233
10025,10458,43,118,97,258
10025,10459,26,68,40,134
10025,10460,26,76,56,158
10025,10461,24,56,65,145
10025,10462,32,87,105,224
10025,10463,48,112,148,308
10025,10464,6,8,2,16
10025,10465,18,29,37,84
10025,10466,33,58,65,156
10025,10467,72,123,127,322
10025,10468,41,145,96,282
10025,10469,25,47,85,157
10025,10470,13,16,17,46
10025,10471,18,28,55,101
10025,10472,36,89,68,193
10025,10473,34,53,61,148
10025,10474,8,11,8,27
10025,10475,5,48,45,98
10025,11001,1,0,3,4
10025,11003,0,0,1,1
10025,11004,5,4,6,15
10025,11040,0,0,1,1
10025,11101,18,30,27,75
10025,11102,28,32,63,123
10025,11103,27,27,55,109
10025,11104,12,34,33,79
10025,11105,19,44,51,114
10025,11106,24,32,57,113
10025,11109,0,2,15,17
10025,11201,19,35,56,110
10025,11203,20,59,66,145
10025,11204,8,16,17,41
10025,11205,16,33,37,86
10025,11206,22,40,58,120
10025,11207,19,55,60,134
10025,11208,13,37,41,91
10025,11209,15,14,39,68
10025,11210,14,30,57,101
10025,11211,30,52,62,144
10025,11212,26,50,48,124
10025,11213,26,36,55,117
10025,11214,10,22,34,66
10025,11215,20,14,67,101
10025,11216,18,33,45,96
10025,11217,19,25,28,72
10025,11218,19,18,36,73
10025,11219,20,22,21,63
10025,11220,25,30,28,83
10025,11221,39,51,56,146
10025,11222,11,17,42,70
10025,11223,6,19,29,54
10025,11224,6,17,16,39
10025,11225,11,30,37,78
10025,11226,18,44,88,150
10025,11228,5,9,13,27
10025,11229,10,12,27,49
10025,11230,13,35,44,92
10025,11231,9,12,34,55
10025,11232,6,7,9,22
10025,11233,13,46,38,97
10025,11234,18,35,54,107
10025,11235,3,13,35,51
10025,11236,16,56,84,156
10025,11237,16,39,35,90
10025,11238,25,36,44,105
10025,11239,2,9,2,13
10025,11354,24,26,34,84
10025,11355,47,42,53,142
10025,11356,3,25,7,35
10025,11357,12,13,29,54
10025,11358,9,15,30,54
10025,11359,0,1,0,1
10025,11360,6,10,8,24
10025,11361,4,14,15,33
10025,11362,1,5,9,15
10025,11363,2,1,2,5
10025,11364,8,7,19,34
10025,11365,9,9,22,40
10025,11366,4,3,5,12
10025,11367,10,9,22,41
10025,11368,46,86,58,190
10025,11369,19,27,36,82
10025,11370,11,25,24,60
10025,11371,0,1,1,2
10025,11372,30,81,78,189
10025,11373,107,113,72,292
10025,11374,17,16,33,66
10025,11375,29,32,72,133
10025,11377,61,122,93,276
10025,11378,19,38,38,95
10025,11379,15,18,43,76
10025,11385,45,81,103,229
10025,11411,3,9,20,32
10025,11412,4,18,26,48
10025,11413,4,18,35,57
10025,11414,3,3,16,22
10025,11415,4,6,16,26
10025,11416,6,14,21,41
10025,11417,3,9,20,32
10025,11418,10,12,21,43
10025,11419,4,21,31,56
10025,11420,11,21,31,63
10025,11421,10,21,32,63
10025,11422,3,8,21,32
10025,11423,1,18,11,30
10025,11426,1,4,8,13
10025,11427,3,10,13,26
10025,11428,3,6,14,23
10025,11429,2,11,21,34
10025,11432,22,16,40,78
10025,11433,7,16,18,41
10025,11434,10,20,30,60
10025,11435,12,22,18,52
10025,11436,3,9,13,25
10025,11691,4,18,15,37
10025,11692,2,7,3,12
10025,11693,0,7,2,9
10025,11694,4,8,10,22
10025,11697,0,1,0,1
10026,10001,9,2,2,13
10026,10002,2,9,16,27
10026,10003,2,3,11,16
10026,10004,3,1,2,6
10026,10005,0,1,2,3
10026,10007,1,0,0,1
10026,10009,2,5,10,17
10026,10010,3,1,7,11
10026,10011,3,2,12,17
10026,10012,2,1,5,8
10026,10013,2,1,4,7
10026,10014,4,3,7,14
10026,10016,1,5,10,16
10026,10017,1,1,2,4
10026,10018,1,4,1,6
10026,10019,7,4,12,23
10026,10021,2,3,13,18
10026,10022,1,2,11,14
10026,10023,4,5,13,22
10026,10024,8,4,15,27
10026,10025,14,27,48,89
10026,10026,63,116,67,246
10026,10027,31,60,47,138
10026,10028,0,3,14,17
10026,10029,35,54,48,137
10026,10030,18,32,17,67
10026,10031,24,30,37,91
10026,10032,17,26,15,58
10026,10033,5,16,18,39
10026,10034,10,12,9,31
10026,10035,22,27,13,62
10026,10036,2,3,10,15
10026,10037,17,14,11,42
10026,10038,6,2,1,9
10026,10039,14,22,11,47
10026,10040,6,11,17,34
10026,10044,1,0,1,2
10026,10065,1,5,8,14
10026,10069,0,0,1,1
10026,10075,1,0,10,11
10026,10128,6,6,25,37
10026,10173,0,1,0,1
10026,10280,1,0,0,1
10026,10301,1,1,3,5
10026,10302,1,2,4,7
10026,10303,0,2,4,6
10026,10304,1,6,3,10
10026,10305,1,0,6,7
10026,10306,0,0,5,5
10026,10307,0,0,1,1
10026,10308,0,1,2,3
10026,10309,0,1,8,9
10026,10310,1,1,5,7
10026,10312,3,6,8,17
10026,10314,1,5,14,20
10026,10451,5,24,11,40
10026,10452,12,26,17,55
10026,10453,23,33,21,77
10026,10454,7,19,7,33
10026,10455,2,28,12,42
10026,10456,18,41,20,79
10026,10457,12,28,12,52
10026,10458,15,19,22,56
10026,10459,8,20,10,38
10026,10460,18,18,13,49
10026,10461,7,12,18,37
10026,10462,17,34,28,79
10026,10463,9,22,28,59
10026,10464,0,0,1,1
10026,10465,4,8,11,23
10026,10466,9,20,19,48
10026,10467,19,32,23,74
10026,10468,22,31,19,72
10026,10469,12,23,22,57
10026,10470,2,5,6,13
10026,10471,2,4,8,14
10026,10472,10,16,10,36
10026,10473,14,22,15,51
10026,10474,1,0,3,4
10026,10475,2,17,13,32
10026,11001,0,1,0,1
10026,11004,0,1,2,3
10026,11005,0,0,1,1
10026,11101,4,8,7,19
10026,11102,5,7,19,31
10026,11103,4,4,19,27
10026,11104,4,4,9,17
10026,11105,3,5,14,22
10026,11106,7,2,16,25
10026,11109,0,0,2,2
10026,11201,1,2,13,16
10026,11203,5,6,8,19
10026,11204,5,3,3,11
10026,11205,2,2,7,11
10026,11206,5,10,14,29
10026,11207,7,5,8,20
10026,11208,4,6,13,23
10026,11209,6,3,9,18
10026,11210,3,4,5,12
10026,11211,10,4,19,33
10026,11212,6,10,13,29
10026,11213,5,3,18,26
10026,11214,5,4,7,16
10026,11215,1,1,11,13
10026,11216,0,4,6,10
10026,11217,0,1,7,8
10026,11218,7,0,7,14
10026,11219,0,2,2,4
10026,11220,5,3,3,11
10026,11221,3,16,8,27
10026,11222,4,5,10,19
10026,11223,1,3,5,9
10026,11224,1,3,2,6
10026,11225,5,5,5,15
10026,11226,3,7,13,23
10026,11228,2,1,7,10
10026,11229,1,4,5,10
10026,11230,7,4,10,21
10026,11231,0,0,6,6
10026,11232,0,1,3,4
10026,11233,6,9,10,25
10026,11234,3,8,12,23
10026,11235,2,0,4,6
10026,11236,2,5,8,15
10026,11237,0,4,9,13
10026,11238,3,0,12,15
10026,11239,1,2,1,4
10026,11354,1,4,6,11
10026,11355,12,6,8,26
10026,11356,4,2,2,8
10026,11357,4,2,7,13
10026,11358,2,4,8,14
10026,11359,0,1,1,2
10026,11360,2,1,1,4
10026,11361,1,1,4,6
10026,11362,1,0,1,2
10026,11364,4,0,4,8
10026,11365,2,3,4,9
10026,11367,0,3,2,5
10026,11368,15,17,12,44
10026,11369,4,10,5,19
10026,11370,4,3,2,9
10026,11372,6,11,10,27
10026,11373,9,22,12,43
10026,11374,1,2,7,10
10026,11375,1,2,16,19
10026,11377,7,15,17,39
10026,11378,3,3,16,22
10026,11379,6,10,8,24
10026,11385,13,18,18,49
10026,11411,0,3,4,7
10026,11412,3,1,2,6
10026,11413,1,6,5,12
10026,11414,0,1,1,2
10026,11415,1,2,3,6
10026,11416,2,2,2,6
10026,11417,0,6,3,9
10026,11418,1,2,4,7
10026,11419,2,2,1,5
10026,11420,0,6,2,8
10026,11421,2,4,4,10
10026,11422,1,1,6,8
10026,11423,1,5,4,10
10026,11426,0,0,1,1
10026,11427,1,4,3,8
10026,11428,1,1,2,4
10026,11429,0,3,3,6
10026,11432,3,2,4,9
10026,11433,4,3,4,11
10026,11434,4,6,4,14
10026,11435,1,7,5,13
10026,11436,1,3,2,6
10026,11691,2,2,7,11
10026,11692,0,0,5,5
10026,11693,0,0,2,2
10026,11694,0,1,3,4
10026,11697,0,0,1,1
10027,10001,39,22,77,138
10027,10002,44,36,98,178
10027,10003,49,28,121,198
10027,10004,13,3,11,27
10027,10005,19,5,21,45
10027,10006,5,2,6,13
10027,10007,10,4,11,25
10027,10009,40,38,94,172
10027,10010,34,11,92,137
10027,10011,63,29,187,279
10027,10012,32,20,49,101
10027,10013,25,14,63,102
10027,10014,35,32,104,171
10027,10016,39,15,122,176
10027,10017,10,12,56,78
10027,10018,12,7,23,42
10027,10019,88,49,199,336
10027,10021,24,20,131,175
10027,10022,36,17,62,115
10027,10023,149,80,428,657
10027,10024,165,89,447,701
10027,10025,865,434,1813,3112
10027,10026,180,151,390,721
10027,10027,1128,719,1518,3365
10027,10028,48,42,139,229
10027,10029,111,125,231,467
10027,10030,102,116,188,406
10027,10031,292,221,468,981
10027,10032,288,214,699,1201
10027,10033,144,148,531,823
10027,10034,80,73,369,522
10027,10035,65,77,120,262
10027,10036,44,34,104,182
10027,10037,45,68,135,248
10027,10038,21,2,35,58
10027,10039,81,73,115,269
10027,10040,105,99,306,510
10027,10044,12,6,36,54
10027,10065,27,18,87,132
10027,10069,14,6,50,70
10027,10075,30,7,89,126
10027,10119,1,0,0,1
10027,10128,86,54,257,397
10027,10162,2,0,7,9
10027,10199,0,1,0,1
10027,10280,8,2,29,39
10027,10282,3,1,3,7
10027,10301,6,8,22,36
10027,10302,6,6,7,19
10027,10303,3,3,16,22
10027,10304,14,14,23,51
10027,10305,6,9,23,38
10027,10306,7,9,31,47
10027,10307,3,0,10,13
10027,10308,5,2,10,17
10027,10309,4,3,16,23
10027,10310,6,4,23,33
10027,10312,7,3,29,39
10027,10314,15,12,65,92
10027,10451,55,69,82,206
10027,10452,58,104,136,298
10027,10453,59,119,113,291
10027,10454,42,55,51,148
10027,10455,33,61,70,164
10027,10456,71,130,121,322
10027,10457,57,90,97,244
10027,10458,56,79,139,274
10027,10459,38,65,72,175
10027,10460,39,79,86,204
10027,10461,33,41,160,234
10027,10462,60,89,213,362
10027,10463,115,97,594,806
10027,10464,1,3,13,17
10027,10465,20,31,81,132
10027,10466,52,72,105,229
10027,10467,99,104,219,422
10027,10468,48,96,154,298
10027,10469,36,63,158,257
10027,10470,16,11,42,69
10027,10471,35,27,191,253
10027,10472,65,67,72,204
10027,10473,66,62,148,276
10027,10474,11,17,20,48
10027,10475,18,34,83,135
10027,11001,3,0,3,6
10027,11003,0,0,1,1
10027,11004,5,4,13,22
10027,11005,0,1,0,1
10027,11040,0,1,4,5
10027,11101,30,26,94,150
10027,11102,45,39,102,186
10027,11103,34,26,110,170
10027,11104,27,21,79,127
10027,11105,42,25,91,158
10027,11106,34,16,101,151
10027,11109,10,8,19,37
10027,11201,83,53,155,291
10027,11203,27,25,70,122
10027,11204,17,9,34,60
10027,11205,34,22,93,149
10027,11206,57,34,100,191
10027,11207,32,30,61,123
10027,11208,26,36,62,124
10027,11209,22,22,70,114
10027,11210,14,14,49,77
10027,11211,65,42,129,236
10027,11212,27,34,66,127
10027,11213,60,35,126,221
10027,11214,15,7,49,71
10027,11215,75,64,169,308
10027,11216,40,18,88,146
10027,11217,48,22,134,204
10027,11218,28,21,56,105
10027,11219,18,11,42,71
10027,11220,32,33,69,134
10027,11221,53,34,70,157
10027,11222,53,32,89,174
10027,11223,20,19,26,65
10027,11224,12,17,19,48
10027,11225,24,47,48,119
10027,11226,48,32,105,185
10027,11228,14,8,32,54
10027,11229,12,10,57,79
10027,11230,34,22,78,134
10027,11231,37,30,103,170
10027,11232,17,9,21,47
10027,11233,27,37,59,123
10027,11234,17,17,53,87
10027,11235,6,8,39,53
10027,11236,28,23,67,118
10027,11237,28,15,39,82
10027,11238,62,39,140,241
10027,11239,6,11,12,29
10027,11354,30,21,44,95
10027,11355,25,26,63,114
10027,11356,11,8,20,39
10027,11357,14,14,52,80
10027,11358,20,29,37,86
10027,11359,1,2,2,5
10027,11360,10,4,31,45
10027,11361,20,9,20,49
10027,11362,9,5,20,34
10027,11363,4,2,2,8
10027,11364,11,16,34,61
10027,11365,11,12,44,67
10027,11366,5,6,14,25
10027,11367,12,12,45,69
10027,11368,39,52,87,178
10027,11369,26,29,47,102
10027,11370,17,15,18,50
10027,11371,0,0,2,2
10027,11372,36,49,120,205
10027,11373,53,59,90,202
10027,11374,15,16,82,113
10027,11375,24,20,130,174
10027,11377,70,45,133,248
10027,11378,15,14,51,80
10027,11379,17,12,35,64
10027,11385,35,44,109,188
10027,11411,8,10,22,40
10027,11412,19,11,14,44
10027,11413,6,17,34,57
10027,11414,6,6,23,35
10027,11415,3,7,14,24
10027,11416,5,10,20,35
10027,11417,3,7,21,31
10027,11418,7,10,30,47
10027,11419,9,14,34,57
10027,11420,10,14,31,55
10027,11421,9,11,27,47
10027,11422,8,12,34,54
10027,11423,17,8,29,54
10027,11426,5,3,17,25
10027,11427,6,10,19,35
10027,11428,4,5,19,28
10027,11429,6,6,23,35
10027,11430,0,0,1,1
10027,11432,21,21,61,103
10027,11433,15,12,27,54
10027,11434,13,20,43,76
10027,11435,22,18,47,87
10027,11436,7,7,12,26
10027,11691,14,17,45,76
10027,11692,3,4,13,20
10027,11693,0,4,10,14
10027,11694,3,1,16,20
10028,10001,7,5,13,25
10028,10002,20,40,37,97
10028,10003,22,20,45,87
10028,10004,3,5,3,11
10028,10005,2,4,5,11
10028,10006,0,5,1,6
10028,10007,5,1,7,13
10028,10009,20,31,53,104
10028,10010,14,11,26,51
10028,10011,22,16,50,88
10028,10012,11,6,27,44
10028,10013,2,11,29,42
10028,10014,12,12,29,53
10028,10016,18,20,58,96
10028,10017,3,9,29,41
10028,10018,8,0,5,13
10028,10019,17,21,42,80
10028,10021,36,30,106,172
10028,10022,19,20,42,81
10028,10023,19,29,96,144
10028,10024,29,32,114,175
10028,10025,48,59,148,255
10028,10026,25,24,28,77
10028,10027,33,63,50,146
10028,10028,107,87,337,531
10028,10029,59,124,136,319
10028,10030,15,28,11,54
10028,10031,50,101,53,204
10028,10032,48,58,49,155
10028,10033,37,32,47,116
10028,10034,39,50,43,132
10028,10035,25,40,35,100
10028,10036,15,17,31,63
10028,10037,13,7,21,41
10028,10038,4,14,15,33
10028,10039,25,38,20,83
10028,10040,45,46,41,132
10028,10044,3,5,13,21
10028,10065,25,23,54,102
10028,10069,1,1,4,6
10028,10075,46,45,125,216
10028,10128,80,66,259,405
10028,10162,2,2,6,10
10028,10280,1,4,12,17
10028,10282,1,0,5,6
10028,10301,8,14,13,35
10028,10302,4,8,7,19
10028,10303,6,6,11,23
10028,10304,11,10,19,40
10028,10305,11,10,25,46
10028,10306,6,9,20,35
10028,10307,5,1,1,7
10028,10308,0,1,5,6
10028,10309,3,1,11,15
10028,10310,4,5,10,19
10028,10312,10,5,15,30
10028,10314,18,17,36,71
10028,10451,23,51,26,100
10028,10452,55,79,40,174
10028,10453,51,66,33,150
10028,10454,17,34,20,71
10028,10455,37,39,26,102
10028,10456,56,72,45,173
10028,10457,43,52,24,119
10028,10458,32,60,25,117
10028,10459,25,45,27,97
10028,10460,43,50,28,121
10028,10461,26,41,63,130
10028,10462,41,58,69,168
10028,10463,33,33,65,131
10028,10464,2,2,6,10
10028,10465,11,21,40,72
10028,10466,18,40,26,84
10028,10467,50,67,60,177
10028,10468,39,42,56,137
10028,10469,14,35,49,98
10028,10470,9,11,15,35
10028,10471,8,16,26,50
10028,10472,53,57,39,149
10028,10473,32,61,30,123
10028,10474,5,12,3,20
10028,10475,14,26,47,87
10028,11001,4,2,2,8
10028,11004,4,2,6,12
10028,11005,0,1,3,4
10028,11040,0,1,2,3
10028,11101,24,28,29,81
10028,11102,33,45,52,130
10028,11103,27,50,63,140
10028,11104,14,34,54,102
10028,11105,27,30,58,115
10028,11106,33,43,67,143
10028,11109,1,0,1,2
10028,11201,23,32,93,148
10028,11203,22,30,28,80
10028,11204,17,16,25,58
10028,11205,11,19,31,61
10028,11206,44,46,42,132
10028,11207,34,42,24,100
10028,11208,31,20,42,93
10028,11209,15,13,35,63
10028,11210,16,25,17,58
10028,11211,35,29,81,145
10028,11212,21,43,25,89
10028,11213,34,45,37,116
10028,11214,13,18,27,58
10028,11215,34,20,60,114
10028,11216,27,48,45,120
10028,11217,17,11,52,80
10028,11218,12,25,23,60
10028,11219,11,22,29,62
10028,11220,30,37,34,101
10028,11221,45,49,65,159
10028,11222,18,24,34,76
10028,11223,19,13,31,63
10028,11224,7,14,18,39
10028,11225,18,20,17,55
10028,11226,36,50,39,125
10028,11228,4,9,15,28
10028,11229,16,15,37,68
10028,11230,22,37,31,90
10028,11231,16,15,30,61
10028,11232,10,13,14,37
10028,11233,32,42,18,92
10028,11234,21,31,22,74
10028,11235,13,23,23,59
10028,11236,28,39,27,94
10028,11237,17,26,31,74
10028,11238,22,22,65,109
10028,11239,5,2,7,14
10028,11354,34,27,26,87
10028,11355,52,46,33,131
10028,11356,8,12,13,33
10028,11357,13,11,41,65
10028,11358,6,22,22,50
10028,11359,0,0,1,1
10028,11360,4,8,12,24
10028,11361,4,9,18,31
10028,11362,7,10,9,26
10028,11363,3,4,3,10
10028,11364,10,14,19,43
10028,11365,18,16,30,64
10028,11366,2,3,7,12
10028,11367,18,9,28,55
10028,11368,56,79,62,197
10028,11369,15,38,22,75
10028,11370,16,16,20,52
10028,11371,0,2,1,3
10028,11372,55,71,100,226
10028,11373,83,117,111,311
10028,11374,34,40,57,131
10028,11375,53,46,85,184
10028,11377,60,107,118,285
10028,11378,17,33,54,104
10028,11379,17,24,43,84
10028,11385,61,67,103,231
10028,11411,3,7,8,18
10028,11412,8,8,14,30
10028,11413,7,14,13,34
10028,11414,4,7,7,18
10028,11415,12,8,13,33
10028,11416,7,14,19,40
10028,11417,7,10,17,34
10028,11418,11,17,24,52
10028,11419,19,10,26,55
10028,11420,8,21,27,56
10028,11421,18,28,40,86
10028,11422,8,7,10,25
10028,11423,13,15,11,39
10028,11426,1,4,8,13
10028,11427,4,9,12,25
10028,11428,8,6,5,19
10028,11429,10,6,5,21
10028,11432,18,33,28,79
10028,11433,14,10,11,35
10028,11434,18,17,23,58
10028,11435,19,18,21,58
10028,11436,4,8,7,19
10028,11691,7,13,12,32
10028,11692,3,6,4,13
10028,11693,3,2,4,9
10028,11694,1,2,6,9
10029,10001,7,18,38,63
10029,10002,20,59,89,168
10029,10003,12,22,131,165
10029,10004,4,5,17,26
10029,10005,1,2,15,18
10029,10006,1,0,6,7
10029,10007,3,3,12,18
10029,10009,26,35,168,229
10029,10010,10,7,92,109
10029,10011,14,30,121,165
10029,10012,5,10,45,60
10029,10013,5,8,32,45
10029,10014,7,7,47,61
10029,10016,6,17,154,177
10029,10017,6,4,48,58
10029,10018,6,7,23,36
10029,10019,11,16,161,188
10029,10021,13,21,179,213
10029,10022,3,11,85,99
10029,10023,14,27,167,208
10029,10024,13,35,222,270
10029,10025,34,87,403,524
10029,10026,29,99,172,300
10029,10027,29,83,179,291
10029,10028,11,28,258,297
10029,10029,292,567,947,1806
10029,10030,32,70,96,198
10029,10031,34,74,124,232
10029,10032,20,79,128,227
10029,10033,25,59,133,217
10029,10034,22,40,86,148
10029,10035,74,134,167,375
10029,10036,7,14,59,80
10029,10037,18,52,106,176
10029,10038,3,5,33,41
10029,10039,14,52,84,150
10029,10040,23,45,117,185
10029,10044,5,8,34,47
10029,10065,14,15,89,118
10029,10069,0,2,30,32
10029,10075,12,7,144,163
10029,10128,40,69,899,1008
10029,10162,0,2,8,10
10029,10280,1,1,18,20
10029,10282,0,2,3,5
10029,10301,4,18,30,52
10029,10302,1,6,16,23
10029,10303,2,18,27,47
10029,10304,5,20,32,57
10029,10305,3,9,34,46
10029,10306,7,12,38,57
10029,10307,0,4,10,14
10029,10308,3,2,23,28
10029,10309,2,4,19,25
10029,10310,1,4,19,24
10029,10312,1,9,33,43
10029,10314,10,17,76,103
10029,10451,32,72,107,211
10029,10452,63,133,134,330
10029,10453,31,114,123,268
10029,10454,31,42,68,141
10029,10455,36,69,74,179
10029,10456,78,166,145,389
10029,10457,37,111,110,258
10029,10458,30,74,95,199
10029,10459,28,80,99,207
10029,10460,28,78,94,200
10029,10461,24,56,167,247
10029,10462,54,130,271,455
10029,10463,23,79,212,314
10029,10464,1,8,9,18
10029,10465,14,28,82,124
10029,10466,26,74,162,262
10029,10467,44,115,211,370
10029,10468,34,132,134,300
10029,10469,30,70,196,296
10029,10470,1,10,59,70
10029,10471,6,17,108,131
10029,10472,37,107,109,253
10029,10473,28,75,182,285
10029,10474,5,19,18,42
10029,10475,23,48,138,209
10029,11001,1,2,6,9
10029,11004,2,5,27,34
10029,11005,1,1,2,4
10029,11040,0,0,8,8
10029,11101,10,22,93,125
10029,11102,22,35,131,188
10029,11103,13,35,113,161
10029,11104,9,18,79,106
10029,11105,7,37,133,177
10029,11106,17,41,130,188
10029,11109,3,0,32,35
10029,11201,14,37,137,188
10029,11203,11,55,132,198
10029,11204,7,9,43,59
10029,11205,8,20,73,101
10029,11206,17,50,112,179
10029,11207,23,72,91,186
10029,11208,13,55,90,158
10029,11209,3,14,56,73
10029,11210,12,32,81,125
10029,11211,30,35,120,185
10029,11212,16,58,121,195
10029,11213,14,25,103,142
10029,11214,8,21,69,98
10029,11215,14,28,121,163
10029,11216,11,23,88,122
10029,11217,4,15,78,97
10029,11218,6,10,46,62
10029,11219,5,16,45,66
10029,11220,10,19,68,97
10029,11221,24,63,89,176
10029,11222,10,22,67,99
10029,11223,8,18,53,79
10029,11224,5,13,47,65
10029,11225,9,38,85,132
10029,11226,12,68,148,228
10029,11228,4,18,41,63
10029,11229,6,14,60,80
10029,11230,8,22,80,110
10029,11231,4,15,51,70
10029,11232,5,9,16,30
10029,11233,13,33,82,128
10029,11234,10,50,130,190
10029,11235,7,15,67,89
10029,11236,17,87,139,243
10029,11237,7,27,44,78
10029,11238,15,30,107,152
10029,11239,0,9,19,28
10029,11354,18,30,88,136
10029,11355,33,37,104,174
10029,11356,8,17,39,64
10029,11357,8,17,72,97
10029,11358,15,18,67,100
10029,11359,0,0,1,1
10029,11360,4,12,40,56
10029,11361,6,11,40,57
10029,11362,8,9,28,45
10029,11363,0,3,10,13
10029,11364,5,7,53,65
10029,11365,11,25,74,110
10029,11366,2,6,31,39
10029,11367,11,29,81,121
10029,11368,28,81,108,217
10029,11369,7,29,73,109
10029,11370,2,16,67,85
10029,11371,1,3,3,7
10029,11372,17,43,150,210
10029,11373,41,61,230,332
10029,11374,16,35,162,213
10029,11375,23,46,254,323
10029,11377,46,85,244,375
10029,11378,8,25,82,115
10029,11379,15,25,115,155
10029,11385,19,68,167,254
10029,11411,6,15,32,53
10029,11412,8,19,48,75
10029,11413,5,21,83,109
10029,11414,5,12,21,38
10029,11415,4,11,32,47
10029,11416,4,12,25,41
10029,11417,4,18,34,56
10029,11418,4,27,45,76
10029,11419,6,24,68,98
10029,11420,6,23,49,78
10029,11421,7,21,48,76
10029,11422,6,19,67,92
10029,11423,5,17,51,73
10029,11426,4,9,47,60
10029,11427,6,8,51,65
10029,11428,3,8,37,48
10029,11429,4,18,50,72
10029,11430,0,0,1,1
10029,11432,11,28,125,164
10029,11433,8,24,41,73
10029,11434,15,32,104,151
10029,11435,12,23,77,112
10029,11436,1,12,28,41
10029,11691,5,19,42,66
10029,11692,2,8,16,26
10029,11693,1,5,14,20
10029,11694,0,3,19,22
10029,11697,0,0,3,3
10030,10001,2,4,6,12
10030,10002,6,7,6,19
10030,10003,4,2,6,12
10030,10004,0,1,0,1
10030,10006,1,1,0,2
10030,10007,0,1,0,1
10030,10009,1,2,8,11
10030,10010,1,6,5,12
10030,10011,1,5,8,14
10030,10012,1,2,5,8
10030,10013,1,3,2,6
10030,10014,2,5,1,8
10030,10016,2,2,10,14
10030,10017,0,1,5,6
10030,10018,2,1,1,4
10030,10019,3,6,8,17
10030,10021,1,1,7,9
10030,10022,1,4,6,11
10030,10023,7,4,19,30
10030,10024,9,4,14,27
10030,10025,11,18,43,72
10030,10026,18,23,30,71
10030,10027,27,49,45,121
10030,10028,2,3,13,18
10030,10029,19,21,30,70
10030,10030,43,96,39,178
10030,10031,25,25,33,83
10030,10032,13,20,24,57
10030,10033,7,12,14,33
10030,10034,3,11,23,37
10030,10035,14,22,21,57
10030,10036,3,7,7,17
10030,10037,13,20,26,59
10030,10038,0,3,3,6
10030,10039,24,26,18,68
10030,10040,5,14,13,32
10030,10044,1,0,5,6
10030,10065,0,3,5,8
10030,10069,0,0,1,1
10030,10075,1,1,3,5
10030,10128,4,4,31,39
10030,10280,0,0,1,1
10030,10282,0,0,1,1
10030,10301,1,0,8,9
10030,10302,2,2,0,4
10030,10303,1,3,4,8
10030,10304,0,2,6,8
10030,10305,0,2,3,5
10030,10306,1,0,12,13
10030,10307,1,0,2,3
10030,10308,2,2,3,7
10030,10309,2,2,5,9
10030,10310,4,2,7,13
10030,10312,0,3,6,9
10030,10314,4,1,8,13
10030,10451,12,19,21,52
10030,10452,25,27,23,75
10030,10453,19,33,26,78
10030,10454,13,23,7,43
10030,10455,3,15,11,29
10030,10456,16,36,16,68
10030,10457,16,31,22,69
10030,10458,21,18,16,55
10030,10459,6,16,14,36
10030,10460,11,22,13,46
10030,10461,5,6,22,33
10030,10462,6,23,32,61
10030,10463,10,13,32,55
10030,10464,0,0,3,3
10030,10465,1,10,15,26
10030,10466,14,28,36,78
10030,10467,20,60,18,98
10030,10468,16,25,16,57
10030,10469,8,16,37,61
10030,10470,2,7,9,18
10030,10471,1,2,21,24
10030,10472,11,14,16,41
10030,10473,7,22,19,48
10030,10474,2,6,6,14
10030,10475,2,5,9,16
10030,11001,0,0,1,1
10030,11004,0,1,1,2
10030,11101,0,7,11,18
10030,11102,6,3,14,23
10030,11103,2,7,17,26
10030,11104,3,5,14,22
10030,11105,3,3,12,18
10030,11106,5,11,15,31
10030,11109,0,1,0,1
10030,11201,1,2,8,11
10030,11203,7,7,14,28
10030,11204,1,2,4,7
10030,11205,1,5,6,12
10030,11206,1,8,8,17
10030,11207,6,5,10,21
10030,11208,6,7,11,24
10030,11209,1,2,11,14
10030,11210,1,10,6,17
10030,11211,0,1,17,18
10030,11212,7,11,8,26
10030,11213,3,5,11,19
10030,11214,1,2,12,15
10030,11215,2,1,7,10
10030,11216,3,5,11,19
10030,11217,4,2,8,14
10030,11218,1,5,8,14
10030,11219,1,1,3,5
10030,11220,1,4,9,14
10030,11221,4,11,10,25
10030,11222,0,1,5,6
10030,11223,0,5,3,8
10030,11224,5,1,4,10
10030,11225,4,15,12,31
10030,11226,6,13,21,40
10030,11228,2,0,3,5
10030,11229,1,1,5,7
10030,11230,3,3,13,19
10030,11231,2,1,7,10
10030,11232,0,0,4,4
10030,11233,5,4,6,15
10030,11234,4,7,14,25
10030,11235,1,0,7,8
10030,11236,4,8,12,24
10030,11237,1,1,5,7
10030,11238,7,2,10,19
10030,11239,0,1,2,3
10030,11354,13,8,11,32
10030,11355,3,10,17,30
10030,11356,3,2,0,5
10030,11357,2,4,17,23
10030,11358,3,8,11,22
10030,11359,0,2,1,3
10030,11360,1,0,2,3
10030,11361,0,1,3,4
10030,11362,0,1,2,3
10030,11363,0,2,1,3
10030,11364,0,0,4,4
10030,11365,0,5,2,7
10030,11366,4,1,0,5
10030,11367,5,2,4,11
10030,11368,5,4,20,29
10030,11369,2,4,8,14
10030,11370,1,5,6,12
10030,11372,1,4,8,13
10030,11373,6,11,15,32
10030,11374,1,2,3,6
10030,11375,2,1,15,18
10030,11377,10,9,19,38
10030,11378,2,2,3,7
10030,11379,1,1,9,11
10030,11385,5,5,11,21
10030,11411,0,1,2,3
10030,11412,2,5,3,10
10030,11413,0,4,9,13
10030,11414,1,2,4,7
10030,11415,1,0,1,2
10030,11416,1,2,2,5
10030,11417,1,4,4,9
10030,11418,1,3,4,8
10030,11419,2,5,5,12
10030,11420,1,1,7,9
10030,11421,1,2,2,5
10030,11422,0,0,1,1
10030,11423,5,4,7,16
10030,11426,2,1,2,5
10030,11427,2,1,1,4
10030,11428,0,0,2,2
10030,11429,2,3,3,8
10030,11432,3,6,6,15
10030,11433,1,0,7,8
10030,11434,5,9,2,16
10030,11435,3,3,6,12
10030,11436,1,4,5,10
10030,11691,1,4,5,10
10030,11692,0,2,0,2
10030,11693,2,0,2,4
10030,11694,4,3,3,10
10031,10001,7,5,5,17
10031,10002,7,10,8,25
10031,10003,15,3,9,27
10031,10004,2,0,1,3
10031,10005,1,1,1,3
10031,10006,0,0,1,1
10031,10009,6,9,7,22
10031,10010,2,5,8,15
10031,10011,7,10,12,29
10031,10012,3,3,7,13
10031,10013,5,1,4,10
10031,10014,1,3,9,13
10031,10016,7,5,13,25
10031,10017,3,1,0,4
10031,10018,2,2,3,7
10031,10019,7,12,13,32
10031,10021,3,4,9,16
10031,10022,3,2,5,10
10031,10023,5,3,7,15
10031,10024,9,10,16,35
10031,10025,12,26,38,76
10031,10026,21,21,32,74
10031,10027,35,47,36,118
10031,10028,4,3,9,16
10031,10029,23,14,21,58
10031,10030,29,41,18,88
10031,10031,190,236,91,517
10031,10032,61,62,38,161
10031,10033,29,36,31,96
10031,10034,34,32,16,82
10031,10035,18,19,23,60
10031,10036,4,8,5,17
10031,10037,11,9,13,33
10031,10038,5,4,10,19
10031,10039,17,31,14,62
10031,10040,24,24,17,65
10031,10044,1,1,1,3
10031,10065,2,1,7,10
10031,10069,1,3,0,4
10031,10075,1,1,2,4
10031,10128,9,7,10,26
10031,10280,2,0,1,3
10031,10301,7,5,2,14
10031,10302,0,3,2,5
10031,10303,2,3,5,10
10031,10304,4,3,4,11
10031,10305,2,0,4,6
10031,10306,3,2,7,12
10031,10307,0,1,5,6
10031,10308,3,2,2,7
10031,10309,2,0,7,9
10031,10310,3,3,5,11
10031,10312,5,3,9,17
10031,10314,6,6,17,29
10031,10451,28,19,25,72
10031,10452,38,39,27,104
10031,10453,36,33,30,99
10031,10454,8,15,8,31
10031,10455,10,24,10,44
10031,10456,52,26,34,112
10031,10457,26,29,19,74
10031,10458,26,25,28,79
10031,10459,10,25,20,55
10031,10460,25,36,22,83
10031,10461,20,15,28,63
10031,10462,19,32,37,88
10031,10463,27,25,39,91
10031,10464,0,0,4,4
10031,10465,12,13,21,46
10031,10466,12,17,21,50
10031,10467,29,21,36,86
10031,10468,25,35,27,87
10031,10469,16,16,22,54
10031,10470,1,6,5,12
10031,10471,5,13,18,36
10031,10472,22,13,17,52
10031,10473,24,19,24,67
10031,10474,2,3,1,6
10031,10475,9,8,27,44
10031,11001,0,1,3,4
10031,11004,1,0,3,4
10031,11005,2,0,0,2
10031,11101,4,1,5,10
10031,11102,8,3,12,23
10031,11103,8,8,20,36
10031,11104,7,5,8,20
10031,11105,4,11,12,27
10031,11106,9,6,15,30
10031,11109,0,0,1,1
10031,11201,8,2,9,19
10031,11203,12,3,7,22
10031,11204,3,2,4,9
10031,11205,1,4,8,13
10031,11206,7,4,14,25
10031,11207,7,10,13,30
10031,11208,13,8,10,31
10031,11209,8,5,5,18
10031,11210,10,4,9,23
10031,11211,5,7,6,18
10031,11212,9,9,9,27
10031,11213,6,7,14,27
10031,11214,5,7,9,21
10031,11215,4,3,9,16
10031,11216,8,6,9,23
10031,11217,4,4,5,13
10031,11218,7,2,3,12
10031,11219,6,6,4,16
10031,11220,9,8,7,24
10031,11221,10,7,15,32
10031,11222,3,6,6,15
10031,11223,5,4,7,16
10031,11224,6,3,5,14
10031,11225,9,5,12,26
10031,11226,8,14,16,38
10031,11228,3,3,3,9
10031,11229,4,1,11,16
10031,11230,15,6,10,31
10031,11231,2,5,6,13
10031,11232,3,4,2,9
10031,11233,7,4,12,23
10031,11234,9,2,13,24
10031,11235,6,0,12,18
10031,11236,5,11,17,33
10031,11237,4,8,5,17
10031,11238,5,11,11,27
10031,11239,0,4,2,6
10031,11354,9,8,12,29
10031,11355,22,11,10,43
10031,11356,7,3,9,19
10031,11357,4,5,9,18
10031,11358,5,9,8,22
10031,11359,2,2,0,4
10031,11360,2,6,9,17
10031,11361,3,5,4,12
10031,11362,1,3,2,6
10031,11363,0,0,2,2
10031,11364,2,4,5,11
10031,11365,2,4,4,10
10031,11366,1,1,0,2
10031,11367,3,2,4,9
10031,11368,17,17,19,53
10031,11369,6,10,14,30
10031,11370,4,9,4,17
10031,11371,0,1,0,1
10031,11372,17,10,13,40
10031,11373,23,14,21,58
10031,11374,4,4,12,20
10031,11375,8,10,19,37
10031,11377,23,22,23,68
10031,11378,4,5,4,13
10031,11379,5,6,4,15
10031,11385,22,8,13,43
10031,11411,2,2,7,11
10031,11412,1,3,5,9
10031,11413,5,2,12,19
10031,11414,3,1,2,6
10031,11415,3,1,2,6
10031,11416,2,2,5,9
10031,11417,3,2,7,12
10031,11418,0,0,1,1
10031,11419,4,4,3,11
10031,11420,5,5,2,12
10031,11421,5,0,2,7
10031,11422,3,3,11,17
10031,11423,4,2,5,11
10031,11426,3,4,4,11
10031,11427,2,6,4,12
10031,11428,2,0,5,7
10031,11429,2,0,5,7
10031,11432,11,1,9,21
10031,11433,3,5,8,16
10031,11434,3,4,14,21
10031,11435,11,3,8,22
10031,11436,2,2,0,4
10031,11691,2,3,4,9
10031,11692,2,1,2,5
10031,11693,1,1,4,6
10031,11694,0,0,4,4
10031,11697,0,0,1,1
10032,10001,6,1,23,30
10032,10002,17,27,56,100
10032,10003,15,10,35,60
10032,10004,0,0,6,6
10032,10005,0,1,7,8
10032,10007,0,1,8,9
10032,10009,7,6,58,71
10032,10010,2,4,22,28
10032,10011,4,14,66,84
10032,10012,4,2,27,33
10032,10013,2,4,27,33
10032,10014,3,6,40,49
10032,10016,3,6,67,76
10032,10017,3,2,25,30
10032,10018,0,1,12,13
10032,10019,2,12,63,77
10032,10021,10,13,330,353
10032,10022,4,4,35,43
10032,10023,7,13,128,148
10032,10024,10,18,126,154
10032,10025,25,34,228,287
10032,10026,11,19,74,104
10032,10027,31,57,123,211
10032,10028,9,5,83,97
10032,10029,24,41,93,158
10032,10030,10,20,67,97
10032,10031,48,97,147,292
10032,10032,254,370,423,1047
10032,10033,82,145,209,436
10032,10034,36,64,116,216
10032,10035,14,23,49,86
10032,10036,3,3,33,39
10032,10037,7,9,55,71
10032,10038,3,6,13,22
10032,10039,12,20,54,86
10032,10040,44,63,147,254
10032,10044,3,7,13,23
10032,10065,5,9,70,84
10032,10069,0,1,10,11
10032,10075,6,4,41,51
10032,10128,9,21,130,160
10032,10162,0,0,2,2
10032,10280,0,0,16,16
10032,10282,0,0,4,4
10032,10301,2,10,20,32
10032,10302,2,3,12,17
10032,10303,3,5,18,26
10032,10304,3,6,23,32
10032,10305,2,10,23,35
10032,10306,5,10,30,45
10032,10307,1,1,9,11
10032,10308,3,3,10,16
10032,10309,1,7,11,19
10032,10310,2,5,11,18
10032,10312,4,6,25,35
10032,10314,9,18,36,63
10032,10451,32,42,79,153
10032,10452,37,72,96,205
10032,10453,36,99,102,237
10032,10454,6,23,22,51
10032,10455,16,28,37,81
10032,10456,44,72,101,217
10032,10457,40,80,95,215
10032,10458,27,80,83,190
10032,10459,23,38,39,100
10032,10460,28,53,84,165
10032,10461,19,38,97,154
10032,10462,31,58,161,250
10032,10463,42,80,191,313
10032,10464,3,2,6,11
10032,10465,13,18,65,96
10032,10466,22,45,139,206
10032,10467,65,89,139,293
10032,10468,45,90,102,237
10032,10469,11,56,139,206
10032,10470,9,6,38,53
10032,10471,8,14,80,102
10032,10472,17,33,70,120
10032,10473,15,49,82,146
10032,10474,4,4,11,19
10032,10475,6,26,77,109
10032,11001,0,1,2,3
10032,11004,0,1,7,8
10032,11005,0,0,1,1
10032,11040,1,0,1,2
10032,11101,9,13,36,58
10032,11102,13,16,64,93
10032,11103,9,10,60,79
10032,11104,5,8,30,43
10032,11105,11,14,69,94
10032,11106,7,15,47,69
10032,11109,4,0,17,21
10032,11201,3,6,44,53
10032,11203,5,23,61,89
10032,11204,7,21,24,52
10032,11205,3,9,20,32
10032,11206,12,22,47,81
10032,11207,15,19,39,73
10032,11208,6,19,36,61
10032,11209,7,13,47,67
10032,11210,4,12,35,51
10032,11211,6,21,54,81
10032,11212,9,18,47,74
10032,11213,7,15,42,64
10032,11214,14,33,36,83
10032,11215,3,14,51,68
10032,11216,5,15,28,48
10032,11217,2,7,21,30
10032,11218,7,12,18,37
10032,11219,13,11,30,54
10032,11220,16,23,23,62
10032,11221,4,12,35,51
10032,11222,6,6,20,32
10032,11223,10,16,25,51
10032,11224,5,15,14,34
10032,11225,7,12,41,60
10032,11226,5,22,52,79
10032,11228,2,7,26,35
10032,11229,5,23,28,56
10032,11230,1,11,35,47
10032,11231,2,5,23,30
10032,11232,5,2,10,17
10032,11233,9,10,38,57
10032,11234,6,19,55,80
10032,11235,8,24,32,64
10032,11236,6,27,66,99
10032,11237,4,9,18,31
10032,11238,6,19,44,69
10032,11239,3,3,1,7
10032,11354,9,14,36,59
10032,11355,18,45,33,96
10032,11356,5,7,8,20
10032,11357,3,4,27,34
10032,11358,2,8,21,31
10032,11360,4,4,17,25
10032,11361,4,11,18,33
10032,11362,1,6,18,25
10032,11363,2,2,2,6
10032,11364,9,15,28,52
10032,11365,3,16,23,42
10032,11366,1,4,10,15
10032,11367,6,7,22,35
10032,11368,14,30,41,85
10032,11369,1,8,23,32
10032,11370,5,9,24,38
10032,11372,7,17,38,62
10032,11373,21,53,62,136
10032,11374,8,9,42,59
10032,11375,8,18,70,96
10032,11377,22,40,80,142
10032,11378,5,5,20,30
10032,11379,1,10,17,28
10032,11385,15,16,58,89
10032,11411,4,5,16,25
10032,11412,4,8,22,34
10032,11413,2,7,33,42
10032,11414,2,6,9,17
10032,11415,1,8,11,20
10032,11416,1,6,19,26
10032,11417,1,5,14,20
10032,11418,2,7,23,32
10032,11419,1,10,28,39
10032,11420,4,11,18,33
10032,11421,1,13,16,30
10032,11422,1,5,23,29
10032,11423,4,6,20,30
10032,11426,2,3,19,24
10032,11427,4,2,20,26
10032,11428,5,0,22,27
10032,11429,0,5,29,34
10032,11432,9,16,50,75
10032,11433,5,4,15,24
10032,11434,4,16,50,70
10032,11435,8,9,38,55
10032,11436,4,8,9,21
10032,11691,4,11,23,38
10032,11692,2,5,13,20
10032,11693,2,1,6,9
10032,11694,2,2,11,15
10032,11697,0,1,4,5
10033,10001,4,3,4,11
10033,10002,9,7,13,29
10033,10003,9,5,5,19
10033,10004,0,1,0,1
10033,10005,1,0,0,1
10033,10006,3,0,1,4
10033,10007,3,1,0,4
10033,10009,10,4,11,25
10033,10010,5,2,4,11
10033,10011,7,2,8,17
10033,10012,10,1,4,15
10033,10013,2,4,4,10
10033,10014,4,5,7,16
10033,10016,5,2,15,22
10033,10017,1,1,5,7
10033,10018,1,1,2,4
10033,10019,5,2,8,15
10033,10021,13,4,17,34
10033,10022,4,2,6,12
10033,10023,12,8,43,63
10033,10024,26,14,40,80
10033,10025,33,28,80,141
10033,10026,12,11,15,38
10033,10027,14,27,29,70
10033,10028,11,11,9,31
10033,10029,17,32,12,61
10033,10030,7,15,20,42
10033,10031,49,59,19,127
10033,10032,87,139,50,276
10033,10033,351,367,205,923
10033,10034,46,83,38,167
10033,10035,11,17,21,49
10033,10036,4,6,4,14
10033,10037,6,7,10,23
10033,10038,6,3,7,16
10033,10039,16,13,22,51
10033,10040,116,133,91,340
10033,10044,1,0,1,2
10033,10065,3,4,16,23
10033,10069,3,2,3,8
10033,10075,4,3,7,14
10033,10128,10,19,27,56
10033,10162,1,0,0,1
10033,10280,2,1,2,5
10033,10282,1,1,1,3
10033,10301,1,1,5,7
10033,10302,0,0,2,2
10033,10303,1,2,3,6
10033,10304,2,5,4,11
10033,10305,1,3,6,10
10033,10306,1,3,4,8
10033,10307,0,0,3,3
10033,10308,0,2,5,7
10033,10309,0,1,3,4
10033,10310,2,1,7,10
10033,10312,0,2,9,11
10033,10314,1,2,16,19
10033,10451,19,23,14,56
10033,10452,36,100,25,161
10033,10453,53,83,25,161
10033,10454,11,18,7,36
10033,10455,18,16,10,44
10033,10456,30,75,35,140
10033,10457,47,64,24,135
10033,10458,20,63,24,107
10033,10459,24,32,15,71
10033,10460,17,39,27,83
10033,10461,16,65,25,106
10033,10462,22,54,55,131
10033,10463,59,60,92,211
10033,10464,0,1,2,3
10033,10465,12,23,24,59
10033,10466,22,19,32,73
10033,10467,17,44,35,96
10033,10468,39,96,30,165
10033,10469,11,30,33,74
10033,10470,5,3,10,18
10033,10471,22,21,34,77
10033,10472,14,36,12,62
10033,10473,13,24,39,76
10033,10474,2,4,5,11
10033,10475,5,15,22,42
10033,11001,0,0,3,3
10033,11004,0,1,3,4
10033,11040,0,1,1,2
10033,11101,5,7,12,24
10033,11102,6,13,8,27
10033,11103,8,15,10,33
10033,11104,0,2,3,5
10033,11105,7,10,15,32
10033,11106,5,9,11,25
10033,11201,7,3,9,19
10033,11203,2,7,11,20
10033,11204,5,5,2,12
10033,11205,2,3,9,14
10033,11206,6,9,12,27
10033,11207,7,10,12,29
10033,11208,2,14,3,19
10033,11209,9,5,8,22
10033,11210,4,7,15,26
10033,11211,14,3,14,31
10033,11212,8,10,8,26
10033,11213,2,5,13,20
10033,11214,5,3,7,15
10033,11215,10,7,17,34
10033,11216,1,5,9,15
10033,11217,6,3,13,22
10033,11218,5,2,14,21
10033,11219,13,4,10,27
10033,11220,7,9,9,25
10033,11221,3,10,6,19
10033,11222,5,0,6,11
10033,11223,5,7,7,19
10033,11224,1,6,9,16
10033,11225,2,4,10,16
10033,11226,6,8,13,27
10033,11228,6,8,3,17
10033,11229,14,8,8,30
10033,11230,15,20,12,47
10033,11231,5,3,7,15
10033,11232,4,2,4,10
10033,11233,4,4,9,17
10033,11234,5,8,12,25
10033,11235,6,10,11,27
10033,11236,4,6,12,22
10033,11237,2,2,6,10
10033,11238,4,2,7,13
10033,11239,1,2,2,5
10033,11354,4,8,12,24
10033,11355,12,8,4,24
10033,11356,2,2,1,5
10033,11357,5,2,4,11
10033,11358,2,7,5,14
10033,11360,1,4,0,5
10033,11361,2,4,4,10
10033,11362,0,3,0,3
10033,11363,0,2,1,3
10033,11364,1,3,3,7
10033,11365,2,0,9,11
10033,11366,2,7,4,13
10033,11367,10,4,11,25
10033,11368,7,12,10,29
10033,11369,2,6,10,18
10033,11370,3,2,4,9
10033,11372,3,7,8,18
10033,11373,14,10,11,35
10033,11374,1,3,11,15
10033,11375,9,5,19,33
10033,11377,7,5,22,34
10033,11378,3,4,5,12
10033,11379,4,4,6,14
10033,11385,4,6,15,25
10033,11411,0,2,2,4
10033,11412,2,4,4,10
10033,11413,2,2,8,12
10033,11414,1,1,4,6
10033,11415,0,0,2,2
10033,11416,3,1,3,7
10033,11417,2,1,1,4
10033,11418,5,2,6,13
10033,11419,2,3,7,12
10033,11420,2,2,4,8
10033,11421,1,9,6,16
10033,11422,0,2,8,10
10033,11423,3,0,3,6
10033,11426,0,0,1,1
10033,11427,2,2,4,8
10033,11428,1,3,2,6
10033,11429,3,2,2,7
10033,11432,12,9,16,37
10033,11433,4,3,7,14
10033,11434,2,4,4,10
10033,11435,4,3,12,19
10033,11436,0,2,2,4
10033,11691,6,5,4,15
10033,11692,0,1,2,3
10033,11693,1,2,3,6
10033,11694,2,1,5,8
10033,11697,0,0,1,1
10034,10001,0,0,1,1
10034,10002,6,3,4,13
10034,10003,8,0,5,13
10034,10006,0,1,0,1
10034,10009,2,3,1,6
10034,10010,0,2,0,2
10034,10011,1,4,5,10
10034,10012,0,0,3,3
10034,10013,1,0,6,7
10034,10016,4,0,2,6
10034,10019,0,6,4,10
10034,10021,0,1,2,3
10034,10023,1,2,11,14
10034,10024,9,5,5,19
10034,10025,11,23,10,44
10034,10026,1,7,8,16
10034,10027,8,14,4,26
10034,10028,1,1,2,4
10034,10029,6,15,10,31
10034,10030,6,7,2,15
10034,10031,24,47,12,83
10034,10032,54,76,19,149
10034,10033,62,82,25,169
10034,10034,204,265,87,556
10034,10035,6,9,10,25
10034,10036,2,2,0,4
10034,10037,4,1,5,10
10034,10038,1,2,2,5
10034,10039,5,15,5,25
10034,10040,71,97,23,191
10034,10065,0,2,4,6
10034,10069,1,0,0,1
10034,10075,0,0,1,1
10034,10128,0,2,4,6
10034,10280,1,0,0,1
10034,10301,0,2,1,3
10034,10302,1,0,1,2
10034,10303,0,0,3,3
10034,10304,1,1,0,2
10034,10305,2,0,1,3
10034,10306,1,2,5,8
10034,10307,1,0,1,2
10034,10308,0,1,1,2
10034,10309,2,0,2,4
10034,10310,0,1,0,1
10034,10312,0,3,3,6
10034,10314,0,2,5,7
10034,10451,13,37,3,53
10034,10452,31,55,8,94
10034,10453,33,81,13,127
10034,10454,9,16,10,35
10034,10455,10,11,3,24
10034,10456,24,44,14,82
10034,10457,36,44,12,92
10034,10458,32,70,15,117
10034,10459,16,25,3,44
10034,10460,15,32,5,52
10034,10461,6,9,5,20
10034,10462,11,30,20,61
10034,10463,71,96,33,200
10034,10464,1,0,0,1
10034,10465,8,12,10,30
10034,10466,18,24,9,51
10034,10467,36,53,26,115
10034,10468,81,76,13,170
10034,10469,12,22,11,45
10034,10470,1,4,9,14
10034,10471,9,8,5,22
10034,10472,6,15,9,30
10034,10473,12,21,6,39
10034,10474,1,1,1,3
10034,10475,1,6,12,19
10034,11004,0,1,0,1
10034,11040,1,0,0,1
10034,11101,4,2,3,9
10034,11102,1,2,5,8
10034,11103,5,2,3,10
10034,11104,1,3,4,8
10034,11105,0,4,5,9
10034,11106,0,3,6,9
10034,11201,0,0,2,2
10034,11203,1,3,1,5
10034,11204,0,3,3,6
10034,11205,0,0,3,3
10034,11206,2,1,5,8
10034,11207,5,11,4,20
10034,11208,2,9,5,16
10034,11209,3,6,4,13
10034,11210,1,3,1,5
10034,11211,1,3,5,9
10034,11212,4,6,5,15
10034,11213,0,1,3,4
10034,11214,1,2,1,4
10034,11215,2,1,4,7
10034,11216,0,1,0,1
10034,11217,3,2,1,6
10034,11218,1,5,8,14
10034,11219,1,0,5,6
10034,11220,2,3,0,5
10034,11221,5,6,4,15
10034,11222,0,0,1,1
10034,11223,1,1,0,2
10034,11224,2,3,1,6
10034,11225,2,0,2,4
10034,11226,3,6,2,11
10034,11228,2,0,3,5
10034,11229,0,0,3,3
10034,11230,1,3,0,4
10034,11231,1,1,1,3
10034,11232,1,0,1,2
10034,11233,3,3,5,11
10034,11234,0,3,3,6
10034,11235,1,2,1,4
10034,11236,0,5,6,11
10034,11237,2,5,1,8
10034,11238,2,1,7,10
10034,11239,2,2,1,5
10034,11354,0,4,0,4
10034,11355,1,1,4,6
10034,11356,0,0,1,1
10034,11357,1,0,0,1
10034,11358,0,0,2,2
10034,11360,0,0,1,1
10034,11362,1,0,1,2
10034,11364,0,3,0,3
10034,11365,0,1,1,2
10034,11367,2,1,2,5
10034,11368,6,2,7,15
10034,11369,2,4,3,9
10034,11370,0,1,1,2
10034,11372,4,6,1,11
10034,11373,4,6,2,12
10034,11374,3,2,2,7
10034,11375,1,7,2,10
10034,11377,3,8,3,14
10034,11378,1,1,2,4
10034,11379,2,5,2,9
10034,11385,6,8,8,22
10034,11411,0,1,3,4
10034,11412,3,2,1,6
10034,11413,1,1,3,5
10034,11415,2,0,1,3
10034,11416,0,1,2,3
10034,11417,5,3,2,10
10034,11418,0,1,1,2
10034,11419,2,2,5,9
10034,11420,3,0,3,6
10034,11421,1,2,0,3
10034,11422,2,2,2,6
10034,11423,0,0,2,2
10034,11426,1,3,0,4
10034,11427,0,2,0,2
10034,11428,1,0,0,1
10034,11429,0,0,3,3
10034,11432,1,4,1,6
10034,11433,1,2,1,4
10034,11434,5,3,3,11
10034,11435,2,1,4,7
10034,11436,0,1,1,2
10034,11691,1,1,5,7
10034,11692,0,0,2,2
10034,11694,0,0,2,2
10035,10001,3,6,15,24
10035,10002,10,44,40,94
10035,10003,9,10,36,55
10035,10004,1,3,5,9
10035,10005,1,0,5,6
10035,10006,0,1,2,3
10035,10007,1,1,3,5
10035,10009,17,25,28,70
10035,10010,6,6,20,32
10035,10011,7,6,26,39
10035,10012,3,1,17,21
10035,10013,3,5,10,18
10035,10014,3,6,23,32
10035,10016,6,6,25,37
10035,10017,3,2,16,21
10035,10018,4,2,6,12
10035,10019,7,19,36,62
10035,10021,5,2,22,29
10035,10022,4,3,9,16
10035,10023,11,9,33,53
10035,10024,13,9,43,65
10035,10025,42,50,99,191
10035,10026,31,71,75,177
10035,10027,54,113,83,250
10035,10028,7,3,39,49
10035,10029,118,174,156,448
10035,10030,28,62,92,182
10035,10031,40,72,85,197
10035,10032,29,60,58,147
10035,10033,18,44,69,131
10035,10034,16,40,77,133
10035,10035,84,188,92,364
10035,10036,10,17,12,39
10035,10037,35,34,53,122
10035,10038,0,4,9,13
10035,10039,25,49,38,112
10035,10040,15,42,71,128
10035,10044,1,4,3,8
10035,10065,5,5,12,22
10035,10069,1,3,2,6
10035,10075,7,4,27,38
10035,10128,22,24,51,97
10035,10162,0,0,3,3
10035,10280,3,0,3,6
10035,10301,2,20,18,40
10035,10302,2,12,14,28
10035,10303,2,9,9,20
10035,10304,4,19,14,37
10035,10305,3,16,18,37
10035,10306,1,14,36,51
10035,10307,1,3,5,9
10035,10308,2,1,16,19
10035,10309,5,4,19,28
10035,10310,3,14,20,37
10035,10312,3,14,31,48
10035,10314,6,30,45,81
10035,10451,31,82,56,169
10035,10452,25,90,58,173
10035,10453,43,102,82,227
10035,10454,33,74,34,141
10035,10455,27,60,44,131
10035,10456,48,128,119,295
10035,10457,38,85,68,191
10035,10458,35,89,68,192
10035,10459,42,66,55,163
10035,10460,27,56,52,135
10035,10461,19,39,63,121
10035,10462,33,65,108,206
10035,10463,25,45,97,167
10035,10464,2,2,5,9
10035,10465,16,26,58,100
10035,10466,28,71,109,208
10035,10467,49,89,118,256
10035,10468,46,98,78,222
10035,10469,29,62,73,164
10035,10470,2,9,23,34
10035,10471,6,9,25,40
10035,10472,29,66,58,153
10035,10473,28,56,106,190
10035,10474,10,17,10,37
10035,10475,19,22,58,99
10035,11001,1,1,1,3
10035,11004,1,2,12,15
10035,11005,0,0,1,1
10035,11040,0,1,0,1
10035,11101,13,24,29,66
10035,11102,2,19,43,64
10035,11103,15,20,37,72
10035,11104,10,10,30,50
10035,11105,6,9,35,50
10035,11106,15,19,40,74
10035,11109,2,1,5,8
10035,11201,6,13,30,49
10035,11203,15,35,75,125
10035,11204,4,5,13,22
10035,11205,15,11,22,48
10035,11206,12,44,60,116
10035,11207,29,59,63,151
10035,11208,14,26,59,99
10035,11209,3,6,20,29
10035,11210,12,28,57,97
10035,11211,18,22,61,101
10035,11212,19,45,54,118
10035,11213,12,24,42,78
10035,11214,7,16,25,48
10035,11215,6,9,34,49
10035,11216,10,19,39,68
10035,11217,9,7,31,47
10035,11218,9,5,21,35
10035,11219,5,4,24,33
10035,11220,6,15,22,43
10035,11221,19,40,45,104
10035,11222,6,5,18,29
10035,11223,7,10,28,45
10035,11224,1,13,28,42
10035,11225,10,26,52,88
10035,11226,29,49,113,191
10035,11228,6,5,7,18
10035,11229,3,13,37,53
10035,11230,10,9,40,59
10035,11231,4,5,20,29
10035,11232,1,6,9,16
10035,11233,13,29,21,63
10035,11234,8,29,75,112
10035,11235,5,9,31,45
10035,11236,15,36,105,156
10035,11237,10,15,24,49
10035,11238,11,16,45,72
10035,11239,5,1,9,15
10035,11354,13,13,14,40
10035,11355,14,28,25,67
10035,11356,4,10,14,28
10035,11357,9,14,28,51
10035,11358,4,7,33,44
10035,11359,0,0,3,3
10035,11360,5,7,9,21
10035,11361,1,1,10,12
10035,11362,1,4,7,12
10035,11363,0,0,6,6
10035,11364,3,8,10,21
10035,11365,6,8,23,37
10035,11366,0,1,9,10
10035,11367,6,6,20,32
10035,11368,24,35,42,101
10035,11369,5,15,29,49
10035,11370,7,8,17,32
10035,11371,0,1,0,1
10035,11372,17,25,40,82
10035,11373,18,24,36,78
10035,11374,4,9,17,30
10035,11375,9,17,52,78
10035,11377,16,31,48,95
10035,11378,7,14,28,49
10035,11379,6,14,33,53
10035,11385,17,44,57,118
10035,11411,5,3,25,33
10035,11412,8,7,24,39
10035,11413,4,16,31,51
10035,11414,1,6,13,20
10035,11415,2,7,4,13
10035,11416,4,7,8,19
10035,11417,0,0,17,17
10035,11418,2,13,13,28
10035,11419,4,11,19,34
10035,11420,7,12,16,35
10035,11421,6,11,17,34
10035,11422,6,14,25,45
10035,11423,2,5,24,31
10035,11426,5,7,7,19
10035,11427,6,9,14,29
10035,11428,3,8,10,21
10035,11429,5,7,25,37
10035,11430,2,0,0,2
10035,11432,10,12,34,56
10035,11433,3,14,26,43
10035,11434,9,18,51,78
10035,11435,5,8,35,48
10035,11436,2,4,10,16
10035,11691,8,13,21,42
10035,11692,1,2,6,9
10035,11693,3,0,5,8
10035,11694,0,2,1,3
10035,11697,1,0,3,4
10036,10001,83,64,518,665
10036,10002,159,176,716,1051
10036,10003,165,93,1107,1365
10036,10004,10,4,132,146
10036,10005,9,13,257,279
10036,10006,9,3,102,114
10036,10007,10,13,187,210
10036,10009,166,162,926,1254
10036,10010,88,73,678,839
10036,10011,162,119,1377,1658
10036,10012,55,29,410,494
10036,10013,60,42,480,582
10036,10014,122,66,835,1023
10036,10016,108,123,1320,1551
10036,10017,45,64,533,642
10036,10018,63,40,239,342
10036,10019,269,273,1509,2051
10036,10021,56,56,749,861
10036,10022,72,41,713,826
10036,10023,186,125,1492,1803
10036,10024,188,110,1299,1597
10036,10025,322,259,1375,1956
10036,10026,145,131,409,685
10036,10027,179,210,463,852
10036,10028,62,64,830,956
10036,10029,212,257,456,925
10036,10030,99,144,232,475
10036,10031,245,311,506,1062
10036,10032,263,243,427,933
10036,10033,225,249,392,866
10036,10034,134,181,328,643
10036,10035,89,134,193,416
10036,10036,359,345,1325,2029
10036,10037,63,66,186,315
10036,10038,33,34,408,475
10036,10039,107,103,148,358
10036,10040,159,192,363,714
10036,10044,22,43,122,187
10036,10065,68,54,577,699
10036,10069,18,14,129,161
10036,10075,52,44,518,614
10036,10119,0,2,3,5
10036,10128,118,103,1150,1371
10036,10162,9,4,39,52
10036,10173,1,0,1,2
10036,10199,0,0,1,1
10036,10280,18,11,250,279
10036,10282,1,2,105,108
10036,10301,43,85,198,326
10036,10302,14,31,62,107
10036,10303,26,36,92,154
10036,10304,43,64,142,249
10036,10305,38,53,168,259
10036,10306,47,42,219,308
10036,10307,8,12,59,79
10036,10308,27,19,136,182
10036,10309,25,24,118,167
10036,10310,22,40,114,176
10036,10312,36,46,254,336
10036,10314,59,76,370,505
10036,10451,105,200,181,486
10036,10452,164,283,255,702
10036,10453,151,271,252,674
10036,10454,75,130,93,298
10036,10455,85,142,114,341
10036,10456,198,379,225,802
10036,10457,141,235,203,579
10036,10458,136,262,244,642
10036,10459,95,119,123,337
10036,10460,88,205,158,451
10036,10461,87,111,307,505
10036,10462,144,226,413,783
10036,10463,134,215,485,834
10036,10464,10,5,28,43
10036,10465,68,66,176,310
10036,10466,108,168,212,488
10036,10467,197,310,326,833
10036,10468,153,290,246,689
10036,10469,112,144,211,467
10036,10470,21,27,82,130
10036,10471,47,39,166,252
10036,10472,98,204,207,509
10036,10473,94,155,218,467
10036,10474,25,37,23,85
10036,10475,65,85,188,338
10036,11001,5,7,20,32
10036,11003,0,0,2,2
10036,11004,11,15,51,77
10036,11005,1,1,6,8
10036,11040,4,1,11,16
10036,11101,81,100,538,719
10036,11102,109,149,531,789
10036,11103,155,159,569,883
10036,11104,95,109,358,562
10036,11105,129,170,494,793
10036,11106,165,206,598,969
10036,11109,14,6,223,243
10036,11201,126,101,1094,1321
10036,11203,134,196,299,629
10036,11204,64,120,255,439
10036,11205,79,80,326,485
10036,11206,150,268,452,870
10036,11207,181,312,298,791
10036,11208,144,303,244,691
10036,11209,120,130,590,840
10036,11210,100,146,279,525
10036,11211,161,186,1145,1492
10036,11212,147,233,215,595
10036,11213,120,191,263,574
10036,11214,63,119,340,522
10036,11215,146,131,1025,1302
10036,11216,153,200,501,854
10036,11217,102,87,649,838
10036,11218,137,161,503,801
10036,11219,91,127,176,394
10036,11220,91,149,308,548
10036,11221,176,261,474,911
10036,11222,86,114,542,742
10036,11223,56,105,263,424
10036,11224,26,54,120,200
10036,11225,139,191,450,780
10036,11226,202,328,553,1083
10036,11228,36,68,176,280
10036,11229,72,115,310,497
10036,11230,112,132,370,614
10036,11231,64,72,503,639
10036,11232,53,56,144,253
10036,11233,158,183,294,635
10036,11234,115,149,463,727
10036,11235,69,97,230,396
10036,11236,144,177,329,650
10036,11237,103,173,332,608
10036,11238,134,122,688,944
10036,11239,17,30,33,80
10036,11354,57,113,237,407
10036,11355,92,136,281,509
10036,11356,20,44,86,150
10036,11357,41,56,232,329
10036,11358,36,49,205,290
10036,11359,0,2,1,3
10036,11360,15,27,87,129
10036,11361,25,41,158,224
10036,11362,9,20,71,100
10036,11363,10,8,34,52
10036,11364,22,50,154,226
10036,11365,48,74,207,329
10036,11366,16,33,73,122
10036,11367,63,94,235,392
10036,11368,123,287,345,755
10036,11369,69,108,215,392
10036,11370,52,87,144,283
10036,11371,1,2,2,5
10036,11372,147,259,487,893
10036,11373,218,479,601,1298
10036,11374,124,140,483,747
10036,11375,121,230,960,1311
10036,11377,224,378,793,1395
10036,11378,49,91,213,353
10036,11379,50,84,259,393
10036,11385,181,270,638,1089
10036,11411,29,36,89,154
10036,11412,50,52,75,177
10036,11413,44,65,141,250
10036,11414,29,35,123,187
10036,11415,44,53,169,266
10036,11416,48,70,94,212
10036,11417,53,74,148,275
10036,11418,55,109,174,338
10036,11419,57,109,218,384
10036,11420,30,85,193,308
10036,11421,65,110,215,390
10036,11422,25,47,119,191
10036,11423,35,61,109,205
10036,11426,19,20,76,115
10036,11427,28,53,119,200
10036,11428,21,52,94,167
10036,11429,23,42,96,161
10036,11430,1,0,3,4
10036,11432,82,156,261,499
10036,11433,33,52,78,163
10036,11434,55,76,132,263
10036,11435,64,131,237,432
10036,11436,15,21,42,78
10036,11691,52,71,113,236
10036,11692,9,26,52,87
10036,11693,9,17,42,68
10036,11694,16,28,96,140
10036,11697,4,4,17,25
10037,10001,0,3,2,5
10037,10002,3,6,12,21
10037,10003,2,0,6,8
10037,10004,1,1,0,2
10037,10005,0,0,1,1
10037,10006,0,1,2,3
10037,10009,2,6,12,20
10037,10010,0,1,13,14
10037,10011,0,5,6,11
10037,10012,3,2,5,10
10037,10013,2,2,2,6
10037,10014,2,0,2,4
10037,10016,1,1,17,19
10037,10017,0,1,1,2
10037,10018,1,1,2,4
10037,10019,2,2,13,17
10037,10022,0,2,4,6
10037,10023,5,2,9,16
10037,10024,1,0,13,14
10037,10025,6,7,24,37
10037,10026,9,9,20,38
10037,10027,27,31,33,91
10037,10028,0,0,9,9
10037,10029,13,38,64,115
10037,10030,8,22,31,61
10037,10031,9,8,23,40
10037,10032,4,10,21,35
10037,10033,3,5,20,28
10037,10034,3,16,22,41
10037,10035,13,21,29,63
10037,10036,2,1,7,10
10037,10037,26,26,26,78
10037,10038,0,1,5,6
10037,10039,14,14,29,57
10037,10040,2,10,13,25
10037,10044,1,1,9,11
10037,10065,0,0,6,6
10037,10069,1,0,2,3
10037,10075,0,1,3,4
10037,10119,0,0,1,1
10037,10128,3,1,29,33
10037,10301,0,2,5,7
10037,10302,0,0,3,3
10037,10303,0,3,2,5
10037,10304,0,1,11,12
10037,10305,0,1,3,4
10037,10306,0,0,4,4
10037,10308,0,2,5,7
10037,10309,0,3,1,4
10037,10310,0,1,4,5
10037,10312,1,3,4,8
10037,10314,0,4,10,14
10037,10451,14,11,37,62
10037,10452,9,22,36,67
10037,10453,10,32,44,86
10037,10454,5,11,23,39
10037,10455,5,14,24,43
10037,10456,22,41,42,105
10037,10457,14,11,41,66
10037,10458,9,25,17,51
10037,10459,8,10,32,50
10037,10460,10,16,45,71
10037,10461,7,12,38,57
10037,10462,12,21,58,91
10037,10463,4,10,35,49
10037,10464,0,0,1,1
10037,10465,4,6,26,36
10037,10466,7,19,70,96
10037,10467,4,32,71,107
10037,10468,8,12,37,57
10037,10469,6,19,66,91
10037,10470,0,1,10,11
10037,10471,0,1,11,12
10037,10472,3,14,30,47
10037,10473,14,14,45,73
10037,10474,1,3,3,7
10037,10475,3,9,37,49
10037,11001,0,0,4,4
10037,11004,1,1,6,8
10037,11101,2,6,9,17
10037,11102,1,3,20,24
10037,11103,1,4,17,22
10037,11104,0,0,11,11
10037,11105,1,2,12,15
10037,11106,1,0,15,16
10037,11109,0,0,2,2
10037,11201,0,3,3,6
10037,11203,3,3,39,45
10037,11204,1,0,4,5
10037,11205,1,0,4,5
10037,11206,0,4,15,19
10037,11207,7,15,15,37
10037,11208,4,4,22,30
10037,11209,0,0,13,13
10037,11210,3,7,18,28
10037,11211,1,3,6,10
10037,11212,0,16,30,46
10037,11213,0,8,15,23
10037,11214,0,4,8,12
10037,11215,0,0,8,8
10037,11216,3,2,11,16
10037,11217,1,1,5,7
10037,11218,1,2,7,10
10037,11219,1,0,6,7
10037,11220,5,2,7,14
10037,11221,2,2,10,14
10037,11222,0,1,5,6
10037,11223,1,0,11,12
10037,11224,0,4,9,13
10037,11225,4,8,20,32
10037,11226,2,6,38,46
10037,11228,0,0,4,4
10037,11229,1,2,12,15
10037,11230,2,3,14,19
10037,11231,0,0,3,3
10037,11232,0,1,1,2
10037,11233,2,4,19,25
10037,11234,1,14,28,43
10037,11235,1,3,9,13
10037,11236,1,9,36,46
10037,11237,1,2,3,6
10037,11238,0,4,10,14
10037,11239,0,2,5,7
10037,11354,4,4,8,16
10037,11355,2,5,16,23
10037,11356,1,0,13,14
10037,11357,0,1,7,8
10037,11358,1,3,9,13
10037,11359,0,0,1,1
10037,11360,0,1,1,2
10037,11361,2,0,2,4
10037,11362,0,0,6,6
10037,11363,0,0,1,1
10037,11364,0,0,5,5
10037,11365,2,1,11,14
10037,11366,0,0,2,2
10037,11367,0,0,9,9
10037,11368,3,6,16,25
10037,11369,1,2,15,18
10037,11370,0,1,6,7
10037,11372,0,3,25,28
10037,11373,3,5,42,50
10037,11374,1,0,14,15
10037,11375,0,4,19,23
10037,11377,6,11,29,46
10037,11378,1,5,9,15
10037,11379,2,1,6,9
10037,11385,4,2,11,17
10037,11411,1,1,8,10
10037,11412,2,1,7,10
10037,11413,1,0,12,13
10037,11414,0,0,4,4
10037,11415,0,0,2,2
10037,11416,0,0,5,5
10037,11417,0,0,7,7
10037,11418,1,4,7,12
10037,11419,0,3,6,9
10037,11420,0,3,9,12
10037,11421,3,6,5,14
10037,11422,2,2,13,17
10037,11423,0,2,9,11
10037,11426,0,0,6,6
10037,11427,0,2,8,10
10037,11428,0,2,9,11
10037,11429,1,2,10,13
10037,11432,3,4,19,26
10037,11433,0,1,9,10
10037,11434,3,1,24,28
10037,11435,0,4,17,21
10037,11436,0,2,8,10
10037,11691,2,1,12,15
10037,11692,0,2,5,7
10037,11693,0,0,1,1
10037,11694,0,0,2,2
10038,10001,12,11,69,92
10038,10002,186,157,201,544
10038,10003,27,26,153,206
10038,10004,4,5,29,38
10038,10005,10,5,86,101
10038,10006,3,1,26,30
10038,10007,8,4,38,50
10038,10009,49,57,212,318
10038,10010,13,18,101,132
10038,10011,32,42,173,247
10038,10012,13,14,80,107
10038,10013,25,24,112,161
10038,10014,19,12,108,139
10038,10016,29,23,226,278
10038,10017,10,10,64,84
10038,10018,4,6,17,27
10038,10019,17,34,147,198
10038,10021,10,14,165,189
10038,10022,18,14,114,146
10038,10023,27,25,182,234
10038,10024,25,30,159,214
10038,10025,69,58,293,420
10038,10026,40,37,95,172
10038,10027,92,81,111,284
10038,10028,17,8,137,162
10038,10029,114,101,103,318
10038,10030,55,41,52,148
10038,10031,76,73,89,238
10038,10032,58,73,106,237
10038,10033,59,60,91,210
10038,10034,42,50,70,162
10038,10035,73,39,54,166
10038,10036,39,29,96,164
10038,10037,19,20,45,84
10038,10038,107,84,199,390
10038,10039,38,29,34,101
10038,10040,39,28,61,128
10038,10044,7,2,25,34
10038,10065,12,6,85,103
10038,10069,4,2,10,16
10038,10075,11,6,76,93
10038,10119,0,0,1,1
10038,10128,33,21,229,283
10038,10162,1,2,5,8
10038,10173,2,0,0,2
10038,10280,8,8,82,98
10038,10282,1,2,15,18
10038,10301,54,53,109,216
10038,10302,28,19,40,87
10038,10303,71,38,36,145
10038,10304,87,52,94,233
10038,10305,35,39,100,174
10038,10306,40,41,167,248
10038,10307,15,7,24,46
10038,10308,27,17,73,117
10038,10309,31,18,83,132
10038,10310,41,26,71,138
10038,10312,48,41,179,268
10038,10314,93,90,224,407
10038,10451,73,58,72,203
10038,10452,132,132,89,353
10038,10453,105,92,74,271
10038,10454,75,30,38,143
10038,10455,60,60,41,161
10038,10456,166,118,87,371
10038,10457,120,87,46,253
10038,10458,101,73,58,232
10038,10459,81,55,57,193
10038,10460,107,88,52,247
10038,10461,38,47,67,152
10038,10462,84,77,117,278
10038,10463,48,58,68,174
10038,10464,2,3,8,13
10038,10465,30,37,55,122
10038,10466,75,54,70,199
10038,10467,86,83,80,249
10038,10468,83,60,61,204
10038,10469,75,56,55,186
10038,10470,26,11,16,53
10038,10471,15,12,24,51
10038,10472,84,62,62,208
10038,10473,84,62,73,219
10038,10474,13,5,6,24
10038,10475,30,34,46,110
10038,11001,1,3,9,13
10038,11004,11,5,24,40
10038,11040,4,0,6,10
10038,11101,55,42,85,182
10038,11102,53,33,98,184
10038,11103,32,35,125,192
10038,11104,26,30,84,140
10038,11105,39,18,76,133
10038,11106,52,30,109,191
10038,11109,0,4,38,42
10038,11201,51,49,361,461
10038,11203,122,112,163,397
10038,11204,70,72,123,265
10038,11205,62,43,91,196
10038,11206,133,118,150,401
10038,11207,207,145,102,454
10038,11208,158,138,103,399
10038,11209,53,57,256,366
10038,11210,93,77,115,285
10038,11211,85,62,237,384
10038,11212,189,126,114,429
10038,11213,93,97,130,320
10038,11214,135,92,157,384
10038,11215,40,47,289,376
10038,11216,90,64,186,340
10038,11217,34,33,189,256
10038,11218,58,70,205,333
10038,11219,85,81,58,224
10038,11220,119,95,130,344
10038,11221,148,109,164,421
10038,11222,31,31,109,171
10038,11223,78,76,151,305
10038,11224,70,46,89,205
10038,11225,87,90,146,323
10038,11226,161,167,237,565
10038,11228,46,54,108,208
10038,11229,96,89,193,378
10038,11230,88,109,147,344
10038,11231,26,22,130,178
10038,11232,28,33,56,117
10038,11233,113,94,121,328
10038,11234,92,122,196,410
10038,11235,60,45,177,282
10038,11236,136,106,164,406
10038,11237,62,47,110,219
10038,11238,69,67,278,414
10038,11239,28,23,18,69
10038,11354,56,33,80,169
10038,11355,87,50,86,223
10038,11356,10,20,35,65
10038,11357,12,17,51,80
10038,11358,22,19,64,105
10038,11360,10,11,24,45
10038,11361,16,15,35,66
10038,11362,10,7,23,40
10038,11363,5,2,7,14
10038,11364,18,17,56,91
10038,11365,26,35,62,123
10038,11366,11,7,23,41
10038,11367,51,16,56,123
10038,11368,82,75,63,220
10038,11369,39,38,51,128
10038,11370,20,19,30,69
10038,11372,52,48,164,264
10038,11373,87,118,118,323
10038,11374,31,28,115,174
10038,11375,44,48,233,325
10038,11377,79,122,176,377
10038,11378,25,34,76,135
10038,11379,18,31,97,146
10038,11385,147,109,216,472
10038,11411,18,22,41,81
10038,11412,48,43,72,163
10038,11413,53,42,72,167
10038,11414,11,7,62,80
10038,11415,13,24,57,94
10038,11416,27,40,33,100
10038,11417,24,40,42,106
10038,11418,25,25,66,116
10038,11419,38,44,45,127
10038,11420,51,40,73,164
10038,11421,40,52,69,161
10038,11422,31,22,38,91
10038,11423,36,42,54,132
10038,11426,9,13,28,50
10038,11427,12,15,31,58
10038,11428,19,13,35,67
10038,11429,48,19,26,93
10038,11430,0,0,1,1
10038,11432,65,64,95,224
10038,11433,42,32,35,109
10038,11434,94,55,84,233
10038,11435,83,35,68,186
10038,11436,32,19,28,79
10038,11691,97,37,62,196
10038,11692,38,11,27,76
10038,11693,7,16,24,47
10038,11694,16,8,43,67
10038,11697,0,1,6,7
10039,10001,2,0,4,6
10039,10002,3,2,2,7
10039,10003,2,2,2,6
10039,10004,0,0,1,1
10039,10005,0,1,1,2
10039,10007,0,0,1,1
10039,10009,2,2,3,7
10039,10010,0,2,1,3
10039,10011,3,2,1,6
10039,10012,1,0,0,1
10039,10013,2,1,2,5
10039,10014,1,0,1,2
10039,10016,0,0,3,3
10039,10017,1,2,0,3
10039,10019,1,4,3,8
10039,10021,0,2,3,5
10039,10022,1,1,1,3
10039,10023,2,4,1,7
10039,10024,1,1,5,7
10039,10025,0,4,8,12
10039,10026,3,10,5,18
10039,10027,6,8,8,22
10039,10028,0,0,5,5
10039,10029,4,16,8,28
10039,10030,7,17,14,38
10039,10031,5,12,12,29
10039,10032,10,5,3,18
10039,10033,3,8,1,12
10039,10034,1,6,2,9
10039,10035,3,6,6,15
10039,10036,4,3,3,10
10039,10037,2,4,4,10
10039,10038,0,2,0,2
10039,10039,14,34,14,62
10039,10040,2,2,2,6
10039,10044,2,0,0,2
10039,10065,0,2,0,2
10039,10069,0,1,1,2
10039,10075,0,1,1,2
10039,10128,1,1,4,6
10039,10282,0,1,0,1
10039,10301,1,0,3,4
10039,10302,0,0,1,1
10039,10303,0,0,1,1
10039,10304,0,0,1,1
10039,10305,0,1,3,4
10039,10306,1,0,6,7
10039,10307,0,0,1,1
10039,10308,0,0,1,1
10039,10309,0,0,1,1
10039,10310,0,0,3,3
10039,10312,1,1,4,6
10039,10314,1,0,4,5
10039,10451,5,8,7,20
10039,10452,13,8,9,30
10039,10453,1,10,6,17
10039,10454,1,4,2,7
10039,10455,4,4,3,11
10039,10456,13,10,10,33
10039,10457,6,6,9,21
10039,10458,4,11,14,29
10039,10459,4,8,5,17
10039,10460,6,9,3,18
10039,10461,2,1,6,9
10039,10462,4,9,10,23
10039,10463,2,8,8,18
10039,10464,0,0,2,2
10039,10465,2,2,5,9
10039,10466,5,4,16,25
10039,10467,9,16,16,41
10039,10468,5,16,4,25
10039,10469,7,9,7,23
10039,10470,0,3,3,6
10039,10471,1,1,6,8
10039,10472,4,10,3,17
10039,10473,11,7,8,26
10039,10474,0,5,1,6
10039,10475,3,2,8,13
10039,11004,0,0,1,1
10039,11101,2,0,3,5
10039,11102,2,1,2,5
10039,11103,1,3,4,8
10039,11104,0,2,3,5
10039,11105,0,3,2,5
10039,11106,1,6,5,12
10039,11201,0,0,3,3
10039,11203,1,3,1,5
10039,11204,1,1,0,2
10039,11205,0,2,2,4
10039,11206,1,2,5,8
10039,11207,4,2,7,13
10039,11208,3,2,5,10
10039,11209,1,3,3,7
10039,11210,0,2,2,4
10039,11211,0,1,6,7
10039,11212,1,1,3,5
10039,11213,2,5,10,17
10039,11214,0,1,2,3
10039,11215,0,1,0,1
10039,11216,0,2,4,6
10039,11217,0,2,3,5
10039,11218,1,2,2,5
10039,11219,1,1,1,3
10039,11220,1,0,2,3
10039,11221,0,3,4,7
10039,11222,0,1,1,2
10039,11223,0,1,3,4
10039,11224,2,1,0,3
10039,11225,3,1,3,7
10039,11226,2,4,7,13
10039,11228,0,0,4,4
10039,11229,0,1,4,5
10039,11230,2,0,3,5
10039,11231,3,1,3,7
10039,11232,2,0,2,4
10039,11233,2,2,6,10
10039,11234,3,3,4,10
10039,11235,0,0,3,3
10039,11236,2,2,2,6
10039,11237,1,2,1,4
10039,11238,0,1,3,4
10039,11239,5,1,1,7
10039,11354,1,2,4,7
10039,11355,2,2,3,7
10039,11356,1,2,0,3
10039,11357,2,4,6,12
10039,11358,0,2,6,8
10039,11360,0,1,1,2
10039,11361,0,2,1,3
10039,11362,0,1,1,2
10039,11364,0,1,5,6
10039,11365,1,2,1,4
10039,11367,1,1,1,3
10039,11368,1,7,5,13
10039,11369,1,1,2,4
10039,11370,1,1,5,7
10039,11371,1,0,1,2
10039,11372,3,2,9,14
10039,11373,5,3,6,14
10039,11374,0,2,1,3
10039,11375,0,1,3,4
10039,11377,4,5,10,19
10039,11378,0,1,3,4
10039,11379,0,1,0,1
10039,11385,2,1,5,8
10039,11411,0,0,6,6
10039,11412,0,1,1,2
10039,11413,2,1,4,7
10039,11414,0,1,0,1
10039,11416,0,2,2,4
10039,11417,0,1,0,1
10039,11418,0,0,4,4
10039,11419,0,2,1,3
10039,11420,3,0,3,6
10039,11421,0,1,3,4
10039,11422,0,2,0,2
10039,11423,0,0,3,3
10039,11426,1,1,0,2
10039,11427,0,0,1,1
10039,11428,0,2,0,2
10039,11429,0,2,1,3
10039,11432,2,1,3,6
10039,11433,0,3,2,5
10039,11434,0,2,4,6
10039,11435,0,1,2,3
10039,11436,0,0,1,1
10039,11691,2,2,3,7
10039,11694,0,0,1,1
10039,11697,0,1,0,1
10040,10001,1,0,1,2
10040,10002,1,6,6,13
10040,10003,1,2,8,11
10040,10005,1,0,0,1
10040,10007,1,0,0,1
10040,10009,0,7,10,17
10040,10010,0,1,2,3
10040,10011,3,3,3,9
10040,10012,1,0,0,1
10040,10013,1,1,1,3
10040,10014,0,1,1,2
10040,10016,3,1,9,13
10040,10017,0,0,2,2
10040,10018,0,0,1,1
10040,10019,1,0,11,12
10040,10021,3,1,6,10
10040,10022,3,0,0,3
10040,10023,4,4,5,13
10040,10024,5,3,16,24
10040,10025,16,22,30,68
10040,10026,7,7,14,28
10040,10027,9,24,18,51
10040,10028,1,1,1,3
10040,10029,9,26,15,50
10040,10030,7,13,5,25
10040,10031,18,33,15,66
10040,10032,36,86,31,153
10040,10033,68,106,54,228
10040,10034,91,94,28,213
10040,10035,12,11,9,32
10040,10036,2,0,3,5
10040,10037,2,1,12,15
10040,10038,1,0,1,2
10040,10039,11,7,2,20
10040,10040,146,161,63,370
10040,10044,0,1,1,2
10040,10065,0,0,6,6
10040,10075,0,0,5,5
10040,10128,1,4,4,9
10040,10162,0,0,1,1
10040,10282,0,0,1,1
10040,10301,2,9,4,15
10040,10302,0,1,2,3
10040,10303,3,1,1,5
10040,10304,2,2,5,9
10040,10305,0,0,4,4
10040,10306,1,2,8,11
10040,10307,0,0,3,3
10040,10308,2,1,5,8
10040,10309,0,0,6,6
10040,10310,1,0,3,4
10040,10312,0,3,6,9
10040,10314,1,3,6,10
10040,10451,15,20,10,45
10040,10452,35,70,27,132
10040,10453,36,81,16,133
10040,10454,4,15,6,25
10040,10455,6,28,14,48
10040,10456,24,64,31,119
10040,10457,24,55,25,104
10040,10458,34,54,15,103
10040,10459,19,31,6,56
10040,10460,11,31,20,62
10040,10461,3,20,24,47
10040,10462,8,33,36,77
10040,10463,30,44,62,136
10040,10464,0,1,2,3
10040,10465,4,14,17,35
10040,10466,11,39,30,80
10040,10467,32,51,32,115
10040,10468,40,64,30,134
10040,10469,7,24,42,73
10040,10470,0,8,7,15
10040,10471,8,11,20,39
10040,10472,10,20,9,39
10040,10473,17,26,14,57
10040,10474,3,4,5,12
10040,10475,2,19,15,36
10040,11001,0,0,1,1
10040,11004,0,1,1,2
10040,11005,0,0,1,1
10040,11040,0,0,1,1
10040,11101,0,0,4,4
10040,11102,2,2,7,11
10040,11103,3,3,9,15
10040,11104,0,1,4,5
10040,11105,5,9,8,22
10040,11106,1,4,7,12
10040,11109,0,0,1,1
10040,11201,0,2,0,2
10040,11203,1,17,2,20
10040,11204,1,3,4,8
10040,11205,4,2,2,8
10040,11206,0,6,11,17
10040,11207,6,7,11,24
10040,11208,5,4,6,15
10040,11209,2,0,8,10
10040,11210,2,8,9,19
10040,11211,1,1,9,11
10040,11212,2,7,3,12
10040,11213,0,12,11,23
10040,11214,1,6,7,14
10040,11215,1,1,7,9
10040,11216,1,9,3,13
10040,11217,0,1,1,2
10040,11218,1,0,4,5
10040,11219,1,4,5,10
10040,11220,0,4,10,14
10040,11221,1,4,9,14
10040,11222,0,1,4,5
10040,11223,3,4,7,14
10040,11224,1,4,3,8
10040,11225,1,12,3,16
10040,11226,4,18,11,33
10040,11228,1,1,6,8
10040,11229,3,4,3,10
10040,11230,4,1,8,13
10040,11231,1,1,3,5
10040,11232,0,2,0,2
10040,11233,2,3,5,10
10040,11234,2,6,4,12
10040,11235,1,2,2,5
10040,11236,2,11,16,29
10040,11237,2,1,1,4
10040,11238,0,3,6,9
10040,11354,2,2,0,4
10040,11355,0,6,9,15
10040,11356,2,2,3,7
10040,11357,3,3,3,9
10040,11358,0,3,1,4
10040,11360,0,1,3,4
10040,11361,1,3,5,9
10040,11362,0,2,1,3
10040,11363,0,1,1,2
10040,11364,3,1,5,9
10040,11365,2,4,2,8
10040,11367,1,1,6,8
10040,11368,2,10,8,20
10040,11369,4,1,1,6
10040,11370,2,2,2,6
10040,11372,3,5,2,10
10040,11373,2,8,9,19
10040,11374,2,5,6,13
10040,11375,1,5,5,11
10040,11377,2,2,2,6
10040,11378,2,1,2,5
10040,11379,2,4,3,9
10040,11385,4,7,10,21
10040,11411,1,2,2,5
10040,11412,2,3,4,9
10040,11413,0,6,6,12
10040,11414,1,2,4,7
10040,11415,0,0,3,3
10040,11416,1,1,2,4
10040,11417,1,5,2,8
10040,11418,1,4,3,8
10040,11419,4,2,5,11
10040,11420,1,3,8,12
10040,11421,0,4,3,7
10040,11422,0,1,6,7
10040,11423,0,2,5,7
10040,11426,2,2,4,8
10040,11427,0,5,3,8
10040,11428,1,1,2,4
10040,11429,2,2,5,9
10040,11432,2,3,3,8
10040,11433,0,1,0,1
10040,11434,1,5,3,9
10040,11435,2,3,5,10
10040,11436,0,0,3,3
10040,11691,2,0,5,7
10040,11692,0,0,3,3
10040,11693,0,0,3,3
10040,11694,0,0,3,3
10044,10001,0,0,6,6
10044,10002,1,0,14,15
10044,10003,1,0,8,9
10044,10004,0,0,1,1
10044,10005,0,0,1,1
10044,10006,0,0,1,1
10044,10009,5,3,9,17
10044,10010,0,1,5,6
10044,10011,2,1,8,11
10044,10012,0,1,1,2
10044,10013,1,1,4,6
10044,10014,0,0,3,3
10044,10016,0,0,9,9
10044,10018,0,1,1,2
10044,10019,0,2,4,6
10044,10021,2,0,7,9
10044,10022,2,1,7,10
10044,10023,4,2,6,12
10044,10024,0,0,12,12
10044,10025,1,2,20,23
10044,10026,2,2,14,18
10044,10027,3,6,15,24
10044,10028,3,2,12,17
10044,10029,2,7,24,33
10044,10030,0,0,10,10
10044,10031,1,2,10,13
10044,10032,0,2,12,14
10044,10033,0,2,13,15
10044,10034,2,2,7,11
10044,10035,0,3,9,12
10044,10036,5,2,0,7
10044,10037,1,0,7,8
10044,10038,0,1,5,6
10044,10039,1,1,10,12
10044,10040,0,5,7,12
10044,10044,18,28,25,71
10044,10065,0,0,3,3
10044,10069,0,0,2,2
10044,10075,1,1,3,5
10044,10119,0,0,1,1
10044,10128,1,2,9,12
10044,10280,0,0,2,2
10044,10301,0,1,4,5
10044,10302,0,0,1,1
10044,10304,0,1,7,8
10044,10305,0,0,5,5
10044,10306,0,0,4,4
10044,10307,0,0,3,3
10044,10308,0,2,1,3
10044,10309,0,1,3,4
10044,10310,0,0,2,2
10044,10312,0,2,2,4
10044,10314,1,1,14,16
10044,10451,0,3,11,14
10044,10452,3,6,10,19
10044,10453,4,4,17,25
10044,10454,0,1,9,10
10044,10455,0,4,10,14
10044,10456,2,3,19,24
10044,10457,1,3,13,17
10044,10458,1,4,13,18
10044,10459,0,4,9,13
10044,10460,1,2,19,22
10044,10461,2,2,33,37
10044,10462,2,2,41,45
10044,10463,0,2,9,11
10044,10464,0,0,2,2
10044,10465,0,4,14,18
10044,10466,1,3,33,37
10044,10467,1,5,31,37
10044,10468,1,7,17,25
10044,10469,1,3,30,34
10044,10470,0,1,6,7
10044,10471,0,0,4,4
10044,10472,0,8,16,24
10044,10473,0,6,23,29
10044,10474,0,2,1,3
10044,10475,0,0,13,13
10044,11001,0,0,2,2
10044,11004,0,0,6,6
10044,11005,0,2,0,2
10044,11040,0,0,1,1
10044,11101,3,6,8,17
10044,11102,0,4,2,6
10044,11103,0,5,13,18
10044,11104,0,4,5,9
10044,11105,0,3,10,13
10044,11106,1,5,9,15
10044,11109,0,0,1,1
10044,11201,0,2,6,8
10044,11203,1,6,52,59
10044,11204,0,0,5,5
10044,11205,1,2,12,15
10044,11206,3,5,21,29
10044,11207,2,11,29,42
10044,11208,3,7,34,44
10044,11209,0,1,9,10
10044,11210,0,2,21,23
10044,11211,0,2,13,15
10044,11212,4,8,27,39
10044,11213,1,2,24,27
10044,11214,0,1,5,6
10044,11215,1,4,16,21
10044,11216,1,7,19,27
10044,11217,1,2,7,10
10044,11218,0,2,9,11
10044,11219,0,1,2,3
10044,11220,1,1,5,7
10044,11221,2,9,21,32
10044,11222,0,0,5,5
10044,11223,0,1,10,11
10044,11224,2,2,8,12
10044,11225,0,4,16,20
10044,11226,3,8,27,38
10044,11228,0,0,1,1
10044,11229,1,0,4,5
10044,11230,1,0,11,12
10044,11231,0,0,9,9
10044,11232,0,2,3,5
10044,11233,3,3,25,31
10044,11234,2,3,39,44
10044,11235,0,0,18,18
10044,11236,2,7,52,61
10044,11237,2,3,4,9
10044,11238,0,2,10,12
10044,11239,0,2,1,3
10044,11354,1,4,7,12
10044,11355,1,1,13,15
10044,11356,0,1,3,4
10044,11357,1,0,8,9
10044,11358,2,0,16,18
10044,11360,0,0,3,3
10044,11361,1,0,8,9
10044,11362,0,0,7,7
10044,11363,0,0,3,3
10044,11364,1,0,7,8
10044,11365,2,1,7,10
10044,11366,0,0,3,3
10044,11367,2,4,12,18
10044,11368,1,5,17,23
10044,11369,0,1,16,17
10044,11370,0,0,17,17
10044,11371,0,0,1,1
10044,11372,0,3,18,21
10044,11373,10,5,30,45
10044,11374,4,1,17,22
10044,11375,3,3,27,33
10044,11377,4,8,34,46
10044,11378,0,2,14,16
10044,11379,2,2,15,19
10044,11385,7,8,17,32
10044,11411,0,1,12,13
10044,11412,1,2,9,12
10044,11413,1,3,16,20
10044,11414,0,1,5,6
10044,11415,1,3,7,11
10044,11416,0,2,1,3
10044,11417,0,0,6,6
10044,11418,1,0,7,8
10044,11419,0,3,10,13
10044,11420,3,2,7,12
10044,11421,2,3,13,18
10044,11422,2,2,14,18
10044,11423,1,1,3,5
10044,11426,0,0,4,4
10044,11427,2,0,14,16
10044,11428,0,1,6,7
10044,11429,1,1,9,11
10044,11432,2,4,12,18
10044,11433,0,1,10,11
10044,11434,0,4,13,17
10044,11435,1,2,16,19
10044,11436,1,2,3,6
10044,11691,0,0,5,5
10044,11692,0,1,0,1
10044,11693,0,0,3,3
10044,11694,0,1,2,3
10044,11697,0,0,1,1
10065,10001,19,15,103,137
10065,10002,41,62,218,321
10065,10003,25,29,263,317
10065,10004,2,5,18,25
10065,10005,5,4,34,43
10065,10006,5,2,14,21
10065,10007,2,10,21,33
10065,10009,37,70,313,420
10065,10010,18,23,141,182
10065,10011,20,39,286,345
10065,10012,21,8,109,138
10065,10013,11,17,106,134
10065,10014,21,19,149,189
10065,10016,24,30,269,323
10065,10017,10,17,119,146
10065,10018,5,8,37,50
10065,10019,36,41,267,344
10065,10021,37,50,978,1065
10065,10022,17,45,316,378
10065,10023,31,41,349,421
10065,10024,20,43,301,364
10065,10025,53,79,502,634
10065,10026,39,39,210,288
10065,10027,39,75,219,333
10065,10028,35,47,463,545
10065,10029,49,122,333,504
10065,10030,21,22,124,167
10065,10031,31,83,238,352
10065,10032,42,100,460,602
10065,10033,54,88,257,399
10065,10034,45,38,212,295
10065,10035,24,66,168,258
10065,10036,28,22,145,195
10065,10037,14,11,97,122
10065,10038,8,21,87,116
10065,10039,18,36,88,142
10065,10040,38,53,178,269
10065,10044,9,18,245,272
10065,10065,82,106,1201,1389
10065,10069,4,2,36,42
10065,10075,25,26,317,368
10065,10128,57,53,603,713
10065,10162,2,0,29,31
10065,10280,3,2,40,45
10065,10282,0,0,11,11
10065,10301,11,15,52,78
10065,10302,10,7,30,47
10065,10303,6,12,41,59
10065,10304,13,14,64,91
10065,10305,13,12,76,101
10065,10306,11,20,91,122
10065,10307,2,3,16,21
10065,10308,3,10,45,58
10065,10309,7,7,36,50
10065,10310,7,7,37,51
10065,10312,12,13,71,96
10065,10314,17,33,142,192
10065,10451,32,60,127,219
10065,10452,36,80,197,313
10065,10453,42,92,179,313
10065,10454,26,37,65,128
10065,10455,23,37,94,154
10065,10456,48,126,148,322
10065,10457,49,69,155,273
10065,10458,38,66,146,250
10065,10459,31,45,79,155
10065,10460,27,53,138,218
10065,10461,22,46,238,306
10065,10462,47,107,338,492
10065,10463,40,68,273,381
10065,10464,1,3,12,16
10065,10465,22,44,129,195
10065,10466,21,51,188,260
10065,10467,37,77,227,341
10065,10468,37,81,202,320
10065,10469,25,54,194,273
10065,10470,4,13,51,68
10065,10471,10,12,67,89
10065,10472,32,74,156,262
10065,10473,35,54,202,291
10065,10474,13,10,21,44
10065,10475,14,25,183,222
10065,11001,1,1,11,13
10065,11004,5,3,30,38
10065,11005,1,0,4,5
10065,11040,0,0,5,5
10065,11101,29,44,198,271
10065,11102,40,39,237,316
10065,11103,57,52,265,374
10065,11104,25,53,191,269
10065,11105,35,50,240,325
10065,11106,39,58,258,355
10065,11109,3,2,43,48
10065,11201,24,29,212,265
10065,11203,24,39,191,254
10065,11204,19,27,99,145
10065,11205,17,31,90,138
10065,11206,46,58,179,283
10065,11207,40,68,233,341
10065,11208,35,58,183,276
10065,11209,22,36,152,210
10065,11210,30,25,190,245
10065,11211,55,52,277,384
10065,11212,26,56,171,253
10065,11213,28,49,188,265
10065,11214,21,32,108,161
10065,11215,30,25,262,317
10065,11216,24,39,173,236
10065,11217,15,20,151,186
10065,11218,27,33,101,161
10065,11219,21,22,93,136
10065,11220,29,44,135,208
10065,11221,46,77,195,318
10065,11222,23,27,174,224
10065,11223,27,29,118,174
10065,11224,17,16,66,99
10065,11225,16,42,153,211
10065,11226,23,61,236,320
10065,11228,17,21,97,135
10065,11229,20,27,102,149
10065,11230,21,23,137,181
10065,11231,9,29,125,163
10065,11232,6,9,41,56
10065,11233,36,49,159,244
10065,11234,32,43,254,329
10065,11235,20,21,120,161
10065,11236,50,56,328,434
10065,11237,24,39,124,187
10065,11238,38,33,214,285
10065,11239,11,8,40,59
10065,11354,36,38,134,208
10065,11355,53,42,136,231
10065,11356,14,19,56,89
10065,11357,20,36,118,174
10065,11358,25,15,103,143
10065,11359,1,1,1,3
10065,11360,3,11,53,67
10065,11361,8,10,66,84
10065,11362,2,3,44,49
10065,11363,2,2,18,22
10065,11364,9,14,92,115
10065,11365,13,27,89,129
10065,11366,8,11,25,44
10065,11367,19,25,105,149
10065,11368,59,85,178,322
10065,11369,24,44,96,164
10065,11370,19,37,71,127
10065,11371,0,0,1,1
10065,11372,41,79,274,394
10065,11373,101,152,287,540
10065,11374,34,34,228,296
10065,11375,41,65,413,519
10065,11377,85,122,439,646
10065,11378,19,29,160,208
10065,11379,40,40,177,257
10065,11385,55,92,360,507
10065,11411,3,8,47,58
10065,11412,9,16,81,106
10065,11413,13,17,93,123
10065,11414,12,8,40,60
10065,11415,11,13,73,97
10065,11416,10,21,49,80
10065,11417,16,12,55,83
10065,11418,16,25,111,152
10065,11419,21,29,108,158
10065,11420,7,27,94,128
10065,11421,25,29,108,162
10065,11422,5,14,66,85
10065,11423,12,14,62,88
10065,11426,4,6,47,57
10065,11427,4,12,52,68
10065,11428,6,10,45,61
10065,11429,5,18,70,93
10065,11432,16,37,147,200
10065,11433,11,8,71,90
10065,11434,15,31,136,182
10065,11435,26,44,126,196
10065,11436,7,8,38,53
10065,11691,9,13,79,101
10065,11692,2,2,19,23
10065,11693,2,2,16,20
10065,11694,0,4,30,34
10065,11697,0,1,10,11
10069,10001,1,1,0,2
10069,10002,1,1,3,5
10069,10003,1,0,2,3
10069,10007,0,0,1,1
10069,10009,0,3,1,4
10069,10010,1,0,1,2
10069,10011,0,1,3,4
10069,10013,0,1,1,2
10069,10014,0,0,1,1
10069,10016,1,0,2,3
10069,10017,1,0,0,1
10069,10018,0,0,1,1
10069,10019,3,0,3,6
10069,10022,0,0,3,3
10069,10023,8,3,21,32
10069,10024,1,1,2,4
10069,10025,1,4,6,11
10069,10026,1,0,1,2
10069,10027,2,2,2,6
10069,10028,0,1,2,3
10069,10029,3,2,1,6
10069,10030,1,2,2,5
10069,10031,3,6,3,12
10069,10032,1,1,6,8
10069,10033,1,1,4,6
10069,10034,3,1,2,6
10069,10035,0,0,2,2
10069,10036,3,0,0,3
10069,10037,0,0,2,2
10069,10038,0,0,2,2
10069,10039,0,0,1,1
10069,10040,1,2,3,6
10069,10065,0,0,1,1
10069,10069,1,1,2,4
10069,10075,0,0,3,3
10069,10128,2,1,2,5
10069,10302,0,0,1,1
10069,10303,1,0,0,1
10069,10304,1,1,2,4
10069,10305,0,1,0,1
10069,10306,0,0,1,1
10069,10312,1,0,1,2
10069,10451,0,1,1,2
10069,10452,1,3,4,8
10069,10453,3,0,3,6
10069,10454,0,0,1,1
10069,10455,1,1,1,3
10069,10456,1,4,1,6
10069,10457,2,1,4,7
10069,10458,0,0,3,3
10069,10459,3,2,0,5
10069,10460,0,3,2,5
10069,10462,0,0,4,4
10069,10463,1,1,4,6
10069,10465,0,1,0,1
10069,10466,1,0,2,3
10069,10467,0,2,5,7
10069,10468,0,0,6,6
10069,10469,1,0,0,1
10069,10470,0,0,1,1
10069,10472,2,0,0,2
10069,10473,2,2,4,8
10069,10474,1,0,0,1
10069,10475,0,1,1,2
10069,11004,0,0,1,1
10069,11101,0,1,1,2
10069,11102,0,0,4,4
10069,11103,1,1,3,5
10069,11104,0,1,2,3
10069,11105,0,1,4,5
10069,11106,2,0,3,5
10069,11201,0,0,4,4
10069,11203,0,2,4,6
10069,11204,0,2,0,2
10069,11205,2,0,0,2
10069,11206,1,1,6,8
10069,11207,2,1,0,3
10069,11208,0,1,1,2
10069,11209,0,0,1,1
10069,11210,1,0,0,1
10069,11211,0,1,1,2
10069,11212,0,2,2,4
10069,11213,1,1,2,4
10069,11214,0,2,1,3
10069,11215,2,0,3,5
10069,11216,0,1,2,3
10069,11217,0,2,3,5
10069,11218,0,1,2,3
10069,11219,0,1,0,1
10069,11220,0,1,2,3
10069,11221,1,0,3,4
10069,11222,2,1,0,3
10069,11223,0,0,1,1
10069,11225,0,0,1,1
10069,11226,1,1,2,4
10069,11229,0,0,1,1
10069,11230,0,0,1,1
10069,11231,0,1,1,2
10069,11233,0,1,2,3
10069,11234,0,0,1,1
10069,11235,0,2,2,4
10069,11236,0,1,3,4
10069,11237,0,1,2,3
10069,11238,1,0,4,5
10069,11239,0,0,1,1
10069,11354,1,0,1,2
10069,11355,0,0,2,2
10069,11356,0,1,0,1
10069,11357,0,0,2,2
10069,11358,0,0,1,1
10069,11361,1,0,0,1
10069,11364,2,0,2,4
10069,11365,0,0,2,2
10069,11368,1,3,2,6
10069,11369,0,1,2,3
10069,11370,0,1,0,1
10069,11372,1,1,3,5
10069,11373,1,2,4,7
10069,11374,1,1,2,4
10069,11375,0,0,3,3
10069,11377,4,1,3,8
10069,11378,1,0,0,1
10069,11379,1,0,1,2
10069,11385,1,2,4,7
10069,11412,0,0,1,1
10069,11414,0,0,1,1
10069,11417,0,1,1,2
10069,11418,1,0,2,3
10069,11419,1,0,0,1
10069,11421,0,0,1,1
10069,11422,0,0,1,1
10069,11423,0,0,2,2
10069,11427,1,1,0,2
10069,11428,0,1,0,1
10069,11432,0,2,3,5
10069,11435,1,0,1,2
10069,11436,0,1,0,1
10069,11691,0,0,1,1
10069,11692,0,0,2,2
10075,10001,2,6,10,18
10075,10002,11,29,41,81
10075,10003,7,10,24,41
10075,10004,0,2,2,4
10075,10005,0,0,6,6
10075,10006,0,0,1,1
10075,10007,1,0,1,2
10075,10009,15,14,39,68
10075,10010,5,9,21,35
10075,10011,12,12,38,62
10075,10012,3,4,16,23
10075,10013,4,4,13,21
10075,10014,7,9,19,35
10075,10016,6,10,26,42
10075,10017,2,3,13,18
10075,10018,2,4,6,12
10075,10019,4,26,27,57
10075,10021,27,29,109,165
10075,10022,11,9,32,52
10075,10023,14,20,39,73
10075,10024,10,17,58,85
10075,10025,27,37,70,134
10075,10026,10,20,27,57
10075,10027,7,22,32,61
10075,10028,43,49,148,240
10075,10029,37,48,75,160
10075,10030,4,26,10,40
10075,10031,19,28,31,78
10075,10032,8,35,26,69
10075,10033,18,36,24,78
10075,10034,13,20,29,62
10075,10035,11,34,34,79
10075,10036,9,12,19,40
10075,10037,4,5,7,16
10075,10038,2,3,5,10
10075,10039,11,12,10,33
10075,10040,5,24,22,51
10075,10044,3,1,8,12
10075,10065,13,13,39,65
10075,10069,2,1,4,7
10075,10075,36,55,113,204
10075,10128,30,44,111,185
10075,10162,3,2,0,5
10075,10280,0,1,8,9
10075,10282,1,0,2,3
10075,10301,0,4,12,16
10075,10302,2,0,5,7
10075,10303,3,6,5,14
10075,10304,2,5,1,8
10075,10305,2,3,9,14
10075,10306,0,5,12,17
10075,10307,1,2,2,5
10075,10308,2,1,4,7
10075,10309,0,4,5,9
10075,10310,1,5,8,14
10075,10312,2,5,12,19
10075,10314,5,11,21,37
10075,10451,8,24,19,51
10075,10452,15,34,31,80
10075,10453,11,44,17,72
10075,10454,6,16,15,37
10075,10455,8,16,8,32
10075,10456,16,37,18,71
10075,10457,14,25,13,52
10075,10458,7,39,35,81
10075,10459,10,31,15,56
10075,10460,10,25,18,53
10075,10461,9,23,27,59
10075,10462,11,24,47,82
10075,10463,6,14,31,51
10075,10464,1,0,2,3
10075,10465,5,13,24,42
10075,10466,10,15,17,42
10075,10467,7,36,37,80
10075,10468,3,32,27,62
10075,10469,12,24,15,51
10075,10470,2,3,4,9
10075,10471,4,2,19,25
10075,10472,14,42,24,80
10075,10473,14,29,25,68
10075,10474,4,3,4,11
10075,10475,5,11,16,32
10075,11001,0,1,0,1
10075,11004,1,3,2,6
10075,11005,0,1,0,1
10075,11101,2,17,21,40
10075,11102,7,21,44,72
10075,11103,9,33,55,97
10075,11104,4,20,25,49
10075,11105,15,26,41,82
10075,11106,6,12,45,63
10075,11109,0,3,3,6
10075,11201,4,18,39,61
10075,11203,9,17,19,45
10075,11204,4,7,12,23
10075,11205,12,7,26,45
10075,11206,16,20,23,59
10075,11207,15,15,16,46
10075,11208,4,21,21,46
10075,11209,11,10,12,33
10075,11210,9,25,10,44
10075,11211,15,13,47,75
10075,11212,8,15,9,32
10075,11213,9,18,24,51
10075,11214,3,9,12,24
10075,11215,10,10,34,54
10075,11216,16,17,35,68
10075,11217,6,9,26,41
10075,11218,6,10,8,24
10075,11219,5,15,14,34
10075,11220,9,17,17,43
10075,11221,17,25,22,64
10075,11222,7,12,31,50
10075,11223,5,6,14,25
10075,11224,2,4,6,12
10075,11225,5,21,19,45
10075,11226,8,35,23,66
10075,11228,3,8,10,21
10075,11229,13,11,8,32
10075,11230,15,22,13,50
10075,11231,5,9,28,42
10075,11232,2,9,6,17
10075,11233,7,23,15,45
10075,11234,5,20,22,47
10075,11235,8,8,9,25
10075,11236,11,28,13,52
10075,11237,8,27,24,59
10075,11238,6,7,32,45
10075,11239,1,4,3,8
10075,11354,10,19,16,45
10075,11355,26,33,28,87
10075,11356,4,12,6,22
10075,11357,10,10,27,47
10075,11358,3,6,11,20
10075,11359,1,0,0,1
10075,11360,3,5,5,13
10075,11361,1,4,7,12
10075,11362,3,3,7,13
10075,11363,0,4,1,5
10075,11364,4,8,10,22
10075,11365,5,11,10,26
10075,11366,2,2,5,9
10075,11367,4,10,12,26
10075,11368,22,60,36,118
10075,11369,11,21,13,45
10075,11370,6,16,16,38
10075,11372,21,47,54,122
10075,11373,38,66,56,160
10075,11374,13,22,43,78
10075,11375,22,31,56,109
10075,11377,33,48,60,141
10075,11378,10,22,25,57
10075,11379,6,13,40,59
10075,11385,24,44,72,140
10075,11411,1,2,4,7
10075,11412,1,7,4,12
10075,11413,2,5,4,11
10075,11414,3,0,10,13
10075,11415,3,6,10,19
10075,11416,2,7,13,22
10075,11417,5,6,17,28
10075,11418,1,9,11,21
10075,11419,2,8,8,18
10075,11420,1,9,15,25
10075,11421,9,10,18,37
10075,11422,3,5,2,10
10075,11423,3,7,9,19
10075,11426,1,3,5,9
10075,11427,5,6,4,15
10075,11428,2,5,6,13
10075,11429,0,5,3,8
10075,11432,13,21,14,48
10075,11433,2,14,5,21
10075,11434,3,8,8,19
10075,11435,10,12,15,37
10075,11436,1,5,4,10
10075,11691,3,5,12,20
10075,11692,1,2,3,6
10075,11693,0,1,6,7
10075,11694,1,3,5,9
10103,10001,4,1,36,41
10103,10002,6,12,41,59
10103,10003,7,2,64,73
10103,10004,1,0,9,10
10103,10005,0,0,30,30
10103,10006,0,0,8,8
10103,10007,0,0,23,23
10103,10009,7,12,60,79
10103,10010,4,1,46,51
10103,10011,2,3,93,98
10103,10012,1,0,31,32
10103,10013,2,1,47,50
10103,10014,4,2,74,80
10103,10016,5,2,93,100
10103,10017,3,3,33,39
10103,10018,3,0,9,12
10103,10019,12,12,112,136
10103,10021,2,4,63,69
10103,10022,1,3,64,68
10103,10023,7,3,116,126
10103,10024,2,0,98,100
10103,10025,8,10,86,104
10103,10026,4,4,21,29
10103,10027,4,7,36,47
10103,10028,4,5,70,79
10103,10029,10,17,30,57
10103,10030,1,2,10,13
10103,10031,14,12,20,46
10103,10032,9,14,33,56
10103,10033,9,9,23,41
10103,10034,5,7,14,26
10103,10035,4,6,6,16
10103,10036,10,7,51,68
10103,10037,2,2,13,17
10103,10038,1,4,32,37
10103,10039,3,0,8,11
10103,10040,3,4,24,31
10103,10044,1,0,10,11
10103,10065,1,0,59,60
10103,10069,2,2,9,13
10103,10075,5,3,55,63
10103,10119,0,0,2,2
10103,10128,2,4,84,90
10103,10280,0,1,20,21
10103,10282,0,1,3,4
10103,10301,3,1,15,19
10103,10302,1,1,2,4
10103,10303,2,4,6,12
10103,10304,5,3,8,16
10103,10305,0,0,9,9
10103,10306,0,2,23,25
10103,10307,1,0,2,3
10103,10308,0,1,7,8
10103,10309,0,0,7,7
10103,10310,2,0,5,7
10103,10312,1,2,19,22
10103,10314,2,0,24,26
10103,10451,4,7,12,23
10103,10452,5,10,14,29
10103,10453,14,13,11,38
10103,10454,4,6,4,14
10103,10455,6,5,2,13
10103,10456,9,21,11,41
10103,10457,8,12,6,26
10103,10458,7,14,18,39
10103,10459,5,7,7,19
10103,10460,4,7,13,24
10103,10461,2,4,26,32
10103,10462,6,12,33,51
10103,10463,3,7,34,44
10103,10464,0,0,2,2
10103,10465,3,4,12,19
10103,10466,4,12,16,32
10103,10467,9,16,14,39
10103,10468,6,8,19,33
10103,10469,5,7,9,21
10103,10470,1,2,5,8
10103,10471,1,1,12,14
10103,10472,3,6,13,22
10103,10473,5,8,12,25
10103,10474,0,1,0,1
10103,10475,1,3,9,13
10103,11001,0,0,1,1
10103,11004,1,0,3,4
10103,11040,0,0,2,2
10103,11101,4,3,32,39
10103,11102,2,5,27,34
10103,11103,5,1,41,47
10103,11104,5,1,26,32
10103,11105,6,3,39,48
10103,11106,6,4,22,32
10103,11109,0,0,21,21
10103,11201,0,3,88,91
10103,11203,5,9,14,28
10103,11204,0,5,8,13
10103,11205,3,4,17,24
10103,11206,13,13,32,58
10103,11207,13,15,16,44
10103,11208,4,16,7,27
10103,11209,2,7,45,54
10103,11210,3,3,14,20
10103,11211,7,19,73,99
10103,11212,11,12,9,32
10103,11213,3,9,11,23
10103,11214,3,4,22,29
10103,11215,6,5,60,71
10103,11216,9,6,19,34
10103,11217,3,4,42,49
10103,11218,7,9,32,48
10103,11219,5,2,7,14
10103,11220,4,10,20,34
10103,11221,8,11,38,57
10103,11222,4,4,26,34
10103,11223,2,6,11,19
10103,11224,0,4,2,6
10103,11225,12,8,24,44
10103,11226,2,8,28,38
10103,11228,0,1,8,9
10103,11229,4,4,13,21
10103,11230,4,7,25,36
10103,11231,5,1,26,32
10103,11232,7,4,7,18
10103,11233,4,6,24,34
10103,11234,5,3,26,34
10103,11235,0,4,9,13
10103,11236,7,3,9,19
10103,11237,5,9,23,37
10103,11238,3,2,40,45
10103,11239,0,1,1,2
10103,11354,3,5,10,18
10103,11355,2,5,16,23
10103,11356,2,1,7,10
10103,11357,1,3,22,26
10103,11358,2,1,22,25
10103,11360,1,0,8,9
10103,11361,0,1,11,12
10103,11362,0,1,6,7
10103,11363,0,0,1,1
10103,11364,0,3,7,10
10103,11365,1,2,10,13
10103,11366,0,1,4,5
10103,11367,5,2,10,17
10103,11368,6,21,24,51
10103,11369,5,6,13,24
10103,11370,4,3,11,18
10103,11372,3,14,26,43
10103,11373,6,6,21,33
10103,11374,4,4,25,33
10103,11375,2,3,63,68
10103,11377,8,10,34,52
10103,11378,2,7,19,28
10103,11379,4,3,24,31
10103,11385,10,17,44,71
10103,11411,2,4,2,8
10103,11412,2,1,5,8
10103,11413,1,1,5,7
10103,11414,0,0,8,8
10103,11415,1,1,22,24
10103,11416,3,3,5,11
10103,11417,2,1,3,6
10103,11418,2,1,10,13
10103,11419,3,3,7,13
10103,11420,2,3,10,15
10103,11421,5,7,10,22
10103,11422,1,1,7,9
10103,11423,2,3,5,10
10103,11426,0,0,9,9
10103,11427,0,1,8,9
10103,11428,1,0,4,5
10103,11429,2,4,4,10
10103,11432,4,1,10,15
10103,11433,2,2,5,9
10103,11434,2,4,9,15
10103,11435,4,3,19,26
10103,11436,0,2,5,7
10103,11691,3,1,9,13
10103,11692,0,0,4,4
10103,11693,1,0,2,3
10103,11694,0,2,12,14
10103,11697,0,0,1,1
10110,10001,6,4,36,46
10110,10002,6,7,50,63
10110,10003,6,8,94,108
10110,10004,2,0,7,9
10110,10005,1,0,12,13
10110,10006,0,0,8,8
10110,10007,0,0,16,16
10110,10009,8,7,66,81
10110,10010,5,4,68,77
10110,10011,3,4,98,105
10110,10012,1,3,41,45
10110,10013,2,0,41,43
10110,10014,5,3,66,74
10110,10016,3,2,107,112
10110,10017,1,2,45,48
10110,10018,2,0,16,18
10110,10019,7,6,60,73
10110,10021,2,2,74,78
10110,10022,3,2,68,73
10110,10023,5,2,96,103
10110,10024,5,4,85,94
10110,10025,11,6,112,129
10110,10026,3,8,36,47
10110,10027,7,8,40,55
10110,10028,3,6,81,90
10110,10029,5,9,44,58
10110,10030,5,1,18,24
10110,10031,5,12,33,50
10110,10032,9,9,28,46
10110,10033,5,11,27,43
10110,10034,2,10,27,39
10110,10035,4,5,8,17
10110,10036,9,3,70,82
10110,10037,3,4,13,20
10110,10038,1,1,28,30
10110,10039,2,1,22,25
10110,10040,3,8,16,27
10110,10044,0,1,8,9
10110,10065,3,2,50,55
10110,10069,0,0,16,16
10110,10075,3,2,34,39
10110,10119,1,0,0,1
10110,10128,5,2,96,103
10110,10162,1,0,3,4
10110,10280,0,1,12,13
10110,10282,0,0,12,12
10110,10301,1,1,16,18
10110,10302,0,1,4,5
10110,10303,1,2,8,11
10110,10304,0,3,8,11
10110,10305,0,3,24,27
10110,10306,0,2,22,24
10110,10307,0,0,8,8
10110,10308,0,0,6,6
10110,10309,4,0,7,11
10110,10310,0,0,5,5
10110,10312,2,0,28,30
10110,10314,2,3,33,38
10110,10451,3,12,12,27
10110,10452,11,13,12,36
10110,10453,8,9,18,35
10110,10454,6,4,10,20
10110,10455,1,5,6,12
10110,10456,14,12,15,41
10110,10457,4,8,10,22
10110,10458,11,13,18,42
10110,10459,4,10,10,24
10110,10460,3,2,16,21
10110,10461,4,5,16,25
10110,10462,6,11,40,57
10110,10463,3,12,40,55
10110,10464,0,0,2,2
10110,10465,4,3,16,23
10110,10466,4,4,14,22
10110,10467,4,11,21,36
10110,10468,7,9,20,36
10110,10469,3,8,17,28
10110,10470,1,1,10,12
10110,10471,1,4,15,20
10110,10472,3,7,12,22
10110,10473,5,6,17,28
10110,10474,0,1,3,4
10110,10475,1,7,13,21
10110,11004,1,1,6,8
10110,11101,3,3,48,54
10110,11102,6,4,43,53
10110,11103,5,5,41,51
10110,11104,2,6,34,42
10110,11105,8,7,39,54
10110,11106,3,3,51,57
10110,11109,0,1,13,14
10110,11201,8,7,106,121
10110,11203,3,6,12,21
10110,11204,4,7,27,38
10110,11205,4,6,31,41
10110,11206,9,6,37,52
10110,11207,7,9,23,39
10110,11208,7,9,17,33
10110,11209,4,9,48,61
10110,11210,8,10,21,39
10110,11211,7,6,100,113
10110,11212,3,8,12,23
10110,11213,3,4,22,29
10110,11214,1,8,26,35
10110,11215,5,6,79,90
10110,11216,4,12,31,47
10110,11217,1,4,57,62
10110,11218,4,7,43,54
10110,11219,4,6,14,24
10110,11220,4,9,27,40
10110,11221,7,16,38,61
10110,11222,4,3,51,58
10110,11223,7,3,26,36
10110,11224,0,6,8,14
10110,11225,4,9,40,53
10110,11226,9,14,52,75
10110,11228,2,0,22,24
10110,11229,6,10,26,42
10110,11230,8,9,36,53
10110,11231,4,3,34,41
10110,11232,2,2,15,19
10110,11233,7,9,21,37
10110,11234,5,11,36,52
10110,11235,0,3,15,18
10110,11236,1,7,21,29
10110,11237,8,4,28,40
10110,11238,4,4,74,82
10110,11239,0,0,1,1
10110,11354,8,8,14,30
10110,11355,8,5,26,39
10110,11356,3,3,5,11
10110,11357,0,1,22,23
10110,11358,2,2,11,15
10110,11360,1,0,15,16
10110,11361,0,2,10,12
10110,11362,0,1,6,7
10110,11363,0,0,6,6
10110,11364,2,0,13,15
10110,11365,4,0,12,16
10110,11366,0,6,10,16
10110,11367,8,1,26,35
10110,11368,5,12,20,37
10110,11369,1,4,19,24
10110,11370,0,2,11,13
10110,11372,2,9,40,51
10110,11373,8,15,51,74
10110,11374,4,6,51,61
10110,11375,7,8,90,105
10110,11377,12,6,64,82
10110,11378,0,2,21,23
10110,11379,0,2,23,25
10110,11385,14,11,46,71
10110,11411,2,2,10,14
10110,11412,2,0,4,6
10110,11413,0,3,10,13
10110,11414,3,1,13,17
10110,11415,2,0,10,12
10110,11416,3,3,16,22
10110,11417,5,6,14,25
10110,11418,2,8,13,23
10110,11419,3,7,21,31
10110,11420,3,3,16,22
10110,11421,3,2,13,18
10110,11422,1,3,9,13
10110,11423,0,0,10,10
10110,11426,2,2,4,8
10110,11427,2,3,6,11
10110,11428,1,3,11,15
10110,11429,3,1,6,10
10110,11432,4,6,30,40
10110,11433,0,3,5,8
10110,11434,2,4,9,15
10110,11435,2,5,24,31
10110,11436,1,1,1,3
10110,11691,0,6,12,18
10110,11692,0,1,4,5
10110,11693,5,1,1,7
10110,11694,0,1,8,9
10110,11697,1,0,1,2
10111,10001,1,3,35,39
10111,10002,3,3,31,37
10111,10003,6,2,53,61
10111,10004,0,0,7,7
10111,10005,0,0,20,20
10111,10006,0,0,7,7
10111,10007,0,0,8,8
10111,10009,4,7,31,42
10111,10010,1,1,29,31
10111,10011,2,4,64,70
10111,10012,1,1,22,24
10111,10013,2,1,26,29
10111,10014,1,2,38,41
10111,10016,1,5,73,79
10111,10017,1,1,18,20
10111,10018,1,1,12,14
10111,10019,8,5,101,114
10111,10021,1,0,39,40
10111,10022,0,2,41,43
10111,10023,2,2,61,65
10111,10024,6,2,60,68
10111,10025,8,4,47,59
10111,10026,4,2,15,21
10111,10027,1,5,25,31
10111,10028,1,3,41,45
10111,10029,2,11,23,36
10111,10030,3,2,5,10
10111,10031,1,12,19,32
10111,10032,3,6,23,32
10111,10033,5,6,11,22
10111,10034,2,5,9,16
10111,10035,4,2,5,11
10111,10036,7,2,29,38
10111,10037,1,0,8,9
10111,10038,1,0,20,21
10111,10039,3,7,2,12
10111,10040,3,4,13,20
10111,10044,2,0,10,12
10111,10065,2,0,43,45
10111,10069,0,0,7,7
10111,10075,0,1,29,30
10111,10128,5,3,63,71
10111,10162,0,0,2,2
10111,10280,1,1,19,21
10111,10282,0,0,5,5
10111,10301,1,0,13,14
10111,10302,0,2,2,4
10111,10303,1,0,0,1
10111,10304,0,1,4,5
10111,10305,0,2,6,8
10111,10306,0,1,8,9
10111,10307,0,0,2,2
10111,10308,0,0,6,6
10111,10309,0,0,4,4
10111,10310,0,0,6,6
10111,10312,0,1,9,10
10111,10314,2,2,12,16
10111,10451,0,3,6,9
10111,10452,2,12,7,21
10111,10453,2,7,8,17
10111,10454,0,10,4,14
10111,10455,2,2,3,7
10111,10456,3,12,10,25
10111,10457,2,8,9,19
10111,10458,7,5,11,23
10111,10459,1,5,7,13
10111,10460,1,2,5,8
10111,10461,2,5,17,24
10111,10462,1,7,17,25
10111,10463,3,2,21,26
10111,10465,1,5,8,14
10111,10466,4,2,7,13
10111,10467,3,13,22,38
10111,10468,0,6,9,15
10111,10469,1,3,8,12
10111,10470,0,0,4,4
10111,10471,1,1,7,9
10111,10472,2,3,13,18
10111,10473,1,8,9,18
10111,10474,0,1,4,5
10111,10475,2,1,8,11
10111,11001,1,0,0,1
10111,11004,0,0,3,3
10111,11040,0,0,3,3
10111,11101,3,0,28,31
10111,11102,2,4,20,26
10111,11103,6,5,27,38
10111,11104,3,6,28,37
10111,11105,2,8,24,34
10111,11106,2,4,19,25
10111,11109,0,0,6,6
10111,11201,2,7,49,58
10111,11203,4,2,9,15
10111,11204,0,2,13,15
10111,11205,0,4,15,19
10111,11206,4,11,21,36
10111,11207,2,4,3,9
10111,11208,4,4,10,18
10111,11209,1,2,25,28
10111,11210,3,2,5,10
10111,11211,4,6,58,68
10111,11212,4,6,7,17
10111,11213,2,5,13,20
10111,11214,0,1,18,19
10111,11215,6,2,39,47
10111,11216,2,4,19,25
10111,11217,4,3,36,43
10111,11218,4,2,18,24
10111,11219,1,3,3,7
10111,11220,2,11,18,31
10111,11221,2,8,24,34
10111,11222,2,3,21,26
10111,11223,1,4,11,16
10111,11224,0,1,2,3
10111,11225,1,3,19,23
10111,11226,4,8,22,34
10111,11228,0,3,10,13
10111,11229,1,2,12,15
10111,11230,3,4,23,30
10111,11231,2,1,25,28
10111,11232,2,2,8,12
10111,11233,2,6,10,18
10111,11234,0,3,16,19
10111,11235,0,1,10,11
10111,11236,1,6,6,13
10111,11237,1,10,15,26
10111,11238,1,0,30,31
10111,11354,1,1,14,16
10111,11355,2,1,9,12
10111,11356,1,0,4,5
10111,11357,3,1,18,22
10111,11358,0,0,8,8
10111,11360,0,1,1,2
10111,11361,0,0,2,2
10111,11362,0,0,2,2
10111,11363,0,0,1,1
10111,11364,0,1,6,7
10111,11365,0,5,10,15
10111,11366,0,0,4,4
10111,11367,0,0,3,3
10111,11368,2,9,11,22
10111,11369,1,5,10,16
10111,11370,0,2,5,7
10111,11372,2,10,15,27
10111,11373,7,12,31,50
10111,11374,2,3,25,30
10111,11375,0,7,47,54
10111,11377,3,8,37,48
10111,11378,4,0,11,15
10111,11379,1,3,16,20
10111,11385,4,6,25,35
10111,11411,0,1,4,5
10111,11412,0,2,3,5
10111,11413,1,1,4,6
10111,11414,0,1,1,2
10111,11415,1,2,8,11
10111,11416,0,2,2,4
10111,11417,1,1,5,7
10111,11418,3,1,7,11
10111,11419,0,3,7,10
10111,11420,0,3,11,14
10111,11421,2,3,12,17
10111,11422,1,1,5,7
10111,11423,0,2,3,5
10111,11426,0,1,8,9
10111,11427,1,1,3,5
10111,11428,2,2,4,8
10111,11429,0,3,5,8
10111,11432,0,2,12,14
10111,11433,1,0,1,2
10111,11434,1,1,5,7
10111,11435,3,0,10,13
10111,11436,1,0,0,1
10111,11691,2,1,5,8
10111,11692,0,1,1,2
10111,11693,0,1,2,3
10111,11694,0,1,6,7
10111,11697,0,0,3,3
10112,10001,5,3,44,52
10112,10002,9,2,58,69
10112,10003,22,7,128,157
10112,10004,1,2,19,22
10112,10005,2,0,44,46
10112,10006,1,0,9,10
10112,10007,1,0,20,21
10112,10009,15,12,105,132
10112,10010,9,1,70,80
10112,10011,9,5,147,161
10112,10012,6,3,49,58
10112,10013,8,1,69,78
10112,10014,7,5,102,114
10112,10016,8,8,160,176
10112,10017,7,2,40,49
10112,10018,3,3,20,26
10112,10019,27,14,158,199
10112,10021,4,8,100,112
10112,10022,8,4,85,97
10112,10023,15,5,141,161
10112,10024,15,3,125,143
10112,10025,28,7,136,171
10112,10026,8,4,23,35
10112,10027,16,11,30,57
10112,10028,14,3,99,116
10112,10029,10,12,39,61
10112,10030,7,5,14,26
10112,10031,8,5,36,49
10112,10032,10,9,22,41
10112,10033,9,12,23,44
10112,10034,10,5,19,34
10112,10035,2,3,13,18
10112,10036,19,4,72,95
10112,10037,3,1,8,12
10112,10038,5,1,55,61
10112,10039,9,7,9,25
10112,10040,9,4,28,41
10112,10044,0,2,12,14
10112,10065,4,4,71,79
10112,10069,0,0,16,16
10112,10075,5,1,86,92
10112,10128,5,1,129,135
10112,10162,0,0,6,6
10112,10280,3,3,20,26
10112,10282,0,2,12,14
10112,10301,4,2,9,15
10112,10302,0,1,2,3
10112,10303,0,0,6,6
10112,10304,4,1,14,19
10112,10305,4,2,15,21
10112,10306,1,0,26,27
10112,10307,2,0,6,8
10112,10308,0,1,9,10
10112,10309,0,1,13,14
10112,10310,0,0,7,7
10112,10312,1,1,23,25
10112,10314,5,5,32,42
10112,10451,6,6,8,20
10112,10452,6,11,13,30
10112,10453,6,11,7,24
10112,10454,6,4,3,13
10112,10455,3,1,7,11
10112,10456,9,11,10,30
10112,10457,6,6,9,21
10112,10458,11,5,16,32
10112,10459,4,6,8,18
10112,10460,8,9,6,23
10112,10461,4,7,20,31
10112,10462,6,10,30,46
10112,10463,4,10,30,44
10112,10464,0,0,1,1
10112,10465,2,2,13,17
10112,10466,2,5,15,22
10112,10467,9,13,24,46
10112,10468,5,5,14,24
10112,10469,3,3,16,22
10112,10470,1,0,8,9
10112,10471,5,1,13,19
10112,10472,10,3,10,23
10112,10473,7,6,8,21
10112,10474,0,2,1,3
10112,10475,4,0,11,15
10112,11001,0,0,5,5
10112,11004,2,1,3,6
10112,11101,5,4,50,59
10112,11102,6,3,70,79
10112,11103,13,1,47,61
10112,11104,9,8,34,51
10112,11105,10,4,52,66
10112,11106,10,7,39,56
10112,11109,1,0,23,24
10112,11201,7,7,115,129
10112,11203,5,6,14,25
10112,11204,1,0,18,19
10112,11205,4,4,30,38
10112,11206,9,8,36,53
10112,11207,8,6,14,28
10112,11208,6,6,18,30
10112,11209,10,4,51,65
10112,11210,4,3,20,27
10112,11211,11,10,101,122
10112,11212,8,8,10,26
10112,11213,10,10,21,41
10112,11214,4,0,28,32
10112,11215,16,6,97,119
10112,11216,7,9,38,54
10112,11217,7,3,51,61
10112,11218,14,9,32,55
10112,11219,3,4,13,20
10112,11220,4,1,19,24
10112,11221,12,12,30,54
10112,11222,7,3,45,55
10112,11223,5,2,14,21
10112,11224,1,0,8,9
10112,11225,5,8,31,44
10112,11226,9,7,37,53
10112,11228,1,3,19,23
10112,11229,5,5,20,30
10112,11230,8,4,45,57
10112,11231,6,2,53,61
10112,11232,1,3,6,10
10112,11233,9,5,16,30
10112,11234,7,8,29,44
10112,11235,2,1,19,22
10112,11236,9,5,15,29
10112,11237,4,7,23,34
10112,11238,7,7,60,74
10112,11239,1,0,4,5
10112,11354,3,1,12,16
10112,11355,5,6,18,29
10112,11356,2,2,6,10
10112,11357,1,0,22,23
10112,11358,2,1,17,20
10112,11360,3,0,11,14
10112,11361,0,0,12,12
10112,11362,0,0,2,2
10112,11363,1,0,2,3
10112,11364,0,0,9,9
10112,11365,6,3,11,20
10112,11366,1,0,5,6
10112,11367,2,5,10,17
10112,11368,14,6,28,48
10112,11369,5,3,7,15
10112,11370,1,4,14,19
10112,11372,12,8,33,53
10112,11373,13,14,37,64
10112,11374,7,2,30,39
10112,11375,6,4,92,102
10112,11377,11,7,60,78
10112,11378,4,2,20,26
10112,11379,0,4,22,26
10112,11385,15,9,56,80
10112,11411,1,4,6,11
10112,11412,4,4,3,11
10112,11413,3,4,2,9
10112,11414,0,3,11,14
10112,11415,1,3,17,21
10112,11416,1,5,6,12
10112,11417,1,1,6,8
10112,11418,4,2,3,9
10112,11419,2,1,9,12
10112,11420,1,1,9,11
10112,11421,3,2,15,20
10112,11422,4,1,2,7
10112,11423,0,1,8,9
10112,11426,0,0,1,1
10112,11427,2,0,6,8
10112,11428,1,2,1,4
10112,11429,1,4,3,8
10112,11432,7,3,10,20
10112,11433,1,2,5,8
10112,11434,4,2,11,17
10112,11435,5,3,18,26
10112,11436,1,0,0,1
10112,11691,6,2,8,16
10112,11692,2,1,0,3
10112,11693,0,0,5,5
10112,11694,1,0,8,9
10112,11697,0,0,2,2
10115,10001,1,1,4,6
10115,10002,2,0,4,6
10115,10003,2,1,8,11
10115,10004,0,1,0,1
10115,10005,0,0,1,1
10115,10009,0,3,8,11
10115,10010,0,1,3,4
10115,10011,0,1,12,13
10115,10012,0,1,2,3
10115,10013,0,0,3,3
10115,10014,2,0,2,4
10115,10016,1,1,2,4
10115,10017,1,0,6,7
10115,10018,0,0,1,1
10115,10019,0,1,5,6
10115,10021,0,0,3,3
10115,10022,0,1,2,3
10115,10023,3,3,10,16
10115,10024,2,1,19,22
10115,10025,20,17,93,130
10115,10026,1,7,17,25
10115,10027,13,7,44,64
10115,10028,0,2,3,5
10115,10029,3,4,4,11
10115,10030,1,2,6,9
10115,10031,2,4,25,31
10115,10032,1,3,15,19
10115,10033,4,4,8,16
10115,10034,1,3,6,10
10115,10035,0,2,5,7
10115,10036,1,1,6,8
10115,10037,0,1,5,6
10115,10038,0,0,4,4
10115,10039,0,0,1,1
10115,10040,0,5,14,19
10115,10044,0,0,1,1
10115,10065,0,1,4,5
10115,10075,0,0,2,2
10115,10128,3,1,9,13
10115,10280,0,0,1,1
10115,10302,0,0,1,1
10115,10303,0,0,2,2
10115,10305,1,0,1,2
10115,10306,0,0,4,4
10115,10308,0,0,1,1
10115,10310,0,0,1,1
10115,10312,1,0,1,2
10115,10314,0,1,2,3
10115,10451,1,6,3,10
10115,10452,1,10,9,20
10115,10453,0,3,4,7
10115,10454,0,0,3,3
10115,10455,0,4,0,4
10115,10456,2,4,5,11
10115,10457,6,4,5,15
10115,10458,4,1,5,10
10115,10459,0,2,2,4
10115,10460,5,5,1,11
10115,10461,1,2,5,8
10115,10462,0,5,14,19
10115,10463,3,6,15,24
10115,10465,1,3,5,9
10115,10466,1,0,6,7
10115,10467,0,1,5,6
10115,10468,2,4,7,13
10115,10469,0,4,18,22
10115,10471,4,3,7,14
10115,10472,3,2,4,9
10115,10473,1,5,11,17
10115,10474,1,0,0,1
10115,10475,0,2,6,8
10115,11101,0,1,3,4
10115,11102,0,0,4,4
10115,11103,1,2,4,7
10115,11104,2,1,6,9
10115,11105,3,2,4,9
10115,11106,0,0,5,5
10115,11201,1,2,16,19
10115,11203,0,0,2,2
10115,11204,1,0,1,2
10115,11205,5,1,6,12
10115,11206,2,6,5,13
10115,11207,1,8,5,14
10115,11208,1,0,2,3
10115,11209,1,1,4,6
10115,11210,0,1,3,4
10115,11211,1,5,5,11
10115,11212,1,2,3,6
10115,11213,1,5,5,11
10115,11214,0,0,4,4
10115,11215,2,2,13,17
10115,11216,3,1,10,14
10115,11217,4,1,6,11
10115,11218,2,0,4,6
10115,11219,0,2,4,6
10115,11220,7,2,5,14
10115,11221,2,1,11,14
10115,11222,0,0,1,1
10115,11223,2,0,2,4
10115,11224,0,1,1,2
10115,11225,0,1,6,7
10115,11226,5,3,7,15
10115,11228,1,0,2,3
10115,11229,0,0,3,3
10115,11230,2,0,2,4
10115,11231,2,0,2,4
10115,11232,1,0,2,3
10115,11233,0,1,4,5
10115,11234,0,0,2,2
10115,11235,0,0,2,2
10115,11236,0,3,3,6
10115,11237,1,1,1,3
10115,11238,0,7,9,16
10115,11354,1,1,0,2
10115,11355,1,1,2,4
10115,11356,0,0,2,2
10115,11357,1,0,5,6
10115,11358,0,1,0,1
10115,11360,0,2,1,3
10115,11364,0,0,1,1
10115,11365,0,1,3,4
10115,11366,0,2,0,2
10115,11367,0,0,4,4
10115,11368,2,1,3,6
10115,11369,3,0,1,4
10115,11370,1,2,0,3
10115,11372,2,2,8,12
10115,11373,0,2,5,7
10115,11374,0,1,3,4
10115,11375,1,2,3,6
10115,11377,0,4,10,14
10115,11378,2,0,4,6
10115,11379,0,1,1,2
10115,11385,1,5,6,12
10115,11411,0,0,1,1
10115,11412,1,1,0,2
10115,11413,2,1,0,3
10115,11415,0,0,2,2
10115,11416,1,0,4,5
10115,11418,0,0,3,3
10115,11419,0,1,3,4
10115,11420,0,0,5,5
10115,11421,1,0,1,2
10115,11422,0,1,1,2
10115,11423,0,0,1,1
10115,11426,1,0,0,1
10115,11427,0,0,1,1
10115,11428,0,1,1,2
10115,11429,0,0,1,1
10115,11432,0,0,7,7
10115,11433,1,0,0,1
10115,11434,0,2,1,3
10115,11435,1,0,2,3
10115,11436,0,1,2,3
10115,11691,0,3,0,3
10115,11692,0,1,0,1
10115,11694,0,1,0,1
10119,10001,19,19,58,96
10119,10002,35,21,51,107
10119,10003,36,8,79,123
10119,10004,1,1,7,9
10119,10005,0,0,11,11
10119,10006,0,0,3,3
10119,10007,2,0,11,13
10119,10009,31,23,75,129
10119,10010,20,8,44,72
10119,10011,38,7,104,149
10119,10012,7,5,35,47
10119,10013,14,6,27,47
10119,10014,30,7,53,90
10119,10016,21,13,86,120
10119,10017,8,5,29,42
10119,10018,13,8,14,35
10119,10019,43,11,67,121
10119,10021,7,2,54,63
10119,10022,16,6,43,65
10119,10023,35,7,109,151
10119,10024,35,10,94,139
10119,10025,39,33,104,176
10119,10026,28,30,30,88
10119,10027,32,26,50,108
10119,10028,9,6,57,72
10119,10029,36,43,38,117
10119,10030,18,9,25,52
10119,10031,48,31,57,136
10119,10032,41,28,30,99
10119,10033,35,23,39,97
10119,10034,24,29,38,91
10119,10035,13,12,15,40
10119,10036,44,18,45,107
10119,10037,11,4,12,27
10119,10038,6,2,25,33
10119,10039,12,9,12,33
10119,10040,19,16,46,81
10119,10044,2,2,13,17
10119,10065,10,1,43,54
10119,10069,4,1,11,16
10119,10075,5,6,27,38
10119,10119,0,0,1,1
10119,10128,26,9,68,103
10119,10162,0,0,3,3
10119,10280,2,1,16,19
10119,10282,2,0,3,5
10119,10301,5,11,32,48
10119,10302,1,4,8,13
10119,10303,2,4,13,19
10119,10304,2,7,14,23
10119,10305,5,6,20,31
10119,10306,3,9,27,39
10119,10307,1,3,7,11
10119,10308,6,5,21,32
10119,10309,4,1,22,27
10119,10310,3,6,16,25
10119,10312,9,9,37,55
10119,10314,8,11,41,60
10119,10451,17,26,13,56
10119,10452,20,31,28,79
10119,10453,19,36,22,77
10119,10454,5,23,7,35
10119,10455,12,17,12,41
10119,10456,32,45,32,109
10119,10457,19,40,16,75
10119,10458,17,29,24,70
10119,10459,7,31,12,50
10119,10460,8,24,7,39
10119,10461,14,11,18,43
10119,10462,9,27,29,65
10119,10463,16,23,45,84
10119,10464,1,2,6,9
10119,10465,5,10,16,31
10119,10466,8,12,24,44
10119,10467,19,23,31,73
10119,10468,18,22,26,66
10119,10469,12,10,20,42
10119,10470,1,2,4,7
10119,10471,4,7,21,32
10119,10472,18,28,15,61
10119,10473,8,13,25,46
10119,10474,3,5,5,13
10119,10475,8,19,19,46
10119,11001,0,0,1,1
10119,11004,2,8,8,18
10119,11005,0,0,1,1
10119,11040,0,1,3,4
10119,11101,17,24,40,81
10119,11102,23,14,41,78
10119,11103,29,13,48,90
10119,11104,13,10,38,61
10119,11105,15,7,46,68
10119,11106,20,10,54,84
10119,11109,1,2,18,21
10119,11201,22,17,89,128
10119,11203,23,30,41,94
10119,11204,8,8,28,44
10119,11205,20,12,40,72
10119,11206,32,26,54,112
10119,11207,28,34,27,89
10119,11208,21,25,34,80
10119,11209,14,24,60,98
10119,11210,6,22,28,56
10119,11211,37,23,84,144
10119,11212,27,30,31,88
10119,11213,16,19,33,68
10119,11214,13,21,32,66
10119,11215,26,21,99,146
10119,11216,20,20,52,92
10119,11217,18,12,56,86
10119,11218,20,26,43,89
10119,11219,9,6,13,28
10119,11220,14,19,34,67
10119,11221,32,41,52,125
10119,11222,12,12,65,89
10119,11223,8,19,35,62
10119,11224,15,9,14,38
10119,11225,14,19,38,71
10119,11226,33,42,66,141
10119,11228,10,5,29,44
10119,11229,8,11,39,58
10119,11230,9,23,30,62
10119,11231,12,10,47,69
10119,11232,2,4,15,21
10119,11233,28,34,29,91
10119,11234,9,42,48,99
10119,11235,5,13,39,57
10119,11236,17,35,32,84
10119,11237,12,11,40,63
10119,11238,20,12,63,95
10119,11239,1,6,3,10
10119,11354,5,0,29,34
10119,11355,12,15,25,52
10119,11356,4,5,12,21
10119,11357,5,2,22,29
10119,11358,6,5,20,31
10119,11360,1,2,16,19
10119,11361,0,1,20,21
10119,11362,3,1,13,17
10119,11363,0,1,2,3
10119,11364,4,2,11,17
10119,11365,5,7,22,34
10119,11366,0,1,2,3
10119,11367,5,3,10,18
10119,11368,15,19,29,63
10119,11369,10,9,23,42
10119,11370,6,6,19,31
10119,11372,16,16,40,72
10119,11373,11,31,45,87
10119,11374,8,11,38,57
10119,11375,12,9,74,95
10119,11377,16,19,70,105
10119,11378,4,8,19,31
10119,11379,10,8,35,53
10119,11385,20,27,91,138
10119,11411,2,7,12,21
10119,11412,3,13,19,35
10119,11413,11,7,16,34
10119,11414,6,7,19,32
10119,11415,8,5,28,41
10119,11416,2,5,12,19
10119,11417,6,7,10,23
10119,11418,11,8,18,37
10119,11419,4,16,25,45
10119,11420,6,12,21,39
10119,11421,2,12,18,32
10119,11422,6,13,10,29
10119,11423,1,8,12,21
10119,11426,3,4,17,24
10119,11427,3,3,15,21
10119,11428,4,8,5,17
10119,11429,7,8,6,21
10119,11432,10,16,27,53
10119,11433,5,9,6,20
10119,11434,4,18,15,37
10119,11435,3,18,21,42
10119,11436,4,5,5,14
10119,11691,10,13,8,31
10119,11692,6,2,2,10
10119,11693,4,4,6,14
10119,11694,1,5,10,16
10119,11697,1,3,2,6
10128,10001,20,14,22,56
10128,10002,51,42,67,160
10128,10003,16,15,58,89
10128,10004,6,8,12,26
10128,10005,7,3,3,13
10128,10006,2,3,2,7
10128,10007,1,0,5,6
10128,10009,40,28,62,130
10128,10010,12,15,37,64
10128,10011,27,27,37,91
10128,10012,11,13,24,48
10128,10013,14,11,17,42
10128,10014,13,8,25,46
10128,10016,11,25,53,89
10128,10017,5,8,20,33
10128,10018,2,6,10,18
10128,10019,20,20,40,80
10128,10021,51,29,90,170
10128,10022,23,19,44,86
10128,10023,40,27,78,145
10128,10024,40,37,104,181
10128,10025,67,60,179,306
10128,10026,30,22,55,107
10128,10027,36,51,68,155
10128,10028,73,65,187,325
10128,10029,109,190,153,452
10128,10030,20,41,25,86
10128,10031,36,54,41,131
10128,10032,50,61,61,172
10128,10033,46,44,62,152
10128,10034,19,25,59,103
10128,10035,30,51,43,124
10128,10036,14,12,25,51
10128,10037,10,12,13,35
10128,10038,10,13,9,32
10128,10039,19,15,15,49
10128,10040,21,32,55,108
10128,10044,2,5,14,21
10128,10065,21,22,57,100
10128,10069,3,1,7,11
10128,10075,31,28,64,123
10128,10128,229,195,528,952
10128,10162,2,0,2,4
10128,10173,0,0,1,1
10128,10280,3,1,8,12
10128,10282,0,3,1,4
10128,10301,4,7,16,27
10128,10302,2,3,7,12
10128,10303,4,8,14,26
10128,10304,6,5,13,24
10128,10305,8,9,16,33
10128,10306,6,6,13,25
10128,10307,1,0,4,5
10128,10308,7,4,7,18
10128,10309,1,3,13,17
10128,10310,2,5,6,13
10128,10312,8,8,31,47
10128,10314,6,14,39,59
10128,10451,24,41,36,101
10128,10452,34,76,46,156
10128,10453,47,64,43,154
10128,10454,26,27,26,79
10128,10455,21,30,23,74
10128,10456,45,80,71,196
10128,10457,37,59,32,128
10128,10458,37,45,59,141
10128,10459,19,54,28,101
10128,10460,35,43,36,114
10128,10461,29,23,84,136
10128,10462,57,57,89,203
10128,10463,28,48,100,176
10128,10464,2,5,7,14
10128,10465,13,29,60,102
10128,10466,15,18,36,69
10128,10467,27,69,74,170
10128,10468,34,47,56,137
10128,10469,21,37,44,102
10128,10470,4,8,15,27
10128,10471,9,9,32,50
10128,10472,51,63,59,173
10128,10473,19,34,35,88
10128,10474,8,9,17,34
10128,10475,21,17,26,64
10128,11001,4,0,1,5
10128,11004,3,5,4,12
10128,11040,0,0,2,2
10128,11101,23,19,45,87
10128,11102,26,26,50,102
10128,11103,38,41,62,141
10128,11104,32,36,40,108
10128,11105,23,44,55,122
10128,11106,30,38,60,128
10128,11109,0,3,2,5
10128,11201,22,19,58,99
10128,11203,20,31,53,104
10128,11204,17,12,22,51
10128,11205,24,25,37,86
10128,11206,31,44,55,130
10128,11207,31,46,38,115
10128,11208,17,26,33,76
10128,11209,16,18,32,66
10128,11210,11,7,21,39
10128,11211,38,49,65,152
10128,11212,17,34,32,83
10128,11213,36,33,44,113
10128,11214,13,16,35,64
10128,11215,33,34,64,131
10128,11216,14,25,39,78
10128,11217,14,22,68,104
10128,11218,5,11,24,40
10128,11219,10,15,31,56
10128,11220,28,21,28,77
10128,11221,29,42,44,115
10128,11222,6,34,55,95
10128,11223,9,19,20,48
10128,11224,7,11,11,29
10128,11225,16,42,37,95
10128,11226,24,41,54,119
10128,11228,6,14,16,36
10128,11229,12,15,21,48
10128,11230,20,20,40,80
10128,11231,15,19,25,59
10128,11232,4,10,8,22
10128,11233,20,35,26,81
10128,11234,8,20,26,54
10128,11235,19,16,19,54
10128,11236,15,26,31,72
10128,11237,7,28,26,61
10128,11238,28,26,69,123
10128,11239,3,5,5,13
10128,11354,30,38,28,96
10128,11355,43,58,34,135
10128,11356,9,10,22,41
10128,11357,20,19,38,77
10128,11358,12,25,23,60
10128,11359,0,1,1,2
10128,11360,4,10,18,32
10128,11361,14,13,14,41
10128,11362,6,4,5,15
10128,11363,1,1,4,6
10128,11364,11,7,14,32
10128,11365,8,22,15,45
10128,11366,1,4,8,13
10128,11367,11,9,15,35
10128,11368,41,63,46,150
10128,11369,18,24,40,82
10128,11370,12,14,21,47
10128,11371,0,1,0,1
10128,11372,42,53,60,155
10128,11373,77,110,81,268
10128,11374,17,14,50,81
10128,11375,35,37,72,144
10128,11377,73,119,110,302
10128,11378,17,25,41,83
10128,11379,14,19,57,90
10128,11385,58,81,110,249
10128,11411,0,4,2,6
10128,11412,6,11,13,30
10128,11413,7,13,9,29
10128,11414,4,5,13,22
10128,11415,5,3,12,20
10128,11416,4,6,13,23
10128,11417,4,12,16,32
10128,11418,14,17,20,51
10128,11419,12,27,28,67
10128,11420,10,18,20,48
10128,11421,6,9,24,39
10128,11422,6,12,18,36
10128,11423,5,10,16,31
10128,11426,3,6,2,11
10128,11427,8,1,8,17
10128,11428,3,7,9,19
10128,11429,3,5,9,17
10128,11432,16,16,35,67
10128,11433,9,13,13,35
10128,11434,7,18,20,45
10128,11435,9,22,26,57
10128,11436,0,7,8,15
10128,11691,8,14,19,41
10128,11692,3,2,2,7
10128,11693,0,2,4,6
10128,11694,0,4,7,11
10128,11697,0,0,4,4
10152,10001,0,0,14,14
10152,10002,1,2,22,25
10152,10003,3,1,44,48
10152,10004,0,0,1,1
10152,10005,0,0,14,14
10152,10006,0,0,3,3
10152,10007,1,1,11,13
10152,10009,5,4,22,31
10152,10010,2,0,33,35
10152,10011,0,3,34,37
10152,10012,2,1,15,18
10152,10013,0,0,16,16
10152,10014,0,0,29,29
10152,10016,1,2,64,67
10152,10017,0,0,22,22
10152,10018,0,1,5,6
10152,10019,3,2,40,45
10152,10021,0,2,45,47
10152,10022,1,1,50,52
10152,10023,0,0,37,37
10152,10024,2,1,30,33
10152,10025,1,5,25,31
10152,10026,0,1,8,9
10152,10027,1,1,7,9
10152,10028,2,1,39,42
10152,10029,2,0,13,15
10152,10030,0,0,3,3
10152,10031,0,2,7,9
10152,10032,0,4,6,10
10152,10033,3,3,9,15
10152,10034,2,0,9,11
10152,10035,0,2,10,12
10152,10036,4,0,31,35
10152,10037,0,1,4,5
10152,10038,0,0,19,19
10152,10039,0,0,1,1
10152,10040,4,1,8,13
10152,10044,0,0,6,6
10152,10065,0,0,30,30
10152,10069,0,0,3,3
10152,10075,0,1,22,23
10152,10128,2,4,41,47
10152,10162,0,0,2,2
10152,10280,0,0,10,10
10152,10282,0,0,6,6
10152,10301,0,0,3,3
10152,10302,0,0,3,3
10152,10303,0,0,1,1
10152,10304,0,0,3,3
10152,10305,0,0,3,3
10152,10306,0,1,4,5
10152,10307,0,0,3,3
10152,10308,0,0,2,2
10152,10309,1,0,1,2
10152,10310,0,0,2,2
10152,10312,0,1,9,10
10152,10314,0,1,10,11
10152,10451,1,1,1,3
10152,10452,0,2,2,4
10152,10453,3,4,2,9
10152,10454,1,0,1,2
10152,10455,0,2,1,3
10152,10456,1,4,4,9
10152,10457,1,1,4,6
10152,10458,0,1,4,5
10152,10459,2,1,3,6
10152,10460,0,2,1,3
10152,10461,1,1,9,11
10152,10462,0,3,14,17
10152,10463,1,0,12,13
10152,10465,0,0,9,9
10152,10466,1,1,3,5
10152,10467,1,2,4,7
10152,10468,1,3,4,8
10152,10469,0,0,6,6
10152,10470,0,0,1,1
10152,10471,0,0,1,1
10152,10472,1,0,5,6
10152,10473,0,1,5,6
10152,10474,0,0,1,1
10152,10475,0,1,2,3
10152,11001,0,0,1,1
10152,11004,0,0,3,3
10152,11040,0,0,1,1
10152,11101,0,4,28,32
10152,11102,0,0,16,16
10152,11103,1,4,10,15
10152,11104,0,0,11,11
10152,11105,0,0,9,9
10152,11106,1,0,16,17
10152,11109,0,0,11,11
10152,11201,0,4,26,30
10152,11203,0,2,2,4
10152,11204,0,1,5,6
10152,11205,1,0,10,11
10152,11206,0,1,8,9
10152,11207,0,5,6,11
10152,11208,1,1,3,5
10152,11209,3,1,11,15
10152,11210,0,1,5,6
10152,11211,2,2,31,35
10152,11212,2,2,4,8
10152,11213,1,0,9,10
10152,11214,1,0,9,10
10152,11215,0,0,21,21
10152,11216,0,2,10,12
10152,11217,0,0,18,18
10152,11218,0,2,12,14
10152,11219,0,0,5,5
10152,11220,0,3,9,12
10152,11221,0,1,9,10
10152,11222,1,0,16,17
10152,11223,0,0,2,2
10152,11224,0,0,1,1
10152,11225,0,1,5,6
10152,11226,2,5,10,17
10152,11228,1,3,6,10
10152,11229,0,2,8,10
10152,11230,0,0,8,8
10152,11231,0,0,5,5
10152,11232,0,0,2,2
10152,11233,0,3,4,7
10152,11234,1,1,8,10
10152,11235,0,2,5,7
10152,11236,0,5,4,9
10152,11237,2,0,10,12
10152,11238,0,0,17,17
10152,11239,0,1,0,1
10152,11354,0,0,9,9
10152,11355,2,0,13,15
10152,11356,0,1,5,6
10152,11357,0,0,9,9
10152,11358,0,0,4,4
10152,11360,0,0,5,5
10152,11361,0,1,3,4
10152,11362,0,0,4,4
10152,11363,0,0,1,1
10152,11364,0,1,7,8
10152,11365,1,0,8,9
10152,11366,0,1,3,4
10152,11367,1,0,4,5
10152,11368,1,2,7,10
10152,11369,0,1,1,2
10152,11370,0,0,1,1
10152,11372,0,0,18,18
10152,11373,0,0,10,10
10152,11374,1,1,15,17
10152,11375,0,2,21,23
10152,11377,0,2,14,16
10152,11378,2,1,7,10
10152,11379,2,0,5,7
10152,11385,3,3,4,10
10152,11411,1,0,1,2
10152,11412,0,1,2,3
10152,11413,0,1,1,2
10152,11414,0,1,5,6
10152,11415,0,0,4,4
10152,11416,0,0,2,2
10152,11417,0,3,3,6
10152,11418,0,0,7,7
10152,11419,2,1,1,4
10152,11420,2,0,2,4
10152,11421,0,3,5,8
10152,11422,0,0,1,1
10152,11423,0,1,3,4
10152,11427,1,1,3,5
10152,11428,0,0,1,1
10152,11429,0,1,3,4
10152,11432,0,2,2,4
10152,11433,0,2,2,4
10152,11434,0,1,1,2
10152,11435,2,1,7,10
10152,11436,0,2,1,3
10152,11691,0,2,1,3
10152,11692,0,1,1,2
10152,11693,0,0,1,1
10152,11694,0,1,1,2
10153,10001,0,3,31,34
10153,10002,1,8,44,53
10153,10003,1,6,90,97
10153,10004,1,0,7,8
10153,10005,0,0,18,18
10153,10006,0,1,4,5
10153,10007,1,1,19,21
10153,10009,1,3,52,56
10153,10010,0,3,61,64
10153,10011,3,5,112,120
10153,10012,0,1,31,32
10153,10013,0,0,32,32
10153,10014,3,4,81,88
10153,10016,3,2,101,106
10153,10017,0,1,35,36
10153,10018,1,0,9,10
10153,10019,3,8,80,91
10153,10021,0,1,91,92
10153,10022,1,2,58,61
10153,10023,0,4,92,96
10153,10024,1,3,64,68
10153,10025,3,3,73,79
10153,10026,1,2,22,25
10153,10027,0,6,20,26
10153,10028,2,4,67,73
10153,10029,5,9,28,42
10153,10030,0,8,10,18
10153,10031,1,9,25,35
10153,10032,2,10,11,23
10153,10033,1,6,12,19
10153,10034,0,1,9,10
10153,10035,0,4,13,17
10153,10036,1,1,39,41
10153,10037,0,2,7,9
10153,10038,0,1,22,23
10153,10039,0,2,8,10
10153,10040,0,7,15,22
10153,10044,1,1,5,7
10153,10065,1,1,59,61
10153,10069,0,1,8,9
10153,10075,2,2,37,41
10153,10128,0,4,77,81
10153,10162,0,0,3,3
10153,10280,0,2,12,14
10153,10282,0,0,6,6
10153,10301,0,2,7,9
10153,10302,0,1,1,2
10153,10303,0,0,2,2
10153,10304,0,2,6,8
10153,10305,0,1,3,4
10153,10306,0,2,7,9
10153,10307,0,0,3,3
10153,10308,0,0,2,2
10153,10309,2,1,2,5
10153,10310,0,1,3,4
10153,10312,0,2,10,12
10153,10314,0,3,19,22
10153,10451,0,3,10,13
10153,10452,0,1,12,13
10153,10453,0,8,7,15
10153,10454,1,2,5,8
10153,10455,0,2,3,5
10153,10456,1,5,3,9
10153,10457,1,3,16,20
10153,10458,0,6,9,15
10153,10459,1,4,6,11
10153,10460,1,3,4,8
10153,10461,0,3,16,19
10153,10462,0,6,19,25
10153,10463,1,3,22,26
10153,10465,0,2,10,12
10153,10466,2,6,9,17
10153,10467,1,9,15,25
10153,10468,1,4,5,10
10153,10469,0,6,11,17
10153,10470,1,2,1,4
10153,10471,0,2,13,15
10153,10472,1,4,4,9
10153,10473,0,1,8,9
10153,10474,0,2,2,4
10153,10475,0,1,13,14
10153,11001,0,1,3,4
10153,11004,0,0,3,3
10153,11040,0,0,2,2
10153,11101,1,3,40,44
10153,11102,2,6,42,50
10153,11103,1,2,36,39
10153,11104,0,4,20,24
10153,11105,2,11,30,43
10153,11106,0,6,32,38
10153,11109,0,1,10,11
10153,11201,1,3,58,62
10153,11203,0,6,8,14
10153,11204,1,0,11,12
10153,11205,1,3,17,21
10153,11206,1,5,16,22
10153,11207,0,5,15,20
10153,11208,0,9,8,17
10153,11209,0,4,28,32
10153,11210,1,0,18,19
10153,11211,0,8,72,80
10153,11212,2,6,9,17
10153,11213,1,8,18,27
10153,11214,0,1,15,16
10153,11215,0,1,56,57
10153,11216,0,3,23,26
10153,11217,1,1,31,33
10153,11218,1,2,20,23
10153,11219,0,1,11,12
10153,11220,1,1,9,11
10153,11221,0,8,24,32
10153,11222,1,2,33,36
10153,11223,1,2,8,11
10153,11224,1,1,3,5
10153,11225,0,4,28,32
10153,11226,2,13,25,40
10153,11228,0,0,14,14
10153,11229,2,0,7,9
10153,11230,0,6,22,28
10153,11231,1,2,36,39
10153,11232,1,2,5,8
10153,11233,0,5,14,19
10153,11234,1,0,20,21
10153,11235,0,3,9,12
10153,11236,0,10,20,30
10153,11237,1,1,16,18
10153,11238,0,4,34,38
10153,11239,1,1,2,4
10153,11354,0,1,11,12
10153,11355,0,7,18,25
10153,11356,4,1,2,7
10153,11357,0,1,9,10
10153,11358,0,1,11,12
10153,11360,0,0,4,4
10153,11361,1,1,10,12
10153,11362,0,0,8,8
10153,11363,0,0,1,1
10153,11364,0,1,11,12
10153,11365,0,0,7,7
10153,11366,0,0,4,4
10153,11367,0,3,8,11
10153,11368,0,9,19,28
10153,11369,1,0,3,4
10153,11370,0,3,6,9
10153,11372,0,4,24,28
10153,11373,4,6,17,27
10153,11374,0,2,26,28
10153,11375,0,1,73,74
10153,11377,3,7,33,43
10153,11378,1,1,17,19
10153,11379,0,4,17,21
10153,11385,0,9,28,37
10153,11411,0,0,5,5
10153,11412,0,0,2,2
10153,11413,0,7,2,9
10153,11414,0,1,3,4
10153,11415,0,2,12,14
10153,11416,0,1,3,4
10153,11417,0,2,6,8
10153,11418,0,2,11,13
10153,11419,0,3,3,6
10153,11420,0,4,11,15
10153,11421,0,3,7,10
10153,11422,0,0,3,3
10153,11423,0,1,8,9
10153,11426,0,0,3,3
10153,11427,0,3,6,9
10153,11428,0,0,2,2
10153,11429,0,1,3,4
10153,11432,1,2,16,19
10153,11433,0,1,2,3
10153,11434,0,2,7,9
10153,11435,2,3,15,20
10153,11436,0,0,3,3
10153,11691,1,4,3,8
10153,11692,0,1,2,3
10153,11693,1,0,3,4
10153,11694,0,0,1,1
10153,11697,0,0,1,1
10154,10001,0,1,36,37
10154,10002,2,5,53,60
10154,10003,1,1,111,113
10154,10004,0,0,7,7
10154,10005,0,1,24,25
10154,10006,0,0,8,8
10154,10007,0,0,15,15
10154,10009,2,2,67,71
10154,10010,1,0,62,63
10154,10011,1,4,104,109
10154,10012,0,0,41,41
10154,10013,0,0,48,48
10154,10014,2,1,74,77
10154,10016,4,1,143,148
10154,10017,0,1,61,62
10154,10018,0,0,18,18
10154,10019,1,1,101,103
10154,10021,1,0,87,88
10154,10022,4,0,125,129
10154,10023,0,1,92,93
10154,10024,0,1,85,86
10154,10025,2,1,48,51
10154,10026,0,1,26,27
10154,10027,1,1,13,15
10154,10028,0,0,101,101
10154,10029,0,1,35,36
10154,10030,0,2,10,12
10154,10031,1,2,15,18
10154,10032,2,1,24,27
10154,10033,0,2,16,18
10154,10034,1,0,9,10
10154,10035,1,1,10,12
10154,10036,0,0,49,49
10154,10037,0,0,7,7
10154,10038,1,0,28,29
10154,10039,0,1,6,7
10154,10040,0,0,10,10
10154,10044,0,0,11,11
10154,10065,0,1,80,81
10154,10069,0,0,13,13
10154,10075,2,0,54,56
10154,10119,0,0,1,1
10154,10128,3,3,132,138
10154,10162,0,0,2,2
10154,10280,0,0,26,26
10154,10282,0,0,9,9
10154,10301,1,0,9,10
10154,10302,0,0,5,5
10154,10303,1,0,3,4
10154,10304,2,0,4,6
10154,10305,0,0,14,14
10154,10306,0,1,11,12
10154,10307,0,0,3,3
10154,10308,0,0,10,10
10154,10309,0,0,6,6
10154,10310,0,0,4,4
10154,10312,0,1,19,20
10154,10314,2,2,20,24
10154,10451,2,2,7,11
10154,10452,0,1,6,7
10154,10453,1,3,4,8
10154,10454,0,3,4,7
10154,10455,0,1,3,4
10154,10456,0,6,12,18
10154,10457,2,1,6,9
10154,10458,0,1,12,13
10154,10459,0,5,6,11
10154,10460,0,2,5,7
10154,10461,0,0,12,12
10154,10462,1,2,21,24
10154,10463,1,2,28,31
10154,10465,1,0,16,17
10154,10466,0,1,9,10
10154,10467,0,3,23,26
10154,10468,0,3,10,13
10154,10469,1,0,16,17
10154,10470,0,0,6,6
10154,10471,0,1,5,6
10154,10472,2,0,12,14
10154,10473,0,2,14,16
10154,10474,1,1,1,3
10154,10475,0,0,7,7
10154,11001,1,0,2,3
10154,11004,0,0,5,5
10154,11005,0,0,1,1
10154,11101,0,2,43,45
10154,11102,4,4,27,35
10154,11103,1,1,27,29
10154,11104,1,2,14,17
10154,11105,1,3,31,35
10154,11106,3,2,30,35
10154,11109,0,1,27,28
10154,11201,0,0,82,82
10154,11203,0,2,15,17
10154,11204,0,2,12,14
10154,11205,0,3,11,14
10154,11206,0,1,31,32
10154,11207,3,2,11,16
10154,11208,0,0,11,11
10154,11209,0,2,24,26
10154,11210,0,3,12,15
10154,11211,0,1,76,77
10154,11212,0,1,10,11
10154,11213,0,1,13,14
10154,11214,1,0,13,14
10154,11215,1,1,45,47
10154,11216,0,1,24,25
10154,11217,0,0,33,33
10154,11218,1,2,26,29
10154,11219,1,2,7,10
10154,11220,0,2,22,24
10154,11221,2,5,28,35
10154,11222,0,0,47,47
10154,11223,1,1,14,16
10154,11224,0,0,6,6
10154,11225,1,3,19,23
10154,11226,2,4,23,29
10154,11228,0,0,20,20
10154,11229,0,0,14,14
10154,11230,2,2,26,30
10154,11231,0,2,22,24
10154,11232,0,0,8,8
10154,11233,0,0,9,9
10154,11234,2,1,15,18
10154,11235,1,1,12,14
10154,11236,0,0,17,17
10154,11237,0,2,14,16
10154,11238,2,2,37,41
10154,11239,0,0,1,1
10154,11354,0,0,19,19
10154,11355,2,3,27,32
10154,11356,0,0,4,4
10154,11357,0,1,12,13
10154,11358,0,0,8,8
10154,11360,0,0,9,9
10154,11361,0,0,14,14
10154,11362,0,0,12,12
10154,11363,0,0,1,1
10154,11364,0,2,15,17
10154,11365,0,1,14,15
10154,11366,0,1,3,4
10154,11367,0,1,12,13
10154,11368,1,3,13,17
10154,11369,0,1,8,9
10154,11370,1,0,8,9
10154,11372,0,1,31,32
10154,11373,2,2,37,41
10154,11374,0,1,21,22
10154,11375,1,0,69,70
10154,11377,4,4,37,45
10154,11378,1,2,16,19
10154,11379,1,1,18,20
10154,11385,1,2,39,42
10154,11412,0,0,3,3
10154,11413,0,0,6,6
10154,11414,0,0,5,5
10154,11415,0,0,7,7
10154,11416,0,1,4,5
10154,11417,1,0,11,12
10154,11418,1,1,14,16
10154,11419,1,3,10,14
10154,11420,0,0,13,13
10154,11421,2,0,12,14
10154,11422,0,0,9,9
10154,11423,0,0,6,6
10154,11426,1,0,4,5
10154,11427,1,1,6,8
10154,11428,0,0,6,6
10154,11429,0,0,8,8
10154,11432,0,1,14,15
10154,11433,0,1,2,3
10154,11434,1,3,3,7
10154,11435,2,3,14,19
10154,11436,0,0,1,1
10154,11691,1,1,2,4
10154,11692,0,0,2,2
10154,11694,0,1,3,4
10154,11697,0,0,3,3
10162,10002,0,0,1,1
10162,10009,1,0,0,1
10162,10016,0,0,2,2
10162,10017,0,0,1,1
10162,10019,0,0,1,1
10162,10021,0,0,6,6
10162,10022,0,0,1,1
10162,10023,0,0,2,2
10162,10024,0,0,3,3
10162,10025,0,0,6,6
10162,10026,0,1,1,2
10162,10028,1,0,4,5
10162,10029,1,0,0,1
10162,10030,1,0,0,1
10162,10031,0,0,1,1
10162,10032,1,0,0,1
10162,10033,0,1,3,4
10162,10034,0,1,0,1
10162,10036,1,0,0,1
10162,10037,0,0,2,2
10162,10038,0,0,1,1
10162,10040,0,1,2,3
10162,10065,0,1,1,2
10162,10075,1,0,12,13
10162,10128,0,0,4,4
10162,10162,0,0,1,1
10162,10312,0,0,1,1
10162,10451,0,0,1,1
10162,10452,0,2,1,3
10162,10455,0,0,2,2
10162,10456,1,0,1,2
10162,10457,0,0,2,2
10162,10458,1,0,1,2
10162,10459,1,0,1,2
10162,10460,0,1,2,3
10162,10461,0,0,3,3
10162,10462,1,0,1,2
10162,10463,0,1,2,3
10162,10466,0,1,1,2
10162,10467,0,0,4,4
10162,10468,0,0,1,1
10162,10469,0,0,1,1
10162,10472,0,0,1,1
10162,10474,0,1,0,1
10162,10475,0,0,2,2
10162,11004,0,0,1,1
10162,11102,0,0,1,1
10162,11103,1,0,0,1
10162,11104,0,0,4,4
10162,11105,1,0,1,2
10162,11106,0,0,2,2
10162,11201,0,0,2,2
10162,11203,1,0,0,1
10162,11205,0,0,1,1
10162,11207,0,1,3,4
10162,11209,1,0,0,1
10162,11210,0,0,1,1
10162,11212,0,0,1,1
10162,11214,0,0,1,1
10162,11215,0,1,1,2
10162,11216,0,1,0,1
10162,11219,0,0,2,2
10162,11222,0,0,3,3
10162,11223,0,2,0,2
10162,11225,0,0,1,1
10162,11226,0,5,3,8
10162,11231,0,0,1,1
10162,11232,0,1,0,1
10162,11233,0,2,0,2
10162,11234,1,2,0,3
10162,11235,0,0,1,1
10162,11236,0,0,1,1
10162,11237,0,0,1,1
10162,11238,0,3,0,3
10162,11354,0,1,0,1
10162,11355,0,1,0,1
10162,11368,0,1,1,2
10162,11370,0,0,1,1
10162,11372,0,1,2,3
10162,11373,0,3,2,5
10162,11375,0,0,1,1
10162,11377,1,0,2,3
10162,11379,0,0,2,2
10162,11385,0,0,4,4
10162,11413,0,0,1,1
10162,11415,0,0,1,1
10162,11418,0,1,1,2
10162,11419,0,0,1,1
10162,11420,0,0,1,1
10162,11432,0,0,2,2
10162,11433,0,0,1,1
10162,11434,0,0,1,1
10162,11435,0,0,1,1
10162,11436,1,0,1,2
10165,10001,5,2,26,33
10165,10002,5,5,43,53
10165,10003,1,2,42,45
10165,10004,0,0,4,4
10165,10005,0,0,13,13
10165,10006,0,0,3,3
10165,10007,0,0,8,8
10165,10009,2,5,67,74
10165,10010,0,4,49,53
10165,10011,5,2,48,55
10165,10012,2,2,25,29
10165,10013,4,2,27,33
10165,10014,1,0,24,25
10165,10016,7,8,112,127
10165,10017,0,5,36,41
10165,10018,2,0,7,9
10165,10019,2,2,64,68
10165,10021,3,2,46,51
10165,10022,4,2,35,41
10165,10023,2,2,59,63
10165,10024,2,2,57,61
10165,10025,2,9,50,61
10165,10026,5,4,18,27
10165,10027,8,10,24,42
10165,10028,5,7,54,66
10165,10029,10,18,31,59
10165,10030,0,10,5,15
10165,10031,7,7,20,34
10165,10032,10,8,21,39
10165,10033,2,6,16,24
10165,10034,5,6,16,27
10165,10035,2,7,7,16
10165,10036,4,5,29,38
10165,10037,0,3,4,7
10165,10038,2,0,20,22
10165,10039,3,3,9,15
10165,10040,2,7,14,23
10165,10044,2,2,12,16
10165,10065,1,1,37,39
10165,10069,0,0,5,5
10165,10075,1,1,31,33
10165,10128,3,4,76,83
10165,10280,0,0,12,12
10165,10301,4,5,12,21
10165,10302,1,0,3,4
10165,10303,0,1,5,6
10165,10304,1,2,10,13
10165,10305,2,3,21,26
10165,10306,3,2,14,19
10165,10307,0,0,1,1
10165,10308,1,1,5,7
10165,10309,2,1,11,14
10165,10310,1,1,6,8
10165,10312,2,4,16,22
10165,10314,4,1,23,28
10165,10451,4,9,11,24
10165,10452,6,13,9,28
10165,10453,4,10,6,20
10165,10454,3,5,7,15
10165,10455,4,6,4,14
10165,10456,5,12,9,26
10165,10457,10,5,10,25
10165,10458,3,10,8,21
10165,10459,1,10,2,13
10165,10460,3,4,5,12
10165,10461,4,4,6,14
10165,10462,3,6,21,30
10165,10463,6,6,11,23
10165,10465,3,1,15,19
10165,10466,3,6,8,17
10165,10467,5,8,14,27
10165,10468,6,10,8,24
10165,10469,6,7,10,23
10165,10470,0,0,3,3
10165,10471,3,0,3,6
10165,10472,1,15,17,33
10165,10473,3,10,8,21
10165,10474,1,3,2,6
10165,10475,2,5,11,18
10165,11004,0,0,2,2
10165,11040,0,0,2,2
10165,11101,1,7,41,49
10165,11102,1,4,35,40
10165,11103,2,3,30,35
10165,11104,3,5,17,25
10165,11105,6,2,24,32
10165,11106,4,6,33,43
10165,11109,0,1,11,12
10165,11201,2,9,52,63
10165,11203,4,7,9,20
10165,11204,3,3,12,18
10165,11205,4,1,22,27
10165,11206,4,10,27,41
10165,11207,8,18,11,37
10165,11208,6,6,11,23
10165,11209,1,6,31,38
10165,11210,4,11,11,26
10165,11211,4,3,69,76
10165,11212,4,12,8,24
10165,11213,2,8,10,20
10165,11214,1,8,24,33
10165,11215,3,3,53,59
10165,11216,6,4,18,28
10165,11217,2,3,23,28
10165,11218,4,3,25,32
10165,11219,2,4,9,15
10165,11220,3,1,19,23
10165,11221,6,16,16,38
10165,11222,0,2,28,30
10165,11223,2,1,23,26
10165,11224,1,5,3,9
10165,11225,1,5,18,24
10165,11226,14,15,27,56
10165,11228,0,2,11,13
10165,11229,1,3,31,35
10165,11230,4,9,26,39
10165,11231,2,4,17,23
10165,11232,0,0,4,4
10165,11233,4,14,8,26
10165,11234,1,7,19,27
10165,11235,2,3,15,20
10165,11236,5,6,10,21
10165,11237,4,10,10,24
10165,11238,2,5,27,34
10165,11239,0,1,2,3
10165,11354,2,5,19,26
10165,11355,1,8,22,31
10165,11356,0,1,10,11
10165,11357,3,1,17,21
10165,11358,1,2,18,21
10165,11359,1,0,0,1
10165,11360,1,1,8,10
10165,11361,1,0,5,6
10165,11362,0,0,4,4
10165,11363,1,0,0,1
10165,11364,1,3,8,12
10165,11365,2,1,13,16
10165,11366,0,1,12,13
10165,11367,1,0,14,15
10165,11368,1,8,16,25
10165,11369,1,3,8,12
10165,11370,1,3,7,11
10165,11372,0,5,21,26
10165,11373,4,10,33,47
10165,11374,2,3,31,36
10165,11375,3,2,58,63
10165,11377,7,8,42,57
10165,11378,5,4,12,21
10165,11379,4,2,21,27
10165,11385,3,8,35,46
10165,11411,2,0,3,5
10165,11412,1,4,2,7
10165,11413,3,2,3,8
10165,11414,1,1,14,16
10165,11415,1,1,8,10
10165,11416,1,5,10,16
10165,11417,1,2,6,9
10165,11418,1,2,10,13
10165,11419,1,4,10,15
10165,11420,2,4,11,17
10165,11421,1,3,13,17
10165,11422,0,0,4,4
10165,11423,0,4,2,6
10165,11426,1,1,3,5
10165,11427,1,1,6,8
10165,11428,0,2,1,3
10165,11429,0,1,4,5
10165,11430,1,0,0,1
10165,11432,1,5,15,21
10165,11433,1,2,0,3
10165,11434,0,6,10,16
10165,11435,3,3,10,16
10165,11436,2,4,2,8
10165,11691,1,3,4,8
10165,11692,2,0,0,2
10165,11693,0,0,3,3
10165,11694,0,2,7,9
10165,11697,0,0,1,1
10167,10001,1,3,37,41
10167,10002,2,7,61,70
10167,10003,1,3,138,142
10167,10004,1,0,15,16
10167,10005,2,1,29,32
10167,10006,0,0,10,10
10167,10007,0,0,25,25
10167,10009,2,4,87,93
10167,10010,1,1,89,91
10167,10011,4,7,133,144
10167,10012,1,0,48,49
10167,10013,1,0,55,56
10167,10014,3,0,71,74
10167,10016,5,7,176,188
10167,10017,2,3,151,156
10167,10018,0,0,13,13
10167,10019,5,5,93,103
10167,10021,1,4,91,96
10167,10022,4,1,75,80
10167,10023,1,2,121,124
10167,10024,0,2,84,86
10167,10025,4,6,89,99
10167,10026,6,2,21,29
10167,10027,5,7,22,34
10167,10028,0,1,97,98
10167,10029,2,8,53,63
10167,10030,1,3,6,10
10167,10031,4,4,22,30
10167,10032,2,2,19,23
10167,10033,3,7,23,33
10167,10034,1,4,11,16
10167,10035,2,5,9,16
10167,10036,0,3,59,62
10167,10037,2,7,2,11
10167,10038,3,3,49,55
10167,10039,0,4,8,12
10167,10040,3,2,20,25
10167,10044,1,2,15,18
10167,10065,1,5,66,72
10167,10069,1,0,9,10
10167,10075,1,0,46,47
10167,10119,0,0,1,1
10167,10128,4,5,118,127
10167,10162,0,0,6,6
10167,10280,0,1,31,32
10167,10282,0,1,11,12
10167,10301,2,2,4,8
10167,10302,1,0,5,6
10167,10303,1,1,4,6
10167,10304,1,1,16,18
10167,10305,0,0,11,11
10167,10306,2,2,28,32
10167,10307,1,2,5,8
10167,10308,1,0,8,9
10167,10309,0,2,9,11
10167,10310,0,2,10,12
10167,10312,1,1,15,17
10167,10314,1,3,39,43
10167,10451,3,4,6,13
10167,10452,8,7,16,31
10167,10453,8,11,15,34
10167,10454,1,4,6,11
10167,10455,2,8,4,14
10167,10456,8,4,5,17
10167,10457,4,4,13,21
10167,10458,4,4,15,23
10167,10459,4,5,2,11
10167,10460,3,2,5,10
10167,10461,3,5,35,43
10167,10462,2,12,25,39
10167,10463,3,3,34,40
10167,10464,0,0,2,2
10167,10465,3,2,16,21
10167,10466,5,4,11,20
10167,10467,3,6,18,27
10167,10468,3,12,14,29
10167,10469,1,2,14,17
10167,10470,0,0,1,1
10167,10471,1,1,13,15
10167,10472,4,9,14,27
10167,10473,1,5,14,20
10167,10475,3,4,9,16
10167,11001,0,1,3,4
10167,11004,1,0,4,5
10167,11005,0,0,1,1
10167,11101,3,3,43,49
10167,11102,1,6,32,39
10167,11103,1,3,59,63
10167,11104,2,3,21,26
10167,11105,0,3,46,49
10167,11106,4,5,41,50
10167,11109,0,0,31,31
10167,11201,2,3,102,107
10167,11203,1,10,16,27
10167,11204,1,4,25,30
10167,11205,1,1,21,23
10167,11206,0,5,28,33
10167,11207,4,10,16,30
10167,11208,5,4,16,25
10167,11209,6,2,55,63
10167,11210,3,3,18,24
10167,11211,4,1,95,100
10167,11212,7,13,11,31
10167,11213,1,7,24,32
10167,11214,2,4,28,34
10167,11215,3,8,70,81
10167,11216,5,7,37,49
10167,11217,3,4,57,64
10167,11218,0,5,21,26
10167,11219,0,1,7,8
10167,11220,4,3,21,28
10167,11221,2,6,34,42
10167,11222,4,2,35,41
10167,11223,1,0,12,13
10167,11224,1,1,7,9
10167,11225,6,2,32,40
10167,11226,12,6,26,44
10167,11228,2,2,13,17
10167,11229,3,2,21,26
10167,11230,2,3,28,33
10167,11231,2,2,31,35
10167,11232,2,0,9,11
10167,11233,7,6,34,47
10167,11234,4,6,36,46
10167,11235,3,0,13,16
10167,11236,3,8,24,35
10167,11237,1,1,15,17
10167,11238,1,3,61,65
10167,11239,0,0,4,4
10167,11354,1,5,15,21
10167,11355,5,2,34,41
10167,11356,0,3,8,11
10167,11357,1,1,13,15
10167,11358,1,0,17,18
10167,11360,0,1,9,10
10167,11361,1,1,13,15
10167,11362,0,0,6,6
10167,11364,0,0,18,18
10167,11365,1,2,28,31
10167,11366,0,0,11,11
10167,11367,0,0,9,9
10167,11368,2,5,16,23
10167,11369,0,2,6,8
10167,11370,1,1,10,12
10167,11372,1,6,33,40
10167,11373,5,11,48,64
10167,11374,2,1,35,38
10167,11375,2,5,88,95
10167,11377,5,9,53,67
10167,11378,2,0,17,19
10167,11379,1,0,25,26
10167,11385,3,6,50,59
10167,11411,0,1,7,8
10167,11412,0,3,3,6
10167,11413,1,1,8,10
10167,11414,1,0,11,12
10167,11415,2,1,24,27
10167,11416,0,0,9,9
10167,11417,1,2,9,12
10167,11418,3,0,9,12
10167,11419,6,3,11,20
10167,11420,4,2,15,21
10167,11421,1,1,23,25
10167,11422,0,4,5,9
10167,11423,1,3,5,9
10167,11426,2,1,8,11
10167,11427,2,2,6,10
10167,11428,1,2,7,10
10167,11429,2,1,8,11
10167,11432,2,3,22,27
10167,11433,0,2,7,9
10167,11434,3,2,15,20
10167,11435,5,4,17,26
10167,11436,1,0,0,1
10167,11691,1,5,7,13
10167,11692,2,1,5,8
10167,11693,0,0,3,3
10167,11694,0,1,9,10
10167,11697,0,0,5,5
10168,10001,2,2,12,16
10168,10002,7,16,29,52
10168,10003,4,5,34,43
10168,10004,0,1,5,6
10168,10005,0,0,12,12
10168,10006,0,0,2,2
10168,10007,3,0,5,8
10168,10009,9,11,34,54
10168,10010,2,1,30,33
10168,10011,8,10,35,53
10168,10012,1,0,11,12
10168,10013,3,1,7,11
10168,10014,3,2,24,29
10168,10016,21,18,90,129
10168,10017,2,2,30,34
10168,10018,1,1,3,5
10168,10019,6,4,36,46
10168,10021,1,6,34,41
10168,10022,3,4,30,37
10168,10023,7,6,30,43
10168,10024,1,7,27,35
10168,10025,23,16,44,83
10168,10026,5,10,17,32
10168,10027,10,14,13,37
10168,10028,6,5,47,58
10168,10029,14,40,25,79
10168,10030,4,7,6,17
10168,10031,3,10,14,27
10168,10032,10,9,10,29
10168,10033,11,11,11,33
10168,10034,4,16,8,28
10168,10035,9,12,11,32
10168,10036,8,3,19,30
10168,10037,0,6,7,13
10168,10038,0,7,15,22
10168,10039,7,8,5,20
10168,10040,7,11,11,29
10168,10044,3,3,5,11
10168,10065,4,0,34,38
10168,10069,0,1,3,4
10168,10075,3,3,20,26
10168,10128,7,9,48,64
10168,10162,0,0,1,1
10168,10280,0,2,7,9
10168,10282,0,0,2,2
10168,10301,3,5,10,18
10168,10302,2,1,5,8
10168,10303,3,2,5,10
10168,10304,4,4,2,10
10168,10305,3,8,13,24
10168,10306,5,1,9,15
10168,10307,0,2,5,7
10168,10308,0,3,5,8
10168,10309,1,0,8,9
10168,10310,6,1,8,15
10168,10312,1,1,11,13
10168,10314,10,4,17,31
10168,10451,8,13,6,27
10168,10452,12,26,10,48
10168,10453,14,21,12,47
10168,10454,5,13,4,22
10168,10455,6,13,6,25
10168,10456,15,31,8,54
10168,10457,12,14,7,33
10168,10458,8,12,11,31
10168,10459,5,13,8,26
10168,10460,8,19,10,37
10168,10461,3,10,15,28
10168,10462,6,24,12,42
10168,10463,6,4,12,22
10168,10464,0,0,1,1
10168,10465,1,7,14,22
10168,10466,12,18,11,41
10168,10467,12,20,10,42
10168,10468,6,14,12,32
10168,10469,5,14,15,34
10168,10470,4,2,6,12
10168,10471,1,3,8,12
10168,10472,6,19,9,34
10168,10473,1,16,8,25
10168,10474,0,5,3,8
10168,10475,5,5,7,17
10168,11004,2,1,1,4
10168,11101,5,10,18,33
10168,11102,10,5,18,33
10168,11103,5,5,31,41
10168,11104,4,9,17,30
10168,11105,3,3,30,36
10168,11106,5,5,19,29
10168,11109,0,0,12,12
10168,11201,7,9,36,52
10168,11203,9,30,12,51
10168,11204,2,4,5,11
10168,11205,11,9,13,33
10168,11206,15,27,26,68
10168,11207,14,17,15,46
10168,11208,19,16,16,51
10168,11209,3,2,25,30
10168,11210,17,15,8,40
10168,11211,7,12,32,51
10168,11212,20,25,10,55
10168,11213,9,13,9,31
10168,11214,3,3,10,16
10168,11215,3,6,31,40
10168,11216,8,12,29,49
10168,11217,8,11,22,41
10168,11218,8,6,9,23
10168,11219,0,6,6,12
10168,11220,4,11,11,26
10168,11221,13,20,13,46
10168,11222,4,9,26,39
10168,11223,4,9,5,18
10168,11224,3,5,4,12
10168,11225,11,15,20,46
10168,11226,21,28,22,71
10168,11228,6,4,8,18
10168,11229,5,5,15,25
10168,11230,7,13,23,43
10168,11231,4,7,21,32
10168,11232,1,2,3,6
10168,11233,6,23,23,52
10168,11234,17,15,27,59
10168,11235,8,7,10,25
10168,11236,19,23,13,55
10168,11237,9,7,12,28
10168,11238,6,11,27,44
10168,11239,2,0,3,5
10168,11354,4,6,12,22
10168,11355,5,8,13,26
10168,11356,0,2,4,6
10168,11357,0,6,12,18
10168,11358,3,0,7,10
10168,11360,2,1,2,5
10168,11361,2,1,10,13
10168,11362,0,2,6,8
10168,11363,0,0,2,2
10168,11364,1,2,8,11
10168,11365,1,5,5,11
10168,11366,0,0,3,3
10168,11367,6,4,7,17
10168,11368,8,12,12,32
10168,11369,2,10,11,23
10168,11370,4,4,6,14
10168,11371,0,0,1,1
10168,11372,13,14,22,49
10168,11373,7,15,32,54
10168,11374,7,12,24,43
10168,11375,3,11,41,55
10168,11377,10,17,31,58
10168,11378,3,2,9,14
10168,11379,5,4,17,26
10168,11385,10,16,29,55
10168,11411,3,5,4,12
10168,11412,4,7,3,14
10168,11413,8,6,3,17
10168,11414,0,3,9,12
10168,11415,1,2,8,11
10168,11416,3,3,4,10
10168,11417,4,2,10,16
10168,11418,8,6,15,29
10168,11419,1,6,12,19
10168,11420,4,7,7,18
10168,11421,5,4,11,20
10168,11422,6,9,5,20
10168,11423,3,4,5,12
10168,11426,0,0,1,1
10168,11427,5,4,4,13
10168,11428,2,2,7,11
10168,11429,4,8,13,25
10168,11430,0,1,0,1
10168,11432,3,10,10,23
10168,11433,7,5,1,13
10168,11434,5,7,11,23
10168,11435,4,8,9,21
10168,11436,1,1,0,2
10168,11691,7,9,5,21
10168,11692,4,4,2,10
10168,11693,2,2,5,9
10168,11694,1,2,3,6
10168,11697,2,0,0,2
10169,10001,0,0,28,28
10169,10002,1,6,51,58
10169,10003,2,3,98,103
10169,10004,1,0,13,14
10169,10005,0,0,19,19
10169,10006,0,0,15,15
10169,10007,0,0,22,22
10169,10009,2,3,62,67
10169,10010,6,2,74,82
10169,10011,4,4,100,108
10169,10012,0,0,27,27
10169,10013,1,1,38,40
10169,10014,2,0,60,62
10169,10016,2,3,164,169
10169,10017,2,3,120,125
10169,10018,0,1,18,19
10169,10019,3,5,79,87
10169,10021,2,1,93,96
10169,10022,2,5,82,89
10169,10023,3,4,114,121
10169,10024,2,5,93,100
10169,10025,4,5,103,112
10169,10026,3,1,15,19
10169,10027,2,7,30,39
10169,10028,0,3,84,87
10169,10029,2,4,31,37
10169,10030,2,2,9,13
10169,10031,4,5,18,27
10169,10032,1,4,25,30
10169,10033,4,4,33,41
10169,10034,1,1,17,19
10169,10035,4,4,8,16
10169,10036,3,6,49,58
10169,10037,1,0,10,11
10169,10038,1,2,29,32
10169,10039,2,3,6,11
10169,10040,1,3,26,30
10169,10044,1,0,12,13
10169,10065,1,2,62,65
10169,10069,0,0,11,11
10169,10075,2,2,42,46
10169,10128,2,3,112,117
10169,10162,0,1,6,7
10169,10280,0,0,26,26
10169,10282,0,0,6,6
10169,10301,2,3,12,17
10169,10302,0,0,4,4
10169,10303,1,1,4,6
10169,10304,0,1,13,14
10169,10305,1,5,23,29
10169,10306,2,2,25,29
10169,10307,0,0,8,8
10169,10308,0,2,23,25
10169,10309,1,2,15,18
10169,10310,1,1,8,10
10169,10312,1,2,24,27
10169,10314,2,4,38,44
10169,10451,2,3,13,18
10169,10452,3,7,7,17
10169,10453,2,2,11,15
10169,10454,0,4,11,15
10169,10455,2,4,11,17
10169,10456,2,11,15,28
10169,10457,3,9,14,26
10169,10458,5,4,16,25
10169,10459,5,4,8,17
10169,10460,3,2,7,12
10169,10461,2,5,37,44
10169,10462,3,9,29,41
10169,10463,0,2,26,28
10169,10464,0,0,1,1
10169,10465,0,3,18,21
10169,10466,1,2,17,20
10169,10467,1,5,23,29
10169,10468,2,3,15,20
10169,10469,1,4,16,21
10169,10470,3,0,7,10
10169,10471,0,1,17,18
10169,10472,4,6,16,26
10169,10473,2,8,12,22
10169,10474,0,3,3,6
10169,10475,2,3,16,21
10169,11001,0,0,2,2
10169,11004,0,0,4,4
10169,11005,0,1,1,2
10169,11101,2,1,45,48
10169,11102,4,3,31,38
10169,11103,4,5,30,39
10169,11104,1,2,26,29
10169,11105,1,4,38,43
10169,11106,2,7,36,45
10169,11109,0,0,28,28
10169,11201,3,5,107,115
10169,11203,3,4,26,33
10169,11204,5,2,31,38
10169,11205,1,3,26,30
10169,11206,3,4,19,26
10169,11207,2,3,17,22
10169,11208,0,9,19,28
10169,11209,4,5,53,62
10169,11210,1,3,16,20
10169,11211,5,7,84,96
10169,11212,1,7,14,22
10169,11213,2,4,23,29
10169,11214,2,1,25,28
10169,11215,1,5,65,71
10169,11216,6,10,22,38
10169,11217,1,0,49,50
10169,11218,0,1,31,32
10169,11219,3,0,14,17
10169,11220,3,3,23,29
10169,11221,3,6,23,32
10169,11222,3,3,35,41
10169,11223,5,2,23,30
10169,11224,0,1,12,13
10169,11225,2,5,29,36
10169,11226,4,8,38,50
10169,11228,0,3,28,31
10169,11229,1,4,19,24
10169,11230,2,5,29,36
10169,11231,0,0,39,39
10169,11232,1,1,7,9
10169,11233,0,5,20,25
10169,11234,4,3,28,35
10169,11235,1,3,18,22
10169,11236,1,9,19,29
10169,11237,0,5,13,18
10169,11238,2,5,38,45
10169,11239,0,0,1,1
10169,11354,1,2,22,25
10169,11355,1,4,30,35
10169,11356,1,2,15,18
10169,11357,4,1,27,32
10169,11358,2,3,17,22
10169,11360,0,1,9,10
10169,11361,0,1,8,9
10169,11362,0,0,5,5
10169,11363,0,0,3,3
10169,11364,1,0,19,20
10169,11365,2,1,17,20
10169,11366,0,1,9,10
10169,11367,1,2,8,11
10169,11368,6,3,21,30
10169,11369,0,1,19,20
10169,11370,1,1,10,12
10169,11372,2,7,42,51
10169,11373,1,10,42,53
10169,11374,2,3,36,41
10169,11375,0,6,66,72
10169,11377,3,7,57,67
10169,11378,1,4,29,34
10169,11379,3,5,27,35
10169,11385,7,3,44,54
10169,11411,2,2,6,10
10169,11412,0,1,3,4
10169,11413,1,4,2,7
10169,11414,0,0,10,10
10169,11415,1,4,14,19
10169,11416,0,1,5,6
10169,11417,0,3,9,12
10169,11418,1,4,13,18
10169,11419,1,3,11,15
10169,11420,0,2,14,16
10169,11421,2,2,15,19
10169,11422,0,2,10,12
10169,11423,1,2,3,6
10169,11426,1,0,6,7
10169,11427,0,4,11,15
10169,11428,0,2,9,11
10169,11429,0,0,6,6
10169,11432,0,3,15,18
10169,11433,0,2,14,16
10169,11434,1,1,11,13
10169,11435,5,5,13,23
10169,11436,0,1,4,5
10169,11691,0,2,13,15
10169,11692,0,0,5,5
10169,11693,0,1,7,8
10169,11694,1,0,7,8
10169,11697,0,0,1,1
10170,10001,3,5,30,38
10170,10002,7,11,35,53
10170,10003,8,4,78,90
10170,10004,2,1,7,10
10170,10005,1,0,22,23
10170,10006,0,0,7,7
10170,10007,2,2,15,19
10170,10009,16,12,50,78
10170,10010,6,2,60,68
10170,10011,15,7,64,86
10170,10012,1,3,33,37
10170,10013,1,4,31,36
10170,10014,3,9,56,68
10170,10016,8,11,95,114
10170,10017,6,10,90,106
10170,10018,0,1,10,11
10170,10019,8,6,65,79
10170,10021,6,9,69,84
10170,10022,3,9,44,56
10170,10023,13,13,69,95
10170,10024,9,6,64,79
10170,10025,22,10,71,103
10170,10026,7,10,19,36
10170,10027,15,12,24,51
10170,10028,7,8,52,67
10170,10029,12,32,38,82
10170,10030,6,7,21,34
10170,10031,9,16,29,54
10170,10032,14,15,20,49
10170,10033,4,11,16,31
10170,10034,6,13,22,41
10170,10035,12,8,18,38
10170,10036,7,5,28,40
10170,10037,6,6,8,20
10170,10038,2,1,30,33
10170,10039,12,10,9,31
10170,10040,8,4,21,33
10170,10044,6,4,8,18
10170,10065,3,2,43,48
10170,10069,1,1,13,15
10170,10075,2,10,31,43
10170,10128,8,4,99,111
10170,10162,1,0,3,4
10170,10280,1,0,15,16
10170,10282,0,1,6,7
10170,10301,5,6,10,21
10170,10302,0,0,2,2
10170,10303,1,3,8,12
10170,10304,6,5,8,19
10170,10305,4,5,16,25
10170,10306,5,3,15,23
10170,10307,0,0,5,5
10170,10308,2,2,11,15
10170,10309,1,2,11,14
10170,10310,5,1,5,11
10170,10312,2,1,14,17
10170,10314,6,5,26,37
10170,10451,6,10,6,22
10170,10452,18,16,12,46
10170,10453,16,19,26,61
10170,10454,8,9,7,24
10170,10455,9,9,11,29
10170,10456,23,26,19,68
10170,10457,11,17,17,45
10170,10458,18,17,26,61
10170,10459,12,12,9,33
10170,10460,11,18,16,45
10170,10461,12,4,27,43
10170,10462,14,18,23,55
10170,10463,10,10,40,60
10170,10464,0,1,2,3
10170,10465,7,4,9,20
10170,10466,14,12,21,47
10170,10467,13,21,23,57
10170,10468,9,23,17,49
10170,10469,14,14,17,45
10170,10470,0,1,3,4
10170,10471,2,4,19,25
10170,10472,4,20,12,36
10170,10473,10,12,11,33
10170,10474,0,0,1,1
10170,10475,5,10,6,21
10170,11001,2,0,1,3
10170,11004,3,1,4,8
10170,11040,0,0,1,1
10170,11101,8,9,39,56
10170,11102,8,13,24,45
10170,11103,13,11,35,59
10170,11104,1,4,21,26
10170,11105,4,6,38,48
10170,11106,7,12,32,51
10170,11109,0,1,14,15
10170,11201,7,7,71,85
10170,11203,13,33,31,77
10170,11204,2,3,14,19
10170,11205,7,8,18,33
10170,11206,9,15,28,52
10170,11207,17,22,14,53
10170,11208,14,31,23,68
10170,11209,7,10,48,65
10170,11210,9,9,25,43
10170,11211,4,4,65,73
10170,11212,20,30,19,69
10170,11213,10,14,20,44
10170,11214,6,4,14,24
10170,11215,7,16,62,85
10170,11216,17,21,40,78
10170,11217,5,7,46,58
10170,11218,6,12,30,48
10170,11219,7,4,7,18
10170,11220,11,12,22,45
10170,11221,8,26,26,60
10170,11222,8,5,27,40
10170,11223,5,3,14,22
10170,11224,2,4,8,14
10170,11225,13,17,29,59
10170,11226,21,38,38,97
10170,11228,5,3,19,27
10170,11229,10,11,8,29
10170,11230,7,13,21,41
10170,11231,4,7,34,45
10170,11232,2,2,4,8
10170,11233,22,26,25,73
10170,11234,16,16,29,61
10170,11235,3,10,16,29
10170,11236,13,25,28,66
10170,11237,1,10,14,25
10170,11238,7,15,47,69
10170,11239,1,1,3,5
10170,11354,4,5,12,21
10170,11355,8,6,25,39
10170,11356,5,2,8,15
10170,11357,2,3,11,16
10170,11358,1,7,17,25
10170,11360,3,0,6,9
10170,11361,3,3,9,15
10170,11362,2,2,3,7
10170,11363,0,0,2,2
10170,11364,0,4,8,12
10170,11365,3,2,13,18
10170,11366,1,1,6,8
10170,11367,1,5,8,14
10170,11368,8,21,14,43
10170,11369,4,6,16,26
10170,11370,2,4,11,17
10170,11372,9,10,39,58
10170,11373,16,15,37,68
10170,11374,5,2,41,48
10170,11375,5,12,58,75
10170,11377,13,14,44,71
10170,11378,2,1,15,18
10170,11379,6,6,21,33
10170,11385,15,19,42,76
10170,11411,3,3,10,16
10170,11412,4,9,10,23
10170,11413,7,10,6,23
10170,11414,1,1,9,11
10170,11415,4,5,12,21
10170,11416,0,4,7,11
10170,11417,3,4,13,20
10170,11418,4,10,11,25
10170,11419,3,10,15,28
10170,11420,4,8,14,26
10170,11421,1,8,14,23
10170,11422,2,10,9,21
10170,11423,0,3,4,7
10170,11426,4,3,7,14
10170,11427,1,1,11,13
10170,11428,2,7,5,14
10170,11429,4,7,12,23
10170,11432,8,11,11,30
10170,11433,8,6,6,20
10170,11434,5,11,10,26
10170,11435,13,12,17,42
10170,11436,3,4,1,8
10170,11691,6,11,8,25
10170,11692,0,2,2,4
10170,11693,1,5,6,12
10170,11694,4,0,5,9
10170,11697,1,0,2,3
10171,10001,0,1,9,10
10171,10002,0,3,12,15
10171,10003,1,2,40,43
10171,10004,0,0,3,3
10171,10005,0,1,10,11
10171,10006,0,0,2,2
10171,10007,0,0,5,5
10171,10009,0,2,11,13
10171,10010,0,0,21,21
10171,10011,0,1,27,28
10171,10012,0,1,14,15
10171,10013,0,1,11,12
10171,10014,0,0,14,14
10171,10016,1,0,41,42
10171,10017,0,1,46,47
10171,10018,0,0,1,1
10171,10019,0,3,14,17
10171,10021,2,1,21,24
10171,10022,1,0,17,18
10171,10023,0,1,28,29
10171,10024,2,1,26,29
10171,10025,1,1,21,23
10171,10026,2,1,7,10
10171,10027,2,3,6,11
10171,10028,0,0,35,35
10171,10029,0,3,14,17
10171,10030,1,2,3,6
10171,10031,0,3,3,6
10171,10032,0,4,0,4
10171,10033,1,2,6,9
10171,10034,1,0,6,7
10171,10035,0,1,3,4
10171,10036,0,1,24,25
10171,10037,0,1,3,4
10171,10038,0,0,16,16
10171,10039,1,0,6,7
10171,10040,1,1,6,8
10171,10044,1,1,2,4
10171,10065,1,0,20,21
10171,10069,0,0,1,1
10171,10075,0,1,11,12
10171,10128,1,3,29,33
10171,10280,0,0,10,10
10171,10282,0,0,2,2
10171,10301,1,1,0,2
10171,10302,0,0,1,1
10171,10303,0,1,2,3
10171,10304,0,0,2,2
10171,10305,0,0,12,12
10171,10306,0,1,7,8
10171,10307,0,0,2,2
10171,10308,0,0,1,1
10171,10309,0,0,3,3
10171,10310,0,0,4,4
10171,10312,0,1,6,7
10171,10314,0,1,15,16
10171,10451,3,1,2,6
10171,10452,0,5,7,12
10171,10453,1,2,5,8
10171,10454,0,3,1,4
10171,10455,1,1,4,6
10171,10456,2,3,7,12
10171,10457,0,2,1,3
10171,10458,1,4,5,10
10171,10459,1,3,6,10
10171,10460,0,0,2,2
10171,10461,1,1,6,8
10171,10462,0,4,5,9
10171,10463,0,1,11,12
10171,10465,0,1,6,7
10171,10466,1,2,3,6
10171,10467,2,2,6,10
10171,10468,1,2,6,9
10171,10469,0,1,5,6
10171,10471,0,1,5,6
10171,10472,0,3,4,7
10171,10473,1,3,4,8
10171,10474,0,1,0,1
10171,10475,0,1,6,7
10171,11001,0,0,1,1
10171,11004,0,0,1,1
10171,11101,0,0,16,16
10171,11102,1,0,11,12
10171,11103,0,1,16,17
10171,11104,0,2,7,9
10171,11105,0,0,13,13
10171,11106,0,0,12,12
10171,11109,0,0,6,6
10171,11201,1,1,24,26
10171,11203,2,2,6,10
10171,11204,0,1,6,7
10171,11205,0,1,3,4
10171,11206,3,2,12,17
10171,11207,0,1,4,5
10171,11208,0,2,5,7
10171,11209,1,2,12,15
10171,11210,0,4,8,12
10171,11211,1,2,30,33
10171,11212,0,5,4,9
10171,11213,0,3,7,10
10171,11214,0,1,9,10
10171,11215,1,3,24,28
10171,11216,2,1,6,9
10171,11217,0,1,22,23
10171,11218,0,4,9,13
10171,11219,1,0,4,5
10171,11220,0,1,10,11
10171,11221,2,3,10,15
10171,11222,0,1,12,13
10171,11223,0,2,5,7
10171,11224,0,1,1,2
10171,11225,0,1,5,6
10171,11226,0,2,20,22
10171,11228,0,1,5,6
10171,11229,1,0,8,9
10171,11230,2,0,5,7
10171,11231,0,0,5,5
10171,11232,0,1,5,6
10171,11233,2,4,6,12
10171,11234,0,1,5,6
10171,11235,0,1,8,9
10171,11236,1,4,7,12
10171,11237,1,1,3,5
10171,11238,0,1,14,15
10171,11354,0,3,2,5
10171,11355,0,3,4,7
10171,11356,0,0,2,2
10171,11357,1,0,4,5
10171,11358,0,1,4,5
10171,11360,0,0,3,3
10171,11361,0,0,2,2
10171,11362,0,0,4,4
10171,11363,0,0,2,2
10171,11364,0,0,1,1
10171,11365,0,0,5,5
10171,11366,0,0,3,3
10171,11367,0,0,3,3
10171,11368,1,1,7,9
10171,11369,1,0,5,6
10171,11370,0,0,1,1
10171,11372,0,8,7,15
10171,11373,2,3,6,11
10171,11374,0,0,9,9
10171,11375,0,2,16,18
10171,11377,4,6,12,22
10171,11378,0,1,4,5
10171,11379,0,0,11,11
10171,11385,1,1,13,15
10171,11411,0,0,2,2
10171,11412,0,1,0,1
10171,11413,0,1,1,2
10171,11414,0,0,3,3
10171,11415,0,1,4,5
10171,11416,0,0,1,1
10171,11417,0,0,2,2
10171,11418,0,2,0,2
10171,11419,0,2,2,4
10171,11420,0,0,3,3
10171,11421,0,1,8,9
10171,11422,0,0,3,3
10171,11423,0,0,1,1
10171,11426,0,0,1,1
10171,11427,0,2,1,3
10171,11428,0,0,2,2
10171,11429,0,1,1,2
10171,11432,1,1,5,7
10171,11433,0,1,0,1
10171,11434,1,2,5,8
10171,11435,3,1,5,9
10171,11436,0,0,1,1
10171,11691,0,1,4,5
10171,11692,0,0,1,1
10171,11693,0,1,0,1
10171,11694,0,0,2,2
10171,11697,0,0,1,1
10172,10001,0,0,18,18
10172,10002,1,1,28,30
10172,10003,1,1,50,52
10172,10004,0,0,5,5
10172,10005,0,1,12,13
10172,10006,0,0,2,2
10172,10007,0,0,12,12
10172,10009,2,2,39,43
10172,10010,0,0,42,42
10172,10011,1,0,40,41
10172,10012,0,2,14,16
10172,10013,1,0,24,25
10172,10014,1,2,30,33
10172,10016,0,3,67,70
10172,10017,0,1,79,80
10172,10018,0,0,8,8
10172,10019,1,4,42,47
10172,10021,0,0,48,48
10172,10022,0,0,48,48
10172,10023,0,1,59,60
10172,10024,1,0,37,38
10172,10025,4,0,33,37
10172,10026,0,1,13,14
10172,10027,5,2,12,19
10172,10028,0,3,54,57
10172,10029,0,3,23,26
10172,10030,0,2,6,8
10172,10031,2,4,8,14
10172,10032,0,5,8,13
10172,10033,1,0,10,11
10172,10034,4,1,2,7
10172,10035,0,0,9,9
10172,10036,0,0,35,35
10172,10037,1,0,3,4
10172,10038,0,0,30,30
10172,10039,0,0,2,2
10172,10040,1,2,11,14
10172,10044,1,1,11,13
10172,10065,0,0,35,35
10172,10069,0,0,6,6
10172,10075,0,0,24,24
10172,10128,4,3,44,51
10172,10280,1,0,14,15
10172,10282,0,0,6,6
10172,10301,2,1,5,8
10172,10302,0,0,2,2
10172,10303,0,1,5,6
10172,10304,1,0,7,8
10172,10305,0,0,6,6
10172,10306,0,1,10,11
10172,10307,0,0,4,4
10172,10308,0,0,5,5
10172,10309,0,0,4,4
10172,10310,0,0,8,8
10172,10312,0,0,7,7
10172,10314,1,2,23,26
10172,10451,0,0,8,8
10172,10452,1,5,9,15
10172,10453,1,2,7,10
10172,10454,0,0,9,9
10172,10455,0,1,4,5
10172,10456,3,3,8,14
10172,10457,0,1,3,4
10172,10458,0,3,11,14
10172,10459,0,0,5,5
10172,10460,0,4,2,6
10172,10461,1,0,15,16
10172,10462,1,2,10,13
10172,10463,1,1,16,18
10172,10465,1,1,2,4
10172,10466,1,1,7,9
10172,10467,0,2,9,11
10172,10468,1,3,6,10
10172,10469,0,0,13,13
10172,10470,0,0,3,3
10172,10471,0,0,13,13
10172,10472,0,5,5,10
10172,10473,1,3,8,12
10172,10475,1,1,5,7
10172,11001,0,0,2,2
10172,11004,0,0,5,5
10172,11040,0,0,1,1
10172,11101,2,1,30,33
10172,11102,0,1,16,17
10172,11103,2,2,14,18
10172,11104,1,2,10,13
10172,11105,0,3,22,25
10172,11106,0,3,14,17
10172,11109,0,0,7,7
10172,11201,2,2,66,70
10172,11203,0,4,10,14
10172,11204,0,2,16,18
10172,11205,2,2,6,10
10172,11206,2,3,10,15
10172,11207,3,3,3,9
10172,11208,0,3,10,13
10172,11209,4,1,24,29
10172,11210,1,0,15,16
10172,11211,0,1,52,53
10172,11212,0,0,6,6
10172,11213,1,2,6,9
10172,11214,0,0,16,16
10172,11215,4,2,37,43
10172,11216,3,2,15,20
10172,11217,0,0,31,31
10172,11218,0,2,10,12
10172,11219,1,2,10,13
10172,11220,1,1,11,13
10172,11221,2,7,10,19
10172,11222,0,2,18,20
10172,11223,0,1,11,12
10172,11224,0,1,9,10
10172,11225,2,0,11,13
10172,11226,0,5,20,25
10172,11228,0,0,7,7
10172,11229,1,0,6,7
10172,11230,2,2,23,27
10172,11231,0,0,14,14
10172,11232,1,0,4,5
10172,11233,3,0,9,12
10172,11234,1,3,15,19
10172,11235,0,0,1,1
10172,11236,0,4,10,14
10172,11237,0,3,15,18
10172,11238,1,0,26,27
10172,11239,0,1,2,3
10172,11354,1,1,16,18
10172,11355,2,1,13,16
10172,11356,0,1,6,7
10172,11357,1,1,10,12
10172,11358,0,2,10,12
10172,11360,0,2,4,6
10172,11361,0,0,7,7
10172,11362,0,1,1,2
10172,11363,1,0,1,2
10172,11364,0,0,14,14
10172,11365,0,4,7,11
10172,11366,0,1,7,8
10172,11367,1,2,8,11
10172,11368,0,2,12,14
10172,11369,0,1,8,9
10172,11370,1,2,6,9
10172,11372,1,3,21,25
10172,11373,2,8,25,35
10172,11374,3,3,25,31
10172,11375,1,1,35,37
10172,11377,3,4,36,43
10172,11378,0,1,15,16
10172,11379,0,0,7,7
10172,11385,1,3,21,25
10172,11411,0,1,4,5
10172,11412,1,0,1,2
10172,11413,1,0,3,4
10172,11414,0,0,7,7
10172,11415,0,0,4,4
10172,11416,1,1,9,11
10172,11417,0,1,5,6
10172,11418,0,1,7,8
10172,11419,0,3,6,9
10172,11420,0,0,6,6
10172,11421,0,3,10,13
10172,11422,0,0,2,2
10172,11423,0,1,3,4
10172,11426,0,0,5,5
10172,11427,0,1,3,4
10172,11428,0,1,1,2
10172,11429,0,2,3,5
10172,11432,2,1,10,13
10172,11433,0,0,2,2
10172,11434,0,1,3,4
10172,11435,1,1,8,10
10172,11436,1,0,0,1
10172,11691,0,0,4,4
10172,11692,1,0,1,2
10172,11693,0,0,2,2
10172,11694,1,0,1,2
10172,11697,1,0,3,4
10173,10001,4,4,14,22
10173,10002,2,7,15,24
10173,10003,9,5,47,61
10173,10004,0,0,5,5
10173,10005,1,0,18,19
10173,10006,0,0,3,3
10173,10007,0,0,13,13
10173,10009,3,7,36,46
10173,10010,1,2,33,36
10173,10011,6,7,47,60
10173,10012,3,2,27,32
10173,10013,2,1,24,27
10173,10014,2,2,26,30
10173,10016,2,5,69,76
10173,10017,3,6,25,34
10173,10018,0,4,10,14
10173,10019,7,8,41,56
10173,10021,3,7,40,50
10173,10022,3,1,44,48
10173,10023,1,5,68,74
10173,10024,5,1,36,42
10173,10025,6,4,34,44
10173,10026,3,6,6,15
10173,10027,7,9,21,37
10173,10028,4,2,41,47
10173,10029,2,7,30,39
10173,10030,1,4,5,10
10173,10031,1,8,7,16
10173,10032,3,9,11,23
10173,10033,8,7,6,21
10173,10034,5,3,12,20
10173,10035,4,10,3,17
10173,10036,2,3,25,30
10173,10037,2,6,6,14
10173,10038,2,3,9,14
10173,10039,3,4,5,12
10173,10040,7,5,5,17
10173,10044,0,0,5,5
10173,10065,3,2,32,37
10173,10069,1,1,3,5
10173,10075,1,4,20,25
10173,10128,9,2,54,65
10173,10280,0,0,5,5
10173,10282,0,0,3,3
10173,10301,1,2,6,9
10173,10303,2,6,7,15
10173,10304,3,5,8,16
10173,10305,2,4,6,12
10173,10306,1,5,7,13
10173,10307,1,0,1,2
10173,10308,0,1,8,9
10173,10309,1,1,3,5
10173,10310,1,4,4,9
10173,10312,0,1,17,18
10173,10314,5,7,17,29
10173,10451,2,7,2,11
10173,10452,7,9,7,23
10173,10453,4,6,13,23
10173,10454,1,4,0,5
10173,10455,2,2,7,11
10173,10456,6,11,7,24
10173,10457,1,11,4,16
10173,10458,8,12,5,25
10173,10459,1,4,5,10
10173,10460,1,5,2,8
10173,10461,2,4,12,18
10173,10462,6,17,17,40
10173,10463,5,7,21,33
10173,10464,0,1,1,2
10173,10465,2,6,7,15
10173,10466,3,8,12,23
10173,10467,3,13,11,27
10173,10468,7,7,10,24
10173,10469,2,4,12,18
10173,10470,1,4,4,9
10173,10471,1,0,6,7
10173,10472,4,9,6,19
10173,10473,3,3,8,14
10173,10474,1,3,1,5
10173,10475,4,3,8,15
10173,11001,0,0,1,1
10173,11004,1,0,4,5
10173,11040,0,1,0,1
10173,11101,4,4,16,24
10173,11102,5,8,18,31
10173,11103,0,8,16,24
10173,11104,5,11,18,34
10173,11105,3,2,17,22
10173,11106,2,6,18,26
10173,11109,0,0,10,10
10173,11201,1,4,46,51
10173,11203,5,9,9,23
10173,11204,1,5,4,10
10173,11205,5,6,12,23
10173,11206,6,8,11,25
10173,11207,6,11,5,22
10173,11208,5,8,8,21
10173,11209,6,7,23,36
10173,11210,6,6,6,18
10173,11211,4,11,32,47
10173,11212,7,8,6,21
10173,11213,4,7,7,18
10173,11214,3,7,15,25
10173,11215,1,7,36,44
10173,11216,4,7,11,22
10173,11217,3,4,25,32
10173,11218,4,2,14,20
10173,11219,2,2,5,9
10173,11220,3,6,10,19
10173,11221,6,9,20,35
10173,11222,2,7,29,38
10173,11223,0,3,9,12
10173,11224,3,4,10,17
10173,11225,8,10,18,36
10173,11226,6,17,17,40
10173,11228,0,2,11,13
10173,11229,1,5,11,17
10173,11230,9,6,20,35
10173,11231,1,1,14,16
10173,11232,3,5,5,13
10173,11233,5,3,11,19
10173,11234,5,5,18,28
10173,11235,3,1,15,19
10173,11236,7,6,6,19
10173,11237,0,2,9,11
10173,11238,5,6,31,42
10173,11239,1,0,1,2
10173,11354,2,1,6,9
10173,11355,5,4,10,19
10173,11356,1,4,2,7
10173,11357,2,4,12,18
10173,11358,2,2,10,14
10173,11360,0,0,1,1
10173,11361,1,4,9,14
10173,11362,1,0,3,4
10173,11363,1,1,0,2
10173,11364,1,2,11,14
10173,11365,1,3,12,16
10173,11366,1,0,2,3
10173,11367,1,2,8,11
10173,11368,6,5,6,17
10173,11369,1,4,6,11
10173,11370,0,4,5,9
10173,11372,4,13,15,32
10173,11373,5,10,30,45
10173,11374,5,6,24,35
10173,11375,2,8,33,43
10173,11377,7,14,24,45
10173,11378,2,1,7,10
10173,11379,4,5,12,21
10173,11385,5,22,19,46
10173,11411,1,1,3,5
10173,11412,2,1,4,7
10173,11413,3,7,6,16
10173,11414,2,1,9,12
10173,11415,0,2,7,9
10173,11416,2,5,2,9
10173,11417,1,1,3,5
10173,11418,1,5,8,14
10173,11419,1,5,7,13
10173,11420,4,13,15,32
10173,11421,2,6,10,18
10173,11422,4,0,0,4
10173,11423,2,1,4,7
10173,11426,1,2,0,3
10173,11427,0,2,11,13
10173,11428,2,1,2,5
10173,11429,1,1,4,6
10173,11432,5,6,9,20
10173,11433,1,1,3,5
10173,11434,2,4,2,8
10173,11435,1,2,7,10
10173,11436,0,2,4,6
10173,11691,1,2,4,7
10173,11692,0,1,2,3
10173,11693,1,1,1,3
10173,11694,0,1,3,4
10174,10001,2,4,14,20
10174,10002,1,11,27,39
10174,10003,1,8,52,61
10174,10004,1,0,5,6
10174,10005,0,0,9,9
10174,10006,0,0,7,7
10174,10007,0,0,14,14
10174,10009,1,7,33,41
10174,10010,3,3,32,38
10174,10011,4,5,66,75
10174,10012,1,4,22,27
10174,10013,2,2,23,27
10174,10014,1,1,37,39
10174,10016,5,8,65,78
10174,10017,4,5,52,61
10174,10018,1,1,9,11
10174,10019,4,5,37,46
10174,10021,1,2,37,40
10174,10022,2,2,25,29
10174,10023,3,2,61,66
10174,10024,1,3,42,46
10174,10025,3,5,37,45
10174,10026,2,1,14,17
10174,10027,4,8,13,25
10174,10028,3,7,45,55
10174,10029,5,15,13,33
10174,10030,3,4,4,11
10174,10031,0,8,16,24
10174,10032,6,9,11,26
10174,10033,1,4,16,21
10174,10034,3,7,6,16
10174,10035,4,5,7,16
10174,10036,3,2,22,27
10174,10037,0,3,2,5
10174,10038,1,1,13,15
10174,10039,6,8,2,16
10174,10040,1,6,8,15
10174,10044,0,0,5,5
10174,10065,2,1,38,41
10174,10069,0,1,5,6
10174,10075,1,0,12,13
10174,10128,5,7,52,64
10174,10162,1,0,0,1
10174,10280,0,1,18,19
10174,10282,0,1,2,3
10174,10301,2,3,2,7
10174,10302,0,2,2,4
10174,10303,1,2,6,9
10174,10304,1,0,5,6
10174,10305,3,2,5,10
10174,10306,2,3,4,9
10174,10307,0,0,1,1
10174,10308,0,0,7,7
10174,10309,0,1,4,5
10174,10310,6,3,5,14
10174,10312,1,2,10,13
10174,10314,3,7,12,22
10174,10451,4,7,5,16
10174,10452,7,13,8,28
10174,10453,6,6,9,21
10174,10454,1,5,6,12
10174,10455,2,11,2,15
10174,10456,4,13,7,24
10174,10457,7,10,6,23
10174,10458,5,13,9,27
10174,10459,5,9,5,19
10174,10460,5,8,3,16
10174,10461,1,5,14,20
10174,10462,4,7,22,33
10174,10463,2,5,20,27
10174,10465,3,3,5,11
10174,10466,7,7,6,20
10174,10467,6,12,7,25
10174,10468,8,5,9,22
10174,10469,1,10,11,22
10174,10470,1,1,4,6
10174,10471,0,1,5,6
10174,10472,4,11,2,17
10174,10473,6,9,9,24
10174,10474,2,2,2,6
10174,10475,2,5,4,11
10174,11003,0,0,1,1
10174,11004,0,1,4,5
10174,11101,4,6,16,26
10174,11102,5,7,15,27
10174,11103,4,9,19,32
10174,11104,5,1,14,20
10174,11105,4,7,19,30
10174,11106,4,6,15,25
10174,11109,0,0,6,6
10174,11201,1,5,50,56
10174,11203,3,13,14,30
10174,11204,0,4,9,13
10174,11205,1,5,14,20
10174,11206,5,8,21,34
10174,11207,4,11,8,23
10174,11208,12,11,9,32
10174,11209,4,2,23,29
10174,11210,4,6,9,19
10174,11211,4,3,34,41
10174,11212,9,14,11,34
10174,11213,5,5,7,17
10174,11214,2,6,13,21
10174,11215,2,6,37,45
10174,11216,6,11,20,37
10174,11217,1,6,27,34
10174,11218,0,5,12,17
10174,11219,1,3,0,4
10174,11220,5,6,7,18
10174,11221,3,7,12,22
10174,11222,1,0,8,9
10174,11223,1,2,5,8
10174,11224,2,1,4,7
10174,11225,6,7,15,28
10174,11226,12,12,15,39
10174,11228,0,1,11,12
10174,11229,2,3,7,12
10174,11230,2,3,9,14
10174,11231,2,2,19,23
10174,11232,2,0,4,6
10174,11233,4,9,8,21
10174,11234,5,2,13,20
10174,11235,1,1,9,11
10174,11236,3,13,11,27
10174,11237,3,7,6,16
10174,11238,3,5,18,26
10174,11239,1,0,1,2
10174,11354,2,5,9,16
10174,11355,8,3,13,24
10174,11356,3,1,1,5
10174,11357,0,2,11,13
10174,11358,3,4,9,16
10174,11360,1,1,5,7
10174,11361,1,0,5,6
10174,11362,0,1,2,3
10174,11363,0,0,2,2
10174,11364,0,0,7,7
10174,11365,4,1,6,11
10174,11366,0,1,1,2
10174,11367,1,1,9,11
10174,11368,5,9,9,23
10174,11369,4,1,6,11
10174,11370,1,3,4,8
10174,11372,4,7,11,22
10174,11373,10,12,15,37
10174,11374,2,1,11,14
10174,11375,2,4,31,37
10174,11377,4,10,31,45
10174,11378,2,5,10,17
10174,11379,0,5,12,17
10174,11385,4,10,22,36
10174,11411,3,1,4,8
10174,11412,1,5,1,7
10174,11413,5,4,7,16
10174,11414,1,0,9,10
10174,11415,0,4,9,13
10174,11416,0,1,2,3
10174,11417,0,4,2,6
10174,11418,2,4,5,11
10174,11419,2,2,9,13
10174,11420,2,4,9,15
10174,11421,2,3,5,10
10174,11422,2,4,5,11
10174,11423,0,2,5,7
10174,11426,1,1,3,5
10174,11427,1,3,2,6
10174,11428,2,2,6,10
10174,11429,2,3,2,7
10174,11432,3,7,6,16
10174,11433,1,5,3,9
10174,11434,4,3,3,10
10174,11435,3,10,11,24
10174,11436,2,2,0,4
10174,11691,4,7,6,17
10174,11692,0,1,5,6
10174,11693,0,2,3,5
10174,11694,1,1,1,3
10174,11697,0,0,1,1
10177,10001,0,0,10,10
10177,10002,3,3,13,19
10177,10003,2,0,20,22
10177,10004,0,0,1,1
10177,10005,0,0,2,2
10177,10006,0,0,1,1
10177,10007,0,0,5,5
10177,10009,1,4,12,17
10177,10010,0,0,12,12
10177,10011,2,1,21,24
10177,10012,0,1,7,8
10177,10013,1,0,11,12
10177,10014,1,0,15,16
10177,10016,3,1,36,40
10177,10017,1,1,20,22
10177,10018,0,1,3,4
10177,10019,0,2,16,18
10177,10021,0,2,23,25
10177,10022,0,0,22,22
10177,10023,0,2,25,27
10177,10024,2,3,27,32
10177,10025,2,2,21,25
10177,10026,0,0,1,1
10177,10027,0,1,4,5
10177,10028,0,0,23,23
10177,10029,1,0,9,10
10177,10030,0,2,2,4
10177,10031,2,4,5,11
10177,10032,2,1,3,6
10177,10033,1,1,3,5
10177,10034,0,4,2,6
10177,10035,4,1,5,10
10177,10036,2,0,17,19
10177,10037,0,3,4,7
10177,10038,0,0,9,9
10177,10039,0,1,5,6
10177,10040,1,1,4,6
10177,10044,0,0,2,2
10177,10065,1,3,12,16
10177,10069,0,0,3,3
10177,10075,0,2,8,10
10177,10128,1,0,24,25
10177,10162,0,0,1,1
10177,10280,0,0,5,5
10177,10282,0,0,1,1
10177,10301,0,0,1,1
10177,10302,0,0,1,1
10177,10303,1,0,2,3
10177,10304,1,1,2,4
10177,10305,0,0,7,7
10177,10306,1,1,3,5
10177,10307,0,0,2,2
10177,10308,0,0,2,2
10177,10309,0,1,2,3
10177,10310,0,2,2,4
10177,10312,0,1,1,2
10177,10314,0,2,6,8
10177,10451,0,3,4,7
10177,10452,2,3,2,7
10177,10453,2,1,1,4
10177,10454,2,1,1,4
10177,10455,0,2,1,3
10177,10456,0,0,4,4
10177,10457,1,2,0,3
10177,10458,1,2,8,11
10177,10459,0,1,0,1
10177,10460,0,3,0,3
10177,10461,3,2,4,9
10177,10462,1,3,8,12
10177,10463,1,1,7,9
10177,10465,0,1,8,9
10177,10466,0,1,10,11
10177,10467,2,2,3,7
10177,10468,2,2,7,11
10177,10469,2,2,3,7
10177,10471,0,0,2,2
10177,10472,1,3,4,8
10177,10473,2,2,3,7
10177,10474,1,0,0,1
10177,10475,0,0,2,2
10177,11004,0,0,2,2
10177,11101,1,0,10,11
10177,11102,3,0,7,10
10177,11103,0,4,9,13
10177,11104,0,1,9,10
10177,11105,0,1,9,10
10177,11106,0,2,11,13
10177,11109,0,0,2,2
10177,11201,1,1,25,27
10177,11203,1,1,3,5
10177,11204,0,0,5,5
10177,11205,2,0,4,6
10177,11206,0,3,9,12
10177,11207,3,0,2,5
10177,11208,0,2,4,6
10177,11209,0,1,8,9
10177,11210,0,1,8,9
10177,11211,1,2,20,23
10177,11212,2,2,4,8
10177,11213,0,2,2,4
10177,11214,1,0,3,4
10177,11215,4,0,18,22
10177,11216,0,0,5,5
10177,11217,0,1,14,15
10177,11218,0,1,12,13
10177,11219,1,2,4,7
10177,11220,0,2,3,5
10177,11221,2,3,10,15
10177,11222,0,0,11,11
10177,11223,1,0,7,8
10177,11224,2,0,3,5
10177,11225,1,1,9,11
10177,11226,2,2,13,17
10177,11228,0,0,6,6
10177,11229,2,2,5,9
10177,11230,1,1,7,9
10177,11231,0,1,6,7
10177,11232,0,2,5,7
10177,11233,0,3,3,6
10177,11234,0,2,13,15
10177,11235,0,1,9,10
10177,11236,1,3,5,9
10177,11237,1,4,6,11
10177,11238,0,4,8,12
10177,11239,0,1,0,1
10177,11354,0,0,5,5
10177,11355,0,2,5,7
10177,11356,0,0,2,2
10177,11357,0,1,2,3
10177,11358,1,0,4,5
10177,11360,0,0,3,3
10177,11361,2,1,4,7
10177,11362,0,0,2,2
10177,11363,0,0,2,2
10177,11364,0,0,6,6
10177,11365,1,0,2,3
10177,11366,0,0,2,2
10177,11367,1,2,2,5
10177,11368,2,4,4,10
10177,11369,0,0,1,1
10177,11370,0,0,3,3
10177,11372,1,3,11,15
10177,11373,0,1,13,14
10177,11374,1,2,15,18
10177,11375,0,2,18,20
10177,11377,3,1,5,9
10177,11378,0,1,1,2
10177,11379,1,0,7,8
10177,11385,0,5,7,12
10177,11411,0,0,1,1
10177,11412,0,0,2,2
10177,11413,1,0,4,5
10177,11414,0,1,5,6
10177,11415,0,0,4,4
10177,11416,0,0,1,1
10177,11417,0,3,1,4
10177,11418,1,2,6,9
10177,11419,0,1,4,5
10177,11420,0,5,0,5
10177,11421,3,1,6,10
10177,11422,1,0,1,2
10177,11423,2,1,2,5
10177,11426,0,1,3,4
10177,11427,0,1,1,2
10177,11428,0,1,1,2
10177,11429,0,0,1,1
10177,11432,1,2,4,7
10177,11433,0,1,2,3
10177,11434,1,0,1,2
10177,11435,0,1,5,6
10177,11436,0,0,2,2
10177,11691,0,1,1,2
10177,11692,1,0,2,3
10177,11693,1,1,0,2
10177,11694,0,0,1,1
10199,10001,0,2,0,2
10199,10009,0,0,1,1
10199,10011,0,1,1,2
10199,10028,0,0,1,1
10199,10040,1,0,0,1
10199,10306,0,0,1,1
10199,10309,0,0,1,1
10199,10314,1,0,0,1
10199,10451,0,1,0,1
10199,10452,0,1,0,1
10199,10454,0,0,1,1
10199,10458,0,1,0,1
10199,10462,0,1,0,1
10199,10465,0,1,0,1
10199,11005,0,1,0,1
10199,11206,0,0,1,1
10199,11214,0,0,1,1
10199,11220,0,1,0,1
10199,11226,0,1,0,1
10199,11354,0,0,1,1
10199,11358,0,1,0,1
10199,11373,0,1,0,1
10199,11418,0,0,1,1
10199,11427,0,0,1,1
10271,10001,0,1,13,14
10271,10002,7,8,29,44
10271,10003,0,2,21,23
10271,10004,2,0,10,12
10271,10005,1,4,14,19
10271,10006,0,0,5,5
10271,10007,0,0,4,4
10271,10009,4,2,22,28
10271,10010,2,2,22,26
10271,10011,2,2,27,31
10271,10012,1,0,11,12
10271,10013,2,4,14,20
10271,10014,0,3,17,20
10271,10016,1,1,28,30
10271,10017,0,0,5,5
10271,10018,0,0,2,2
10271,10019,5,2,28,35
10271,10021,0,1,11,12
10271,10022,0,0,16,16
10271,10023,4,0,21,25
10271,10024,4,0,27,31
10271,10025,7,6,34,47
10271,10026,1,2,11,14
10271,10027,3,3,15,21
10271,10028,0,2,22,24
10271,10029,4,7,13,24
10271,10030,3,0,10,13
10271,10031,4,5,14,23
10271,10032,0,3,3,6
10271,10033,1,2,15,18
10271,10034,2,5,9,16
10271,10035,1,3,3,7
10271,10036,0,1,9,10
10271,10037,0,1,6,7
10271,10038,2,5,20,27
10271,10039,2,3,6,11
10271,10040,1,6,7,14
10271,10044,1,1,6,8
10271,10065,2,1,14,17
10271,10075,0,4,7,11
10271,10128,3,3,22,28
10271,10162,0,0,2,2
10271,10280,1,2,3,6
10271,10282,0,1,3,4
10271,10301,6,2,19,27
10271,10302,1,1,5,7
10271,10303,6,0,9,15
10271,10304,1,2,16,19
10271,10305,4,3,11,18
10271,10306,4,7,35,46
10271,10307,0,2,7,9
10271,10308,4,1,10,15
10271,10309,2,1,16,19
10271,10310,1,2,8,11
10271,10312,4,5,29,38
10271,10314,2,2,36,40
10271,10451,1,6,6,13
10271,10452,2,6,16,24
10271,10453,5,11,5,21
10271,10454,4,5,0,9
10271,10455,1,1,6,8
10271,10456,5,7,13,25
10271,10457,4,2,7,13
10271,10458,2,2,5,9
10271,10459,1,5,3,9
10271,10460,2,6,8,16
10271,10461,1,2,9,12
10271,10462,4,6,11,21
10271,10463,2,4,10,16
10271,10464,1,0,1,2
10271,10465,2,1,8,11
10271,10466,3,0,9,12
10271,10467,3,2,11,16
10271,10468,5,3,9,17
10271,10469,4,2,7,13
10271,10470,0,0,6,6
10271,10471,2,1,7,10
10271,10472,2,4,10,16
10271,10473,4,4,14,22
10271,10474,0,0,1,1
10271,10475,3,3,7,13
10271,11004,1,0,4,5
10271,11040,1,0,0,1
10271,11101,1,3,13,17
10271,11102,0,1,15,16
10271,11103,2,3,8,13
10271,11104,5,1,12,18
10271,11105,3,3,8,14
10271,11106,4,3,15,22
10271,11109,0,0,3,3
10271,11201,3,7,55,65
10271,11203,6,7,17,30
10271,11204,0,1,20,21
10271,11205,0,3,12,15
10271,11206,9,7,19,35
10271,11207,2,5,13,20
10271,11208,9,10,15,34
10271,11209,1,4,25,30
10271,11210,5,2,15,22
10271,11211,5,13,34,52
10271,11212,11,16,15,42
10271,11213,6,7,15,28
10271,11214,3,8,19,30
10271,11215,1,2,64,67
10271,11216,3,2,20,25
10271,11217,3,2,21,26
10271,11218,3,6,26,35
10271,11219,2,5,7,14
10271,11220,1,6,17,24
10271,11221,6,7,20,33
10271,11222,1,2,12,15
10271,11223,4,3,13,20
10271,11224,5,10,9,24
10271,11225,6,4,14,24
10271,11226,6,9,27,42
10271,11228,4,0,16,20
10271,11229,3,9,35,47
10271,11230,1,11,17,29
10271,11231,0,2,22,24
10271,11232,1,1,7,9
10271,11233,2,8,17,27
10271,11234,3,8,30,41
10271,11235,11,7,21,39
10271,11236,5,7,27,39
10271,11237,2,4,10,16
10271,11238,2,1,24,27
10271,11239,1,3,2,6
10271,11354,1,1,9,11
10271,11355,3,5,12,20
10271,11356,1,2,6,9
10271,11357,1,0,16,17
10271,11358,1,1,6,8
10271,11360,2,0,3,5
10271,11361,0,0,3,3
10271,11362,0,1,2,3
10271,11363,1,0,2,3
10271,11364,1,0,9,10
10271,11365,2,3,6,11
10271,11366,1,1,3,5
10271,11367,2,3,8,13
10271,11368,5,2,13,20
10271,11369,0,0,8,8
10271,11370,1,3,3,7
10271,11372,2,4,13,19
10271,11373,12,8,20,40
10271,11374,4,2,20,26
10271,11375,2,5,43,50
10271,11377,2,8,15,25
10271,11378,4,4,12,20
10271,11379,0,2,20,22
10271,11385,4,10,18,32
10271,11411,1,0,2,3
10271,11412,2,5,14,21
10271,11413,0,1,8,9
10271,11414,2,1,7,10
10271,11415,0,0,5,5
10271,11416,0,2,4,6
10271,11417,4,1,6,11
10271,11418,0,3,6,9
10271,11419,1,10,6,17
10271,11420,1,5,15,21
10271,11421,4,1,8,13
10271,11422,0,1,12,13
10271,11423,2,4,6,12
10271,11426,0,1,2,3
10271,11427,0,1,3,4
10271,11428,0,1,1,2
10271,11429,1,0,7,8
10271,11432,6,5,9,20
10271,11433,2,2,5,9
10271,11434,7,9,15,31
10271,11435,3,4,13,20
10271,11436,1,2,6,9
10271,11691,2,4,6,12
10271,11692,0,2,3,5
10271,11693,1,0,6,7
10271,11694,1,1,7,9
10271,11697,0,0,2,2
10278,10001,0,1,0,1
10278,10002,0,2,0,2
10278,10005,0,1,0,1
10278,10009,0,0,1,1
10278,10010,0,1,1,2
10278,10011,0,1,0,1
10278,10013,0,0,1,1
10278,10014,0,1,0,1
10278,10016,0,0,1,1
10278,10019,0,0,1,1
10278,10021,0,0,1,1
10278,10024,0,0,3,3
10278,10025,0,2,1,3
10278,10027,0,1,0,1
10278,10028,0,0,1,1
10278,10029,0,0,2,2
10278,10030,1,0,0,1
10278,10031,0,1,0,1
10278,10032,0,0,1,1
10278,10033,0,1,0,1
10278,10034,0,0,2,2
10278,10035,0,1,0,1
10278,10038,0,2,1,3
10278,10039,0,0,2,2
10278,10075,0,1,0,1
10278,10301,0,1,1,2
10278,10306,0,0,1,1
10278,10307,0,0,1,1
10278,10310,0,1,0,1
10278,10312,0,1,1,2
10278,10314,0,1,2,3
10278,10451,1,0,0,1
10278,10452,0,4,0,4
10278,10453,1,1,0,2
10278,10454,0,0,1,1
10278,10456,0,1,0,1
10278,10458,0,0,1,1
10278,10459,0,3,0,3
10278,10460,0,1,0,1
10278,10461,0,0,1,1
10278,10465,0,1,0,1
10278,10469,0,1,0,1
10278,10471,0,0,1,1
10278,10475,0,1,0,1
10278,11004,0,1,0,1
10278,11005,0,1,0,1
10278,11102,0,0,1,1
10278,11103,0,0,1,1
10278,11104,0,0,1,1
10278,11105,0,1,0,1
10278,11106,0,1,1,2
10278,11201,0,1,2,3
10278,11203,0,4,0,4
10278,11204,0,1,1,2
10278,11205,0,0,1,1
10278,11206,0,2,1,3
10278,11207,0,1,3,4
10278,11208,0,4,0,4
10278,11209,0,2,1,3
10278,11211,0,2,0,2
10278,11213,0,0,1,1
10278,11214,1,2,0,3
10278,11215,0,0,2,2
10278,11216,0,1,1,2
10278,11218,0,2,1,3
10278,11221,0,2,1,3
10278,11222,0,1,0,1
10278,11223,0,1,0,1
10278,11224,0,1,0,1
10278,11225,0,0,1,1
10278,11226,0,3,3,6
10278,11228,0,0,1,1
10278,11229,1,2,0,3
10278,11231,0,1,0,1
10278,11233,0,2,0,2
10278,11234,0,1,1,2
10278,11235,0,1,0,1
10278,11236,0,1,1,2
10278,11237,0,2,0,2
10278,11238,0,1,0,1
10278,11354,0,1,1,2
10278,11358,0,1,0,1
10278,11365,0,1,0,1
10278,11367,1,1,0,2
10278,11368,0,1,1,2
10278,11369,0,1,0,1
10278,11370,0,0,1,1
10278,11371,0,1,0,1
10278,11373,0,1,0,1
10278,11374,0,0,1,1
10278,11377,0,0,1,1
10278,11379,0,1,1,2
10278,11385,0,0,2,2
10278,11411,1,0,1,2
10278,11412,0,1,0,1
10278,11413,0,0,1,1
10278,11415,0,0,2,2
10278,11416,0,1,0,1
10278,11417,0,1,0,1
10278,11418,0,1,0,1
10278,11422,0,1,1,2
10278,11427,1,0,0,1
10278,11429,0,1,1,2
10278,11432,0,3,0,3
10278,11434,0,0,1,1
10278,11435,0,1,0,1
10278,11692,0,1,1,2
10279,10001,0,1,5,6
10279,10002,2,3,24,29
10279,10003,0,2,26,28
10279,10004,0,1,9,10
10279,10005,0,0,9,9
10279,10006,0,0,2,2
10279,10007,1,1,11,13
10279,10009,5,3,12,20
10279,10010,0,2,20,22
10279,10011,0,0,27,27
10279,10012,0,1,12,13
10279,10013,2,1,22,25
10279,10014,2,0,19,21
10279,10016,0,1,32,33
10279,10017,0,0,8,8
10279,10018,0,0,1,1
10279,10019,0,1,22,23
10279,10021,1,0,19,20
10279,10022,0,2,18,20
10279,10023,1,3,23,27
10279,10024,0,0,25,25
10279,10025,2,2,28,32
10279,10026,0,1,8,9
10279,10027,0,2,18,20
10279,10028,0,2,22,24
10279,10029,2,6,18,26
10279,10030,2,2,1,5
10279,10031,1,5,11,17
10279,10032,0,2,4,6
10279,10033,1,6,11,18
10279,10034,0,5,7,12
10279,10035,0,0,8,8
10279,10036,0,0,12,12
10279,10037,0,1,6,7
10279,10038,2,2,19,23
10279,10039,0,2,4,6
10279,10040,2,4,4,10
10279,10044,0,0,2,2
10279,10065,0,1,13,14
10279,10069,0,0,5,5
10279,10075,0,0,8,8
10279,10128,0,5,22,27
10279,10280,1,0,17,18
10279,10282,0,2,4,6
10279,10301,0,2,9,11
10279,10302,1,0,3,4
10279,10303,1,2,0,3
10279,10304,0,3,5,8
10279,10305,1,1,13,15
10279,10306,1,1,18,20
10279,10307,0,1,3,4
10279,10308,0,0,7,7
10279,10309,2,0,11,13
10279,10310,0,0,7,7
10279,10312,0,3,19,22
10279,10314,4,2,36,42
10279,10451,0,5,0,5
10279,10452,1,4,5,10
10279,10453,1,9,6,16
10279,10454,1,2,1,4
10279,10455,0,4,2,6
10279,10456,1,5,9,15
10279,10457,0,5,2,7
10279,10458,1,4,4,9
10279,10459,2,7,1,10
10279,10460,2,2,2,6
10279,10461,0,1,4,5
10279,10462,0,1,7,8
10279,10463,0,2,11,13
10279,10464,0,1,2,3
10279,10465,1,2,4,7
10279,10466,0,2,5,7
10279,10467,1,1,9,11
10279,10468,3,5,7,15
10279,10469,1,1,8,10
10279,10470,1,2,3,6
10279,10471,1,0,5,6
10279,10472,0,2,7,9
10279,10473,0,2,2,4
10279,10474,0,0,2,2
10279,10475,0,1,5,6
10279,11004,0,1,3,4
10279,11040,0,0,1,1
10279,11101,3,1,16,20
10279,11102,0,2,11,13
10279,11103,1,2,12,15
10279,11104,0,1,10,11
10279,11105,0,2,17,19
10279,11106,1,6,10,17
10279,11109,0,0,4,4
10279,11201,0,3,42,45
10279,11203,1,3,14,18
10279,11204,1,2,15,18
10279,11205,0,1,14,15
10279,11206,1,10,17,28
10279,11207,4,7,16,27
10279,11208,1,8,7,16
10279,11209,3,4,34,41
10279,11210,2,0,9,11
10279,11211,2,2,50,54
10279,11212,1,6,9,16
10279,11213,1,0,8,9
10279,11214,2,2,23,27
10279,11215,3,3,46,52
10279,11216,2,1,21,24
10279,11217,0,1,22,23
10279,11218,2,3,18,23
10279,11219,1,1,14,16
10279,11220,2,5,16,23
10279,11221,2,4,12,18
10279,11222,0,1,30,31
10279,11223,3,4,17,24
10279,11224,1,2,6,9
10279,11225,1,3,16,20
10279,11226,2,3,15,20
10279,11228,0,2,14,16
10279,11229,1,0,20,21
10279,11230,1,4,20,25
10279,11231,0,3,21,24
10279,11232,0,0,10,10
10279,11233,2,6,13,21
10279,11234,4,3,18,25
10279,11235,2,3,25,30
10279,11236,2,7,17,26
10279,11237,1,4,15,20
10279,11238,0,2,37,39
10279,11239,0,0,4,4
10279,11354,0,2,9,11
10279,11355,0,0,9,9
10279,11356,0,0,6,6
10279,11357,0,1,7,8
10279,11358,0,0,13,13
10279,11360,0,0,5,5
10279,11361,0,0,2,2
10279,11362,1,0,3,4
10279,11364,0,1,14,15
10279,11365,0,0,7,7
10279,11366,0,0,2,2
10279,11367,0,1,10,11
10279,11368,2,2,3,7
10279,11369,0,5,6,11
10279,11370,0,2,5,7
10279,11372,1,5,16,22
10279,11373,3,9,19,31
10279,11374,2,3,11,16
10279,11375,1,1,33,35
10279,11377,2,7,16,25
10279,11378,1,2,6,9
10279,11379,1,0,8,9
10279,11385,3,3,19,25
10279,11411,0,0,1,1
10279,11412,0,0,1,1
10279,11413,0,1,2,3
10279,11414,0,1,5,6
10279,11415,1,1,6,8
10279,11416,1,1,5,7
10279,11417,0,0,6,6
10279,11418,0,2,4,6
10279,11419,0,3,6,9
10279,11420,0,1,0,1
10279,11421,0,4,5,9
10279,11422,0,0,2,2
10279,11423,1,2,4,7
10279,11426,0,0,5,5
10279,11427,0,0,4,4
10279,11428,0,0,1,1
10279,11429,0,1,4,5
10279,11432,1,0,12,13
10279,11433,0,1,4,5
10279,11434,1,1,4,6
10279,11435,1,1,4,6
10279,11436,0,1,1,2
10279,11691,1,0,8,9
10279,11692,0,1,1,2
10279,11693,0,2,2,4
10279,11694,0,0,5,5
10279,11697,0,1,0,1
10280,10001,3,7,36,46
10280,10002,9,3,38,50
10280,10003,3,5,73,81
10280,10004,1,7,41,49
10280,10005,2,0,44,46
10280,10006,0,0,24,24
10280,10007,0,1,48,49
10280,10009,3,9,45,57
10280,10010,3,1,48,52
10280,10011,3,4,97,104
10280,10012,3,3,46,52
10280,10013,1,5,76,82
10280,10014,3,2,104,109
10280,10016,6,3,66,75
10280,10017,1,3,22,26
10280,10018,1,0,15,16
10280,10019,4,2,68,74
10280,10021,2,3,43,48
10280,10022,0,2,33,35
10280,10023,4,2,113,119
10280,10024,1,4,82,87
10280,10025,4,8,84,96
10280,10026,2,1,17,20
10280,10027,2,7,10,19
10280,10028,4,1,48,53
10280,10029,3,4,17,24
10280,10030,0,0,8,8
10280,10031,4,5,10,19
10280,10032,3,11,6,20
10280,10033,5,7,11,23
10280,10034,1,16,9,26
10280,10035,5,8,4,17
10280,10036,0,3,28,31
10280,10037,2,0,7,9
10280,10038,4,3,78,85
10280,10039,4,1,8,13
10280,10040,2,1,7,10
10280,10044,1,0,1,2
10280,10065,0,3,31,34
10280,10069,0,0,6,6
10280,10075,3,2,33,38
10280,10128,6,5,50,61
10280,10162,0,0,1,1
10280,10280,5,7,144,156
10280,10282,3,4,36,43
10280,10301,2,15,19,36
10280,10302,1,1,3,5
10280,10303,0,1,4,5
10280,10304,4,6,10,20
10280,10305,1,1,22,24
10280,10306,1,5,25,31
10280,10307,0,1,5,6
10280,10308,1,4,19,24
10280,10309,0,1,3,4
10280,10310,1,3,5,9
10280,10312,2,7,24,33
10280,10314,0,11,32,43
10280,10451,3,6,8,17
10280,10452,6,13,13,32
10280,10453,8,9,8,25
10280,10454,1,4,1,6
10280,10455,2,6,8,16
10280,10456,4,18,9,31
10280,10457,4,13,11,28
10280,10458,2,7,6,15
10280,10459,5,8,4,17
10280,10460,2,7,10,19
10280,10461,3,3,10,16
10280,10462,4,6,10,20
10280,10463,1,10,15,26
10280,10464,1,3,0,4
10280,10465,1,2,1,4
10280,10466,1,5,5,11
10280,10467,2,5,9,16
10280,10468,2,7,7,16
10280,10469,3,9,10,22
10280,10470,1,0,3,4
10280,10471,1,4,3,8
10280,10472,3,9,2,14
10280,10473,2,4,7,13
10280,10474,0,2,2,4
10280,10475,2,2,7,11
10280,11001,0,1,0,1
10280,11040,0,0,1,1
10280,11101,2,5,15,22
10280,11102,2,5,10,17
10280,11103,1,6,18,25
10280,11104,3,3,9,15
10280,11105,4,2,20,26
10280,11106,2,4,11,17
10280,11109,0,0,7,7
10280,11201,4,4,87,95
10280,11203,3,14,19,36
10280,11204,1,5,17,23
10280,11205,3,2,13,18
10280,11206,5,9,14,28
10280,11207,4,22,9,35
10280,11208,6,8,6,20
10280,11209,4,3,30,37
10280,11210,2,4,19,25
10280,11211,4,6,55,65
10280,11212,5,10,12,27
10280,11213,7,8,13,28
10280,11214,5,7,24,36
10280,11215,3,5,58,66
10280,11216,6,4,21,31
10280,11217,3,3,49,55
10280,11218,1,6,23,30
10280,11219,4,5,9,18
10280,11220,5,4,18,27
10280,11221,2,7,17,26
10280,11222,1,3,12,16
10280,11223,3,4,14,21
10280,11224,6,2,7,15
10280,11225,7,9,19,35
10280,11226,6,17,32,55
10280,11228,3,5,14,22
10280,11229,1,6,23,30
10280,11230,3,4,18,25
10280,11231,1,4,32,37
10280,11232,0,1,4,5
10280,11233,8,12,7,27
10280,11234,4,8,13,25
10280,11235,2,3,19,24
10280,11236,5,9,24,38
10280,11237,3,8,7,18
10280,11238,2,2,35,39
10280,11239,1,1,3,5
10280,11354,1,1,7,9
10280,11355,7,5,10,22
10280,11356,0,2,3,5
10280,11357,3,1,8,12
10280,11358,0,3,9,12
10280,11360,1,2,6,9
10280,11361,1,0,8,9
10280,11362,0,2,5,7
10280,11363,0,0,2,2
10280,11364,0,0,6,6
10280,11365,2,1,4,7
10280,11366,0,6,3,9
10280,11367,1,3,10,14
10280,11368,3,14,13,30
10280,11369,1,2,5,8
10280,11370,1,2,7,10
10280,11372,5,11,15,31
10280,11373,4,8,13,25
10280,11374,1,2,9,12
10280,11375,4,8,40,52
10280,11377,4,9,35,48
10280,11378,3,4,4,11
10280,11379,2,5,14,21
10280,11385,4,7,39,50
10280,11411,0,2,5,7
10280,11412,0,10,7,17
10280,11413,1,7,9,17
10280,11414,0,0,8,8
10280,11415,1,3,4,8
10280,11416,2,8,6,16
10280,11417,0,2,9,11
10280,11418,0,5,11,16
10280,11419,1,6,9,16
10280,11420,2,2,9,13
10280,11421,2,4,10,16
10280,11422,0,2,12,14
10280,11423,1,1,5,7
10280,11426,0,2,5,7
10280,11427,0,1,8,9
10280,11428,0,4,3,7
10280,11429,2,1,4,7
10280,11432,3,2,13,18
10280,11433,0,8,6,14
10280,11434,2,5,4,11
10280,11435,2,5,10,17
10280,11436,0,1,2,3
10280,11691,1,0,8,9
10280,11692,0,3,0,3
10280,11693,0,0,2,2
10280,11694,1,1,7,9
10280,11697,0,0,8,8
10282,10001,7,1,71,79
10282,10002,13,6,71,90
10282,10003,3,6,160,169
10282,10004,4,1,81,86
10282,10005,5,0,112,117
10282,10006,0,2,61,63
10282,10007,2,1,108,111
10282,10009,6,7,76,89
10282,10010,1,9,87,97
10282,10011,8,3,283,294
10282,10012,5,5,112,122
10282,10013,11,3,202,216
10282,10014,7,6,219,232
10282,10016,5,3,144,152
10282,10017,4,4,44,52
10282,10018,5,2,22,29
10282,10019,8,3,132,143
10282,10021,6,3,82,91
10282,10022,4,3,61,68
10282,10023,12,4,175,191
10282,10024,6,7,146,159
10282,10025,7,12,156,175
10282,10026,3,9,31,43
10282,10027,5,8,41,54
10282,10028,15,4,77,96
10282,10029,5,15,42,62
10282,10030,0,5,9,14
10282,10031,3,10,27,40
10282,10032,2,14,28,44
10282,10033,6,13,26,45
10282,10034,0,9,22,31
10282,10035,1,6,11,18
10282,10036,5,3,77,85
10282,10037,5,4,9,18
10282,10038,3,2,189,194
10282,10039,3,7,11,21
10282,10040,3,8,13,24
10282,10044,4,0,5,9
10282,10065,4,5,50,59
10282,10069,1,0,15,16
10282,10075,3,0,65,68
10282,10128,5,7,125,137
10282,10162,0,0,3,3
10282,10280,4,3,254,261
10282,10282,6,2,87,95
10282,10301,3,3,20,26
10282,10302,2,3,3,8
10282,10303,0,3,2,5
10282,10304,2,7,17,26
10282,10305,2,1,27,30
10282,10306,2,3,39,44
10282,10307,2,0,22,24
10282,10308,0,1,38,39
10282,10309,0,0,22,22
10282,10310,2,0,8,10
10282,10312,2,3,50,55
10282,10314,5,10,39,54
10282,10451,6,6,8,20
10282,10452,5,16,10,31
10282,10453,3,7,9,19
10282,10454,2,3,5,10
10282,10455,11,10,6,27
10282,10456,4,11,10,25
10282,10457,4,9,8,21
10282,10458,7,7,6,20
10282,10459,0,7,2,9
10282,10460,1,17,12,30
10282,10461,3,9,12,24
10282,10462,2,9,18,29
10282,10463,2,5,26,33
10282,10465,1,3,13,17
10282,10466,6,5,5,16
10282,10467,4,7,13,24
10282,10468,3,6,13,22
10282,10469,4,12,10,26
10282,10470,2,2,0,4
10282,10471,0,1,8,9
10282,10472,4,13,10,27
10282,10473,5,8,17,30
10282,10474,1,0,5,6
10282,10475,1,3,9,13
10282,11004,0,0,6,6
10282,11040,1,0,1,2
10282,11101,5,5,53,63
10282,11102,5,0,20,25
10282,11103,10,2,28,40
10282,11104,6,1,15,22
10282,11105,3,9,26,38
10282,11106,1,9,33,43
10282,11109,0,0,19,19
10282,11201,10,1,187,198
10282,11203,3,8,23,34
10282,11204,3,3,20,26
10282,11205,6,3,25,34
10282,11206,8,9,23,40
10282,11207,3,11,19,33
10282,11208,2,17,15,34
10282,11209,5,15,63,83
10282,11210,4,8,20,32
10282,11211,2,11,103,116
10282,11212,8,17,27,52
10282,11213,7,12,15,34
10282,11214,8,15,33,56
10282,11215,6,8,114,128
10282,11216,3,9,28,40
10282,11217,6,6,114,126
10282,11218,6,6,45,57
10282,11219,3,10,11,24
10282,11220,6,8,26,40
10282,11221,3,9,23,35
10282,11222,5,2,17,24
10282,11223,1,5,25,31
10282,11224,3,2,6,11
10282,11225,1,11,45,57
10282,11226,6,15,45,66
10282,11228,3,5,33,41
10282,11229,4,8,35,47
10282,11230,10,3,30,43
10282,11231,0,4,34,38
10282,11232,0,6,9,15
10282,11233,7,12,29,48
10282,11234,7,4,27,38
10282,11235,3,3,43,49
10282,11236,7,13,27,47
10282,11237,8,10,14,32
10282,11238,6,4,61,71
10282,11239,0,0,2,2
10282,11354,2,6,14,22
10282,11355,3,2,24,29
10282,11356,2,2,4,8
10282,11357,1,3,17,21
10282,11358,3,4,17,24
10282,11359,0,0,2,2
10282,11360,0,0,10,10
10282,11361,1,2,8,11
10282,11362,0,1,3,4
10282,11364,0,2,15,17
10282,11365,2,0,12,14
10282,11366,2,5,6,13
10282,11367,1,3,8,12
10282,11368,2,5,22,29
10282,11369,0,5,11,16
10282,11370,2,2,14,18
10282,11372,1,19,32,52
10282,11373,4,13,21,38
10282,11374,1,2,29,32
10282,11375,1,8,74,83
10282,11377,3,15,42,60
10282,11378,2,6,17,25
10282,11379,1,2,21,24
10282,11385,5,15,46,66
10282,11411,0,2,5,7
10282,11412,2,6,8,16
10282,11413,5,4,11,20
10282,11414,2,0,15,17
10282,11415,6,6,7,19
10282,11416,1,8,8,17
10282,11417,1,6,17,24
10282,11418,3,12,14,29
10282,11419,2,6,11,19
10282,11420,2,8,7,17
10282,11421,2,5,15,22
10282,11422,2,4,7,13
10282,11423,0,6,5,11
10282,11426,0,1,7,8
10282,11427,1,1,3,5
10282,11428,0,2,6,8
10282,11429,3,1,5,9
10282,11430,0,0,1,1
10282,11432,2,3,11,16
10282,11433,0,5,4,9
10282,11434,4,3,15,22
10282,11435,2,5,16,23
10282,11436,1,0,3,4
10282,11691,1,5,3,9
10282,11692,0,2,6,8
10282,11693,0,2,0,2
10282,11694,0,1,12,13
10282,11697,0,1,7,8
10301,10001,0,0,3,3
10301,10002,7,7,16,30
10301,10003,3,4,7,14
10301,10004,1,2,3,6
10301,10007,1,1,0,2
10301,10009,1,3,12,16
10301,10010,1,0,5,6
10301,10011,1,3,2,6
10301,10012,2,3,8,13
10301,10013,1,2,7,10
10301,10014,2,2,14,18
10301,10016,1,1,5,7
10301,10017,1,1,2,4
10301,10018,1,0,3,4
10301,10019,3,2,3,8
10301,10021,0,1,4,5
10301,10022,0,0,1,1
10301,10023,1,0,3,4
10301,10024,0,1,5,6
10301,10025,3,4,9,16
10301,10026,1,2,8,11
10301,10027,3,1,11,15
10301,10028,1,1,6,8
10301,10029,4,3,8,15
10301,10030,1,4,7,12
10301,10031,1,4,7,12
10301,10032,0,6,6,12
10301,10033,0,3,11,14
10301,10034,1,3,7,11
10301,10035,4,4,2,10
10301,10036,0,0,2,2
10301,10037,0,3,1,4
10301,10038,4,1,2,7
10301,10039,0,3,3,6
10301,10040,1,0,4,5
10301,10065,0,1,6,7
10301,10075,0,1,3,4
10301,10128,1,1,3,5
10301,10280,0,0,3,3
10301,10301,213,281,212,706
10301,10302,40,100,76,216
10301,10303,79,151,78,308
10301,10304,123,208,130,461
10301,10305,75,104,82,261
10301,10306,81,88,129,298
10301,10307,18,15,36,69
10301,10308,38,51,57,146
10301,10309,42,36,82,160
10301,10310,93,163,106,362
10301,10312,72,98,162,332
10301,10314,180,275,272,727
10301,10451,1,3,2,6
10301,10452,2,6,5,13
10301,10453,3,5,7,15
10301,10454,3,1,2,6
10301,10455,2,3,6,11
10301,10456,7,7,8,22
10301,10457,3,5,3,11
10301,10458,0,5,6,11
10301,10459,4,5,6,15
10301,10460,4,2,4,10
10301,10461,2,5,7,14
10301,10462,3,4,7,14
10301,10463,4,4,10,18
10301,10464,0,0,1,1
10301,10465,5,4,5,14
10301,10466,3,3,4,10
10301,10467,3,10,7,20
10301,10468,4,4,10,18
10301,10469,3,2,8,13
10301,10470,2,0,1,3
10301,10471,1,0,1,2
10301,10472,2,6,7,15
10301,10473,3,3,3,9
10301,10474,0,1,3,4
10301,10475,3,2,6,11
10301,11004,0,2,5,7
10301,11005,1,0,0,1
10301,11040,0,1,0,1
10301,11101,0,1,4,5
10301,11102,1,1,3,5
10301,11103,1,0,4,5
10301,11104,0,2,4,6
10301,11105,1,1,5,7
10301,11106,1,0,1,2
10301,11109,0,0,1,1
10301,11201,12,16,18,46
10301,11203,12,13,33,58
10301,11204,8,17,25,50
10301,11205,2,13,12,27
10301,11206,5,8,11,24
10301,11207,3,5,19,27
10301,11208,3,11,12,26
10301,11209,18,23,59,100
10301,11210,11,16,29,56
10301,11211,5,8,14,27
10301,11212,6,10,17,33
10301,11213,2,13,22,37
10301,11214,18,13,24,55
10301,11215,16,12,34,62
10301,11216,3,7,17,27
10301,11217,3,4,21,28
10301,11218,8,17,40,65
10301,11219,18,17,17,52
10301,11220,20,16,27,63
10301,11221,1,14,20,35
10301,11222,3,3,2,8
10301,11223,5,16,31,52
10301,11224,4,15,36,55
10301,11225,4,6,15,25
10301,11226,11,21,30,62
10301,11228,10,22,30,62
10301,11229,6,10,28,44
10301,11230,12,18,30,60
10301,11231,5,2,17,24
10301,11232,3,8,9,20
10301,11233,7,6,12,25
10301,11234,16,31,51,98
10301,11235,9,12,29,50
10301,11236,25,19,29,73
10301,11237,3,4,5,12
10301,11238,4,10,17,31
10301,11239,0,0,1,1
10301,11354,5,2,6,13
10301,11355,3,0,8,11
10301,11356,0,3,3,6
10301,11357,2,3,3,8
10301,11358,6,2,1,9
10301,11361,1,0,4,5
10301,11362,0,0,1,1
10301,11364,0,2,1,3
10301,11365,0,1,3,4
10301,11366,0,0,2,2
10301,11367,1,2,7,10
10301,11368,7,5,3,15
10301,11369,1,2,4,7
10301,11370,1,2,6,9
10301,11372,2,3,4,9
10301,11373,5,7,11,23
10301,11374,1,4,8,13
10301,11375,0,0,13,13
10301,11377,9,0,7,16
10301,11378,1,0,7,8
10301,11379,1,1,4,6
10301,11385,3,10,14,27
10301,11411,0,1,1,2
10301,11412,1,2,7,10
10301,11413,2,1,10,13
10301,11414,2,3,8,13
10301,11415,0,3,1,4
10301,11416,0,1,2,3
10301,11417,2,1,10,13
10301,11418,0,0,5,5
10301,11419,2,6,7,15
10301,11420,4,3,5,12
10301,11421,1,4,3,8
10301,11422,1,3,7,11
10301,11423,0,2,5,7
10301,11426,0,1,3,4
10301,11427,0,2,6,8
10301,11428,1,2,1,4
10301,11429,2,2,3,7
10301,11432,2,4,12,18
10301,11433,3,4,6,13
10301,11434,1,3,6,10
10301,11435,2,2,9,13
10301,11436,1,0,2,3
10301,11691,1,4,13,18
10301,11692,2,2,4,8
10301,11693,0,0,4,4
10301,11694,4,2,8,14
10301,11697,0,0,1,1
10302,10001,0,0,3,3
10302,10002,4,4,1,9
10302,10003,1,4,2,7
10302,10004,0,0,3,3
10302,10006,0,0,2,2
10302,10007,0,1,0,1
10302,10009,1,3,3,7
10302,10010,0,0,2,2
10302,10011,1,3,3,7
10302,10012,1,0,0,1
10302,10013,0,2,0,2
10302,10014,0,1,0,1
10302,10016,0,1,2,3
10302,10019,0,1,0,1
10302,10021,0,0,2,2
10302,10022,0,0,1,1
10302,10023,1,0,2,3
10302,10024,0,0,1,1
10302,10025,2,3,6,11
10302,10026,3,5,0,8
10302,10027,0,2,6,8
10302,10028,1,0,2,3
10302,10029,2,4,6,12
10302,10030,0,5,0,5
10302,10031,0,2,4,6
10302,10032,0,1,5,6
10302,10033,0,2,2,4
10302,10034,0,4,3,7
10302,10035,2,3,2,7
10302,10036,1,0,0,1
10302,10037,0,3,0,3
10302,10039,1,4,2,7
10302,10040,0,1,1,2
10302,10044,0,1,1,2
10302,10065,0,0,1,1
10302,10075,0,0,1,1
10302,10128,0,2,3,5
10302,10301,38,57,60,155
10302,10302,77,97,46,220
10302,10303,43,60,52,155
10302,10304,42,45,47,134
10302,10305,28,24,27,79
10302,10306,30,48,64,142
10302,10307,12,17,32,61
10302,10308,17,19,26,62
10302,10309,34,14,40,88
10302,10310,45,86,56,187
10302,10312,23,52,103,178
10302,10314,112,145,78,335
10302,10451,3,4,1,8
10302,10452,6,1,4,11
10302,10453,3,9,4,16
10302,10454,0,3,1,4
10302,10455,3,0,1,4
10302,10456,4,4,2,10
10302,10457,0,10,2,12
10302,10458,2,7,3,12
10302,10459,0,5,1,6
10302,10460,2,2,1,5
10302,10461,1,1,2,4
10302,10462,4,7,5,16
10302,10463,2,4,4,10
10302,10465,2,1,2,5
10302,10466,2,7,2,11
10302,10467,7,5,7,19
10302,10468,0,2,3,5
10302,10469,5,7,2,14
10302,10470,1,4,1,6
10302,10471,1,0,1,2
10302,10472,5,2,2,9
10302,10473,0,7,3,10
10302,10474,0,0,1,1
10302,10475,3,3,1,7
10302,11001,0,0,1,1
10302,11004,1,1,1,3
10302,11101,0,1,1,2
10302,11102,1,3,1,5
10302,11103,0,0,4,4
10302,11104,0,1,2,3
10302,11105,0,1,1,2
10302,11106,0,1,2,3
10302,11201,1,0,4,5
10302,11203,1,13,10,24
10302,11204,9,3,6,18
10302,11205,1,2,3,6
10302,11206,2,2,4,8
10302,11207,4,7,6,17
10302,11208,7,2,4,13
10302,11209,14,6,25,45
10302,11210,2,2,10,14
10302,11211,3,2,4,9
10302,11212,4,10,6,20
10302,11213,1,3,6,10
10302,11214,7,5,7,19
10302,11215,2,11,12,25
10302,11216,0,7,1,8
10302,11217,0,2,2,4
10302,11218,9,12,5,26
10302,11219,10,7,2,19
10302,11220,31,25,5,61
10302,11221,1,3,3,7
10302,11222,0,1,0,1
10302,11223,7,7,4,18
10302,11224,3,3,4,10
10302,11225,3,6,10,19
10302,11226,4,16,7,27
10302,11228,10,8,8,26
10302,11229,1,3,4,8
10302,11230,2,4,8,14
10302,11231,3,5,4,12
10302,11232,3,3,5,11
10302,11233,4,7,5,16
10302,11234,4,6,6,16
10302,11235,3,6,6,15
10302,11236,2,2,8,12
10302,11237,0,2,2,4
10302,11238,1,3,3,7
10302,11239,1,0,0,1
10302,11354,1,0,2,3
10302,11355,0,2,2,4
10302,11356,1,1,0,2
10302,11357,0,0,1,1
10302,11358,2,3,1,6
10302,11360,2,0,2,4
10302,11361,2,1,1,4
10302,11362,0,1,4,5
10302,11363,1,0,0,1
10302,11364,3,0,1,4
10302,11365,2,1,5,8
10302,11366,0,1,0,1
10302,11367,1,1,2,4
10302,11368,0,2,2,4
10302,11369,0,2,0,2
10302,11370,0,3,3,6
10302,11372,0,1,2,3
10302,11373,2,3,0,5
10302,11374,1,0,2,3
10302,11375,3,1,1,5
10302,11377,3,0,9,12
10302,11378,1,3,2,6
10302,11379,2,2,4,8
10302,11385,4,4,6,14
10302,11411,1,0,3,4
10302,11412,1,2,3,6
10302,11413,0,1,4,5
10302,11414,1,3,6,10
10302,11415,0,1,0,1
10302,11416,1,2,2,5
10302,11417,1,2,3,6
10302,11418,2,0,2,4
10302,11419,1,0,4,5
10302,11420,0,1,4,5
10302,11421,3,0,1,4
10302,11422,0,0,2,2
10302,11423,2,0,1,3
10302,11426,1,3,6,10
10302,11427,1,3,2,6
10302,11428,0,2,0,2
10302,11429,0,0,3,3
10302,11432,3,3,4,10
10302,11433,2,0,0,2
10302,11434,0,3,2,5
10302,11435,1,0,2,3
10302,11436,0,1,0,1
10302,11691,3,3,6,12
10302,11692,1,0,0,1
10302,11693,0,0,1,1
10302,11694,0,1,2,3
10302,11697,0,1,0,1
10303,10001,0,0,2,2
10303,10002,4,2,7,13
10303,10003,0,0,5,5
10303,10004,0,1,1,2
10303,10005,1,1,0,2
10303,10007,0,0,2,2
10303,10009,2,0,4,6
10303,10010,0,0,4,4
10303,10011,1,3,4,8
10303,10012,0,0,1,1
10303,10013,1,2,0,3
10303,10014,0,1,2,3
10303,10016,0,0,2,2
10303,10019,1,2,4,7
10303,10021,0,0,2,2
10303,10022,1,0,2,3
10303,10023,1,1,0,2
10303,10024,1,2,1,4
10303,10025,1,6,3,10
10303,10026,1,2,3,6
10303,10027,6,4,6,16
10303,10028,0,0,1,1
10303,10029,2,5,10,17
10303,10030,1,2,5,8
10303,10031,1,4,4,9
10303,10032,1,3,5,9
10303,10033,2,4,3,9
10303,10034,1,1,0,2
10303,10035,1,2,4,7
10303,10036,0,0,5,5
10303,10037,1,0,1,2
10303,10038,2,1,3,6
10303,10039,1,3,3,7
10303,10040,1,2,5,8
10303,10065,0,0,1,1
10303,10069,0,0,1,1
10303,10128,0,1,3,4
10303,10280,1,0,1,2
10303,10282,1,0,0,1
10303,10301,60,69,65,194
10303,10302,48,42,50,140
10303,10303,171,188,75,434
10303,10304,64,87,69,220
10303,10305,49,43,73,165
10303,10306,68,81,102,251
10303,10307,26,16,41,83
10303,10308,49,33,48,130
10303,10309,26,40,79,145
10303,10310,58,69,71,198
10303,10312,71,87,184,342
10303,10314,156,175,201,532
10303,10451,4,2,0,6
10303,10452,2,4,2,8
10303,10453,3,2,3,8
10303,10454,0,1,3,4
10303,10455,0,1,2,3
10303,10456,6,4,3,13
10303,10457,0,5,4,9
10303,10458,5,4,3,12
10303,10459,2,3,3,8
10303,10460,2,0,5,7
10303,10461,2,2,6,10
10303,10462,1,2,7,10
10303,10463,1,0,7,8
10303,10464,0,1,0,1
10303,10465,2,3,6,11
10303,10466,4,6,5,15
10303,10467,8,2,5,15
10303,10468,6,3,3,12
10303,10469,4,2,6,12
10303,10470,0,0,1,1
10303,10471,1,0,1,2
10303,10472,3,4,3,10
10303,10473,1,1,4,6
10303,10474,1,1,3,5
10303,10475,2,1,3,6
10303,11004,0,1,1,2
10303,11101,2,2,4,8
10303,11102,1,3,3,7
10303,11103,4,2,1,7
10303,11104,1,2,0,3
10303,11105,1,1,3,5
10303,11106,3,3,4,10
10303,11201,3,3,9,15
10303,11203,5,5,17,27
10303,11204,11,7,6,24
10303,11205,2,0,3,5
10303,11206,2,3,7,12
10303,11207,3,10,8,21
10303,11208,4,4,7,15
10303,11209,8,14,44,66
10303,11210,4,5,6,15
10303,11211,1,0,4,5
10303,11212,8,9,9,26
10303,11213,4,9,5,18
10303,11214,16,7,14,37
10303,11215,2,1,13,16
10303,11216,2,4,6,12
10303,11217,2,1,3,6
10303,11218,2,5,8,15
10303,11219,5,7,10,22
10303,11220,12,12,15,39
10303,11221,5,2,4,11
10303,11222,0,5,1,6
10303,11223,15,11,14,40
10303,11224,9,8,12,29
10303,11225,4,7,7,18
10303,11226,11,13,15,39
10303,11228,7,10,12,29
10303,11229,7,13,12,32
10303,11230,5,11,13,29
10303,11231,1,5,7,13
10303,11232,2,5,1,8
10303,11233,5,4,3,12
10303,11234,3,11,27,41
10303,11235,14,14,22,50
10303,11236,5,10,22,37
10303,11237,2,1,9,12
10303,11238,0,2,7,9
10303,11239,2,2,1,5
10303,11354,2,1,2,5
10303,11355,2,2,6,10
10303,11356,1,0,0,1
10303,11357,1,1,4,6
10303,11358,0,0,3,3
10303,11360,0,0,1,1
10303,11361,1,0,6,7
10303,11362,0,0,2,2
10303,11364,0,0,2,2
10303,11365,1,1,3,5
10303,11366,1,0,0,1
10303,11367,2,1,4,7
10303,11368,3,3,5,11
10303,11369,1,3,1,5
10303,11370,4,4,2,10
10303,11372,4,3,3,10
10303,11373,2,2,5,9
10303,11374,1,3,3,7
10303,11375,5,8,8,21
10303,11377,1,4,5,10
10303,11378,0,1,4,5
10303,11379,0,1,2,3
10303,11385,3,4,13,20
10303,11411,1,1,4,6
10303,11412,1,1,5,7
10303,11413,1,0,7,8
10303,11414,0,1,9,10
10303,11415,0,1,1,2
10303,11416,0,0,2,2
10303,11417,3,1,4,8
10303,11418,3,0,4,7
10303,11419,2,2,5,9
10303,11420,3,3,9,15
10303,11421,1,1,2,4
10303,11422,2,1,7,10
10303,11423,3,5,4,12
10303,11426,0,3,3,6
10303,11427,2,1,3,6
10303,11428,0,1,1,2
10303,11429,0,0,6,6
10303,11432,4,3,6,13
10303,11433,2,3,4,9
10303,11434,4,5,6,15
10303,11435,4,3,6,13
10303,11436,3,2,4,9
10303,11691,2,5,7,14
10303,11692,1,2,4,7
10303,11693,3,0,3,6
10303,11694,0,0,3,3
10303,11697,0,1,0,1
10304,10001,0,2,3,5
10304,10002,3,4,7,14
10304,10003,3,2,9,14
10304,10004,1,2,0,3
10304,10005,0,0,5,5
10304,10007,0,0,1,1
10304,10009,3,2,3,8
10304,10010,0,0,10,10
10304,10011,1,2,8,11
10304,10012,1,0,2,3
10304,10013,4,3,6,13
10304,10014,2,0,12,14
10304,10016,0,1,8,9
10304,10017,0,0,3,3
10304,10019,3,1,6,10
10304,10021,0,1,4,5
10304,10022,1,3,2,6
10304,10023,2,2,2,6
10304,10024,4,1,2,7
10304,10025,3,2,3,8
10304,10026,2,1,1,4
10304,10027,1,10,4,15
10304,10029,5,5,6,16
10304,10030,1,2,1,4
10304,10031,1,4,3,8
10304,10032,2,3,5,10
10304,10033,0,4,0,4
10304,10034,0,2,2,4
10304,10035,3,2,2,7
10304,10036,0,0,1,1
10304,10037,4,2,0,6
10304,10038,3,3,5,11
10304,10039,4,2,5,11
10304,10040,2,4,3,9
10304,10044,1,0,0,1
10304,10065,0,0,3,3
10304,10069,0,0,1,1
10304,10075,2,0,1,3
10304,10128,0,1,5,6
10304,10280,0,2,3,5
10304,10301,124,150,145,419
10304,10302,49,62,41,152
10304,10303,75,117,75,267
10304,10304,242,384,193,819
10304,10305,99,132,110,341
10304,10306,116,155,141,412
10304,10307,24,25,27,76
10304,10308,58,49,66,173
10304,10309,42,38,61,141
10304,10310,71,93,69,233
10304,10312,109,128,131,368
10304,10314,175,212,213,600
10304,10451,0,2,6,8
10304,10452,5,3,5,13
10304,10453,1,7,3,11
10304,10454,0,6,1,7
10304,10455,0,2,4,6
10304,10456,6,9,5,20
10304,10457,6,5,3,14
10304,10458,4,8,6,18
10304,10459,3,9,1,13
10304,10460,2,8,2,12
10304,10461,1,1,5,7
10304,10462,3,8,3,14
10304,10463,2,4,3,9
10304,10464,0,1,0,1
10304,10465,0,1,3,4
10304,10466,7,13,2,22
10304,10467,1,4,6,11
10304,10468,2,10,3,15
10304,10469,2,2,4,8
10304,10470,1,1,0,2
10304,10471,1,4,3,8
10304,10472,2,4,3,9
10304,10473,0,7,2,9
10304,10474,1,0,0,1
10304,10475,3,2,2,7
10304,11004,0,0,2,2
10304,11005,0,1,0,1
10304,11101,0,2,4,6
10304,11102,0,3,5,8
10304,11103,0,3,3,6
10304,11104,1,0,3,4
10304,11105,0,1,0,1
10304,11106,0,5,6,11
10304,11109,0,0,1,1
10304,11201,2,5,7,14
10304,11203,7,10,9,26
10304,11204,17,14,19,50
10304,11205,1,4,9,14
10304,11206,3,5,6,14
10304,11207,7,8,13,28
10304,11208,5,9,6,20
10304,11209,16,21,34,71
10304,11210,9,14,15,38
10304,11211,2,6,7,15
10304,11212,11,14,9,34
10304,11213,6,7,9,22
10304,11214,20,28,16,64
10304,11215,4,11,14,29
10304,11216,5,4,7,16
10304,11217,2,5,9,16
10304,11218,4,8,20,32
10304,11219,10,18,22,50
10304,11220,25,21,23,69
10304,11221,2,4,5,11
10304,11222,1,1,5,7
10304,11223,19,17,22,58
10304,11224,3,23,11,37
10304,11225,4,9,5,18
10304,11226,8,22,12,42
10304,11228,12,11,21,44
10304,11229,9,16,17,42
10304,11230,16,16,27,59
10304,11231,3,7,8,18
10304,11232,5,14,7,26
10304,11233,3,8,7,18
10304,11234,13,26,24,63
10304,11235,11,7,18,36
10304,11236,14,13,25,52
10304,11237,3,1,3,7
10304,11238,3,4,7,14
10304,11239,2,2,0,4
10304,11354,1,1,4,6
10304,11355,1,3,2,6
10304,11356,0,2,0,2
10304,11357,6,1,4,11
10304,11358,0,1,6,7
10304,11360,1,0,1,2
10304,11361,0,1,0,1
10304,11362,0,1,1,2
10304,11364,2,3,1,6
10304,11365,1,2,3,6
10304,11367,0,1,1,2
10304,11368,2,6,4,12
10304,11369,1,1,3,5
10304,11370,1,3,4,8
10304,11372,2,2,5,9
10304,11373,4,3,8,15
10304,11374,0,1,0,1
10304,11375,1,2,4,7
10304,11377,4,1,1,6
10304,11378,0,0,6,6
10304,11379,0,0,3,3
10304,11385,2,8,9,19
10304,11411,0,0,4,4
10304,11412,1,0,3,4
10304,11413,5,5,8,18
10304,11414,2,1,1,4
10304,11415,1,1,6,8
10304,11416,1,5,4,10
10304,11417,0,0,2,2
10304,11418,0,1,2,3
10304,11419,1,1,3,5
10304,11420,0,2,3,5
10304,11421,0,2,4,6
10304,11422,1,2,3,6
10304,11423,2,3,0,5
10304,11426,1,3,2,6
10304,11427,0,2,1,3
10304,11428,2,1,2,5
10304,11429,1,2,0,3
10304,11432,0,2,6,8
10304,11433,2,3,6,11
10304,11434,1,5,6,12
10304,11435,1,4,2,7
10304,11436,1,2,3,6
10304,11691,1,0,8,9
10304,11693,1,0,1,2
10304,11694,2,2,4,8
10304,11697,0,0,1,1
10305,10001,1,1,4,6
10305,10002,5,6,11,22
10305,10003,3,4,13,20
10305,10004,0,0,1,1
10305,10005,0,0,2,2
10305,10006,0,0,1,1
10305,10007,2,0,1,3
10305,10009,3,1,13,17
10305,10010,1,0,8,9
10305,10011,2,2,6,10
10305,10012,0,0,8,8
10305,10013,2,1,6,9
10305,10014,1,0,10,11
10305,10016,1,1,10,12
10305,10017,0,0,3,3
10305,10019,0,0,9,9
10305,10021,2,1,14,17
10305,10022,0,0,6,6
10305,10023,1,1,11,13
10305,10024,0,3,8,11
10305,10025,0,1,19,20
10305,10026,2,5,3,10
10305,10027,3,2,7,12
10305,10028,0,1,10,11
10305,10029,4,6,18,28
10305,10030,2,1,4,7
10305,10031,0,4,5,9
10305,10032,2,3,2,7
10305,10033,2,2,6,10
10305,10034,1,0,5,6
10305,10035,2,1,4,7
10305,10036,0,0,7,7
10305,10037,1,2,3,6
10305,10038,0,3,5,8
10305,10039,1,2,4,7
10305,10040,4,2,5,11
10305,10044,0,0,1,1
10305,10065,0,1,4,5
10305,10069,0,0,1,1
10305,10075,0,1,3,4
10305,10128,2,0,13,15
10305,10280,2,0,0,2
10305,10301,95,144,192,431
10305,10302,33,59,69,161
10305,10303,81,110,98,289
10305,10304,142,228,200,570
10305,10305,286,385,333,1004
10305,10306,241,311,400,952
10305,10307,32,47,78,157
10305,10308,95,109,202,406
10305,10309,67,105,188,360
10305,10310,50,87,119,256
10305,10312,145,225,393,763
10305,10314,201,274,504,979
10305,10451,5,3,9,17
10305,10452,5,12,10,27
10305,10453,1,7,11,19
10305,10454,2,8,4,14
10305,10455,2,3,4,9
10305,10456,6,10,7,23
10305,10457,4,9,4,17
10305,10458,2,5,5,12
10305,10459,5,3,3,11
10305,10460,4,9,5,18
10305,10461,0,4,2,6
10305,10462,5,8,12,25
10305,10463,4,7,10,21
10305,10464,1,1,0,2
10305,10465,1,2,4,7
10305,10466,0,12,13,25
10305,10467,1,13,12,26
10305,10468,1,7,6,14
10305,10469,5,6,6,17
10305,10470,1,1,4,6
10305,10471,1,0,2,3
10305,10472,2,3,13,18
10305,10473,2,6,4,12
10305,10474,0,1,1,2
10305,10475,2,3,6,11
10305,11001,1,1,1,3
10305,11003,0,0,2,2
10305,11004,0,3,4,7
10305,11005,1,0,0,1
10305,11040,0,1,0,1
10305,11101,0,2,3,5
10305,11102,3,2,4,9
10305,11103,0,4,4,8
10305,11104,1,4,5,10
10305,11105,1,0,7,8
10305,11106,0,2,9,11
10305,11109,0,0,1,1
10305,11201,1,8,13,22
10305,11203,2,15,16,33
10305,11204,21,20,26,67
10305,11205,2,3,12,17
10305,11206,3,4,6,13
10305,11207,8,10,13,31
10305,11208,5,17,18,40
10305,11209,41,30,72,143
10305,11210,1,13,22,36
10305,11211,4,8,13,25
10305,11212,8,6,10,24
10305,11213,4,10,11,25
10305,11214,36,43,55,134
10305,11215,10,4,23,37
10305,11216,0,6,9,15
10305,11217,0,3,12,15
10305,11218,8,18,30,56
10305,11219,20,30,21,71
10305,11220,45,31,24,100
10305,11221,3,7,11,21
10305,11222,4,3,4,11
10305,11223,24,33,38,95
10305,11224,7,14,24,45
10305,11225,4,6,8,18
10305,11226,9,17,28,54
10305,11228,17,22,48,87
10305,11229,10,17,29,56
10305,11230,14,22,31,67
10305,11231,7,3,11,21
10305,11232,7,7,12,26
10305,11233,4,5,12,21
10305,11234,11,19,39,69
10305,11235,18,22,35,75
10305,11236,10,19,34,63
10305,11237,0,4,4,8
10305,11238,5,4,7,16
10305,11239,4,3,2,9
10305,11354,3,1,6,10
10305,11355,6,1,8,15
10305,11356,0,1,1,2
10305,11357,2,0,6,8
10305,11358,2,1,3,6
10305,11360,0,2,4,6
10305,11361,0,4,5,9
10305,11362,1,1,3,5
10305,11364,1,2,6,9
10305,11365,6,6,7,19
10305,11366,2,0,1,3
10305,11367,5,4,6,15
10305,11368,7,7,13,27
10305,11369,3,3,6,12
10305,11370,1,5,8,14
10305,11372,3,3,7,13
10305,11373,8,5,15,28
10305,11374,2,4,7,13
10305,11375,2,1,13,16
10305,11377,3,12,11,26
10305,11378,1,2,6,9
10305,11379,4,1,11,16
10305,11385,4,8,21,33
10305,11411,1,4,4,9
10305,11412,0,6,7,13
10305,11413,3,2,13,18
10305,11414,2,2,7,11
10305,11415,2,3,4,9
10305,11416,1,3,7,11
10305,11417,0,6,10,16
10305,11418,3,5,5,13
10305,11419,3,6,6,15
10305,11420,9,6,13,28
10305,11421,2,7,8,17
10305,11422,0,10,10,20
10305,11423,1,2,6,9
10305,11426,1,2,5,8
10305,11427,3,3,12,18
10305,11428,0,1,5,6
10305,11429,0,6,6,12
10305,11432,6,8,24,38
10305,11433,3,4,14,21
10305,11434,3,8,18,29
10305,11435,4,5,9,18
10305,11436,0,2,8,10
10305,11691,4,6,8,18
10305,11692,0,3,3,6
10305,11693,1,2,4,7
10305,11694,1,1,10,12
10305,11697,2,0,2,4
10306,10001,2,1,1,4
10306,10002,6,8,6,20
10306,10003,3,4,3,10
10306,10004,0,1,0,1
10306,10005,0,1,2,3
10306,10007,1,0,1,2
10306,10009,1,3,7,11
10306,10010,0,1,1,2
10306,10011,1,4,9,14
10306,10012,2,0,4,6
10306,10013,1,1,1,3
10306,10014,0,0,4,4
10306,10016,0,1,3,4
10306,10017,0,0,1,1
10306,10018,0,1,1,2
10306,10019,1,3,9,13
10306,10021,1,3,2,6
10306,10022,1,1,4,6
10306,10023,3,0,2,5
10306,10024,7,2,4,13
10306,10025,2,5,5,12
10306,10026,12,10,6,28
10306,10027,6,6,10,22
10306,10028,0,1,4,5
10306,10029,8,15,8,31
10306,10030,5,4,2,11
10306,10031,7,5,3,15
10306,10032,8,11,1,20
10306,10033,4,9,1,14
10306,10034,4,8,3,15
10306,10035,2,10,1,13
10306,10036,0,3,4,7
10306,10037,1,6,2,9
10306,10039,2,0,7,9
10306,10040,4,1,7,12
10306,10044,0,2,1,3
10306,10065,0,2,3,5
10306,10069,0,0,1,1
10306,10075,0,0,4,4
10306,10128,2,2,5,9
10306,10280,0,2,3,5
10306,10301,133,178,112,423
10306,10302,58,108,59,225
10306,10303,98,184,69,351
10306,10304,297,408,139,844
10306,10305,202,291,127,620
10306,10306,612,609,362,1583
10306,10307,64,38,65,167
10306,10308,171,207,118,496
10306,10309,120,139,128,387
10306,10310,66,120,87,273
10306,10312,267,290,248,805
10306,10314,317,412,292,1021
10306,10451,5,2,6,13
10306,10452,10,12,7,29
10306,10453,10,10,3,23
10306,10454,5,2,5,12
10306,10455,3,4,2,9
10306,10456,15,18,6,39
10306,10457,3,12,5,20
10306,10458,8,18,11,37
10306,10459,2,6,1,9
10306,10460,3,9,4,16
10306,10461,3,5,4,12
10306,10462,7,8,7,22
10306,10463,8,3,10,21
10306,10464,0,0,1,1
10306,10465,3,3,7,13
10306,10466,1,9,4,14
10306,10467,14,14,6,34
10306,10468,6,14,7,27
10306,10469,5,7,10,22
10306,10470,1,1,1,3
10306,10471,4,2,2,8
10306,10472,7,3,5,15
10306,10473,6,9,4,19
10306,10474,0,2,1,3
10306,10475,2,7,5,14
10306,11004,2,1,2,5
10306,11101,7,2,1,10
10306,11102,1,4,2,7
10306,11103,1,1,1,3
10306,11104,2,1,2,5
10306,11105,1,5,8,14
10306,11106,4,4,0,8
10306,11109,0,1,0,1
10306,11201,3,1,6,10
10306,11203,12,24,13,49
10306,11204,15,22,15,52
10306,11205,6,2,9,17
10306,11206,5,10,12,27
10306,11207,14,17,10,41
10306,11208,7,11,15,33
10306,11209,36,38,67,141
10306,11210,7,20,14,41
10306,11211,4,4,7,15
10306,11212,17,31,12,60
10306,11213,8,10,9,27
10306,11214,23,26,32,81
10306,11215,8,10,16,34
10306,11216,2,10,9,21
10306,11217,2,3,6,11
10306,11218,8,25,25,58
10306,11219,13,9,19,41
10306,11220,33,42,32,107
10306,11221,6,11,4,21
10306,11222,3,0,2,5
10306,11223,17,46,41,104
10306,11224,11,18,29,58
10306,11225,8,17,10,35
10306,11226,12,25,9,46
10306,11228,20,17,39,76
10306,11229,14,24,32,70
10306,11230,11,25,16,52
10306,11231,0,3,5,8
10306,11232,9,12,5,26
10306,11233,10,19,13,42
10306,11234,12,26,16,54
10306,11235,16,22,36,74
10306,11236,10,25,27,62
10306,11237,5,8,4,17
10306,11238,3,5,8,16
10306,11239,1,4,4,9
10306,11354,3,4,2,9
10306,11355,2,3,8,13
10306,11356,0,2,3,5
10306,11357,3,2,7,12
10306,11358,3,4,4,11
10306,11361,1,2,3,6
10306,11362,1,0,2,3
10306,11363,2,0,0,2
10306,11364,3,1,0,4
10306,11365,2,5,5,12
10306,11366,1,1,2,4
10306,11367,2,2,1,5
10306,11368,8,10,7,25
10306,11369,1,4,3,8
10306,11370,5,5,5,15
10306,11372,4,4,3,11
10306,11373,5,8,4,17
10306,11374,0,3,2,5
10306,11375,1,10,5,16
10306,11377,3,10,9,22
10306,11378,5,7,3,15
10306,11379,1,10,4,15
10306,11385,6,13,12,31
10306,11411,1,4,2,7
10306,11412,7,4,6,17
10306,11413,2,6,6,14
10306,11414,3,2,5,10
10306,11415,1,2,2,5
10306,11416,2,2,3,7
10306,11417,4,6,3,13
10306,11418,2,3,8,13
10306,11419,3,8,9,20
10306,11420,5,10,8,23
10306,11421,7,3,4,14
10306,11422,2,3,12,17
10306,11423,4,4,1,9
10306,11426,3,0,1,4
10306,11427,0,5,2,7
10306,11428,2,4,3,9
10306,11429,2,2,7,11
10306,11432,2,4,8,14
10306,11433,3,6,7,16
10306,11434,5,9,5,19
10306,11435,2,7,8,17
10306,11436,2,2,0,4
10306,11691,3,8,14,25
10306,11692,6,2,2,10
10306,11693,0,2,3,5
10306,11694,6,1,7,14
10306,11697,1,0,2,3
10307,10001,0,0,1,1
10307,10002,0,2,1,3
10307,10003,0,0,1,1
10307,10005,0,0,1,1
10307,10007,1,0,0,1
10307,10009,2,0,3,5
10307,10011,0,0,2,2
10307,10012,0,0,1,1
10307,10016,0,0,2,2
10307,10022,0,0,1,1
10307,10023,0,0,1,1
10307,10025,0,1,3,4
10307,10026,0,0,4,4
10307,10028,0,0,3,3
10307,10029,0,1,3,4
10307,10030,2,0,1,3
10307,10031,1,0,1,2
10307,10032,0,1,0,1
10307,10035,0,0,1,1
10307,10038,1,0,1,2
10307,10039,0,0,1,1
10307,10040,0,0,4,4
10307,10044,0,1,0,1
10307,10065,0,0,1,1
10307,10069,0,1,0,1
10307,10075,0,0,1,1
10307,10280,0,0,2,2
10307,10301,3,9,12,24
10307,10302,1,8,4,13
10307,10303,7,15,9,31
10307,10304,8,16,14,38
10307,10305,11,10,14,35
10307,10306,33,38,27,98
10307,10307,91,77,63,231
10307,10308,29,14,19,62
10307,10309,69,28,39,136
10307,10310,1,5,10,16
10307,10312,61,49,69,179
10307,10314,42,47,36,125
10307,10452,0,1,0,1
10307,10455,0,1,0,1
10307,10456,0,1,0,1
10307,10457,0,1,2,3
10307,10458,0,0,2,2
10307,10459,0,0,1,1
10307,10460,0,1,1,2
10307,10461,0,0,2,2
10307,10462,0,0,1,1
10307,10463,0,0,2,2
10307,10465,0,0,2,2
10307,10466,0,0,2,2
10307,10467,2,0,2,4
10307,10468,0,0,1,1
10307,10469,1,1,0,2
10307,10470,0,1,2,3
10307,10471,1,1,0,2
10307,10473,0,2,1,3
10307,10475,0,0,1,1
10307,11004,0,0,1,1
10307,11005,0,1,0,1
10307,11101,0,0,2,2
10307,11102,1,0,2,3
10307,11104,1,0,1,2
10307,11106,0,0,4,4
10307,11201,0,1,5,6
10307,11203,0,1,3,4
10307,11204,0,2,2,4
10307,11205,0,2,1,3
10307,11206,2,2,0,4
10307,11207,1,1,3,5
10307,11208,1,2,1,4
10307,11209,0,4,5,9
10307,11210,0,0,1,1
10307,11211,0,0,5,5
10307,11212,0,0,2,2
10307,11213,1,0,3,4
10307,11214,4,2,10,16
10307,11215,0,1,1,2
10307,11216,1,0,5,6
10307,11217,0,1,2,3
10307,11218,3,0,2,5
10307,11219,5,1,3,9
10307,11220,1,5,2,8
10307,11221,0,3,5,8
10307,11222,0,0,1,1
10307,11223,1,2,2,5
10307,11224,0,2,1,3
10307,11225,0,0,2,2
10307,11226,2,3,7,12
10307,11228,0,0,3,3
10307,11229,2,4,4,10
10307,11230,0,0,1,1
10307,11231,1,0,1,2
10307,11232,0,1,0,1
10307,11233,0,0,3,3
10307,11234,0,3,6,9
10307,11235,2,0,3,5
10307,11236,0,3,8,11
10307,11237,0,1,2,3
10307,11238,0,0,4,4
10307,11239,0,1,0,1
10307,11354,1,1,2,4
10307,11355,2,0,2,4
10307,11357,0,0,2,2
10307,11364,1,0,0,1
10307,11365,0,0,1,1
10307,11368,2,0,1,3
10307,11370,3,0,1,4
10307,11372,0,1,2,3
10307,11373,0,0,1,1
10307,11374,1,0,2,3
10307,11375,0,0,5,5
10307,11377,2,0,2,4
10307,11378,0,1,1,2
10307,11379,0,1,3,4
10307,11385,1,0,1,2
10307,11411,0,1,2,3
10307,11412,0,0,1,1
10307,11413,0,1,1,2
10307,11414,0,0,2,2
10307,11416,0,1,1,2
10307,11417,0,2,1,3
10307,11418,0,1,2,3
10307,11419,1,0,3,4
10307,11420,2,0,1,3
10307,11421,0,0,2,2
10307,11423,1,0,2,3
10307,11426,0,0,1,1
10307,11427,0,0,1,1
10307,11429,1,0,1,2
10307,11432,0,0,1,1
10307,11433,0,0,1,1
10307,11434,0,0,3,3
10307,11435,0,1,1,2
10307,11691,1,1,2,4
10307,11692,0,1,2,3
10307,11694,0,0,2,2
10308,10001,0,1,0,1
10308,10002,2,1,0,3
10308,10003,0,2,0,2
10308,10005,0,0,1,1
10308,10009,4,0,3,7
10308,10010,2,1,0,3
10308,10011,0,2,6,8
10308,10012,0,0,2,2
10308,10013,1,0,2,3
10308,10014,0,0,1,1
10308,10016,0,0,3,3
10308,10017,1,0,1,2
10308,10019,0,1,1,2
10308,10021,0,0,1,1
10308,10022,0,0,1,1
10308,10023,0,2,1,3
10308,10024,1,1,2,4
10308,10025,2,3,2,7
10308,10026,0,3,1,4
10308,10027,1,2,3,6
10308,10029,2,3,2,7
10308,10030,0,1,1,2
10308,10031,0,0,4,4
10308,10032,0,0,4,4
10308,10033,1,0,0,1
10308,10034,0,1,0,1
10308,10035,2,3,0,5
10308,10036,1,0,0,1
10308,10037,0,2,0,2
10308,10038,0,0,1,1
10308,10040,1,0,2,3
10308,10044,1,0,0,1
10308,10065,1,0,1,2
10308,10075,0,0,1,1
10308,10128,0,1,2,3
10308,10301,19,19,20,58
10308,10302,10,12,6,28
10308,10303,16,9,22,47
10308,10304,26,26,14,66
10308,10305,23,23,34,80
10308,10306,99,62,71,232
10308,10307,18,23,21,62
10308,10308,107,98,77,282
10308,10309,47,52,28,127
10308,10310,20,12,18,50
10308,10312,132,118,82,332
10308,10314,80,73,53,206
10308,10451,0,3,5,8
10308,10452,0,5,5,10
10308,10453,3,6,5,14
10308,10454,1,3,2,6
10308,10455,0,3,5,8
10308,10456,1,4,6,11
10308,10457,2,4,11,17
10308,10458,1,1,2,4
10308,10459,4,6,4,14
10308,10460,0,4,4,8
10308,10461,2,1,5,8
10308,10462,6,0,8,14
10308,10463,4,1,3,8
10308,10465,0,0,2,2
10308,10466,2,1,8,11
10308,10467,6,4,8,18
10308,10468,2,4,6,12
10308,10469,2,5,5,12
10308,10470,3,1,1,5
10308,10471,0,0,1,1
10308,10472,0,2,7,9
10308,10473,0,3,2,5
10308,10474,1,2,0,3
10308,10475,3,3,2,8
10308,11004,0,0,1,1
10308,11101,3,0,1,4
10308,11102,1,1,1,3
10308,11103,0,0,1,1
10308,11104,0,1,0,1
10308,11106,0,0,1,1
10308,11201,2,1,0,3
10308,11203,2,4,7,13
10308,11204,2,1,7,10
10308,11205,1,1,3,5
10308,11206,3,0,4,7
10308,11207,2,9,4,15
10308,11208,7,1,9,17
10308,11209,5,6,13,24
10308,11210,2,3,3,8
10308,11211,1,4,4,9
10308,11212,3,3,3,9
10308,11213,2,0,4,6
10308,11214,7,4,9,20
10308,11215,1,2,3,6
10308,11216,2,1,1,4
10308,11217,0,0,2,2
10308,11218,9,10,4,23
10308,11219,3,9,6,18
10308,11220,18,10,6,34
10308,11221,2,1,4,7
10308,11222,0,1,2,3
10308,11223,3,6,3,12
10308,11224,2,7,3,12
10308,11225,2,5,2,9
10308,11226,8,11,1,20
10308,11228,4,7,5,16
10308,11229,5,10,9,24
10308,11230,2,8,6,16
10308,11231,0,0,2,2
10308,11232,2,3,3,8
10308,11233,4,2,4,10
10308,11234,4,4,6,14
10308,11235,5,9,11,25
10308,11236,0,1,6,7
10308,11237,2,0,2,4
10308,11238,1,1,2,4
10308,11239,2,0,1,3
10308,11354,4,0,0,4
10308,11355,7,0,1,8
10308,11356,1,1,2,4
10308,11357,2,0,5,7
10308,11358,1,1,2,4
10308,11360,0,2,1,3
10308,11361,2,0,0,2
10308,11365,0,1,0,1
10308,11366,0,0,1,1
10308,11367,0,0,3,3
10308,11368,5,5,4,14
10308,11369,2,5,4,11
10308,11370,3,2,5,10
10308,11372,2,2,5,9
10308,11373,8,3,3,14
10308,11374,1,1,3,5
10308,11375,0,3,3,6
10308,11377,1,4,5,10
10308,11378,1,2,1,4
10308,11379,3,2,1,6
10308,11385,4,6,4,14
10308,11411,0,0,4,4
10308,11412,0,4,3,7
10308,11413,0,1,4,5
10308,11414,1,4,2,7
10308,11415,0,1,1,2
10308,11416,1,0,0,1
10308,11417,0,2,2,4
10308,11418,0,1,3,4
10308,11419,0,0,6,6
10308,11420,0,1,6,7
10308,11421,0,1,4,5
10308,11422,0,0,3,3
10308,11423,2,2,1,5
10308,11426,0,1,1,2
10308,11427,0,2,0,2
10308,11428,0,0,3,3
10308,11429,1,1,0,2
10308,11432,2,2,3,7
10308,11433,1,2,5,8
10308,11434,2,2,2,6
10308,11435,0,3,3,6
10308,11436,0,3,2,5
10308,11691,3,3,4,10
10308,11692,1,0,1,2
10308,11693,1,0,5,6
10308,11694,2,1,0,3
10308,11697,1,0,0,1
10309,10001,0,0,1,1
10309,10002,3,1,3,7
10309,10003,0,0,4,4
10309,10009,1,0,2,3
10309,10010,1,0,1,2
10309,10011,1,0,2,3
10309,10013,1,2,4,7
10309,10014,0,2,2,4
10309,10016,1,1,2,4
10309,10017,0,2,0,2
10309,10019,1,0,1,2
10309,10021,0,1,1,2
10309,10022,1,1,0,2
10309,10023,0,1,0,1
10309,10025,3,0,1,4
10309,10026,2,3,2,7
10309,10027,3,4,2,9
10309,10028,0,0,1,1
10309,10029,3,5,7,15
10309,10030,2,1,1,4
10309,10031,1,2,2,5
10309,10032,2,3,3,8
10309,10033,0,2,3,5
10309,10034,0,1,1,2
10309,10035,0,3,2,5
10309,10036,0,1,0,1
10309,10037,1,0,1,2
10309,10038,1,1,0,2
10309,10039,0,1,2,3
10309,10040,1,1,3,5
10309,10044,1,0,0,1
10309,10065,0,0,1,1
10309,10128,0,1,5,6
10309,10280,0,0,1,1
10309,10282,1,0,0,1
10309,10301,61,68,46,175
10309,10302,35,52,51,138
10309,10303,40,69,48,157
10309,10304,53,98,83,234
10309,10305,72,66,62,200
10309,10306,121,135,150,406
10309,10307,148,135,113,396
10309,10308,134,82,105,321
10309,10309,341,246,237,824
10309,10310,32,41,39,112
10309,10312,302,309,272,883
10309,10314,182,193,196,571
10309,10451,5,3,6,14
10309,10452,6,10,6,22
10309,10453,6,7,5,18
10309,10454,1,2,0,3
10309,10455,1,0,3,4
10309,10456,9,5,6,20
10309,10457,5,9,3,17
10309,10458,6,3,4,13
10309,10459,1,6,0,7
10309,10460,4,9,6,19
10309,10461,1,7,3,11
10309,10462,4,4,2,10
10309,10463,0,4,8,12
10309,10465,1,0,1,2
10309,10466,7,5,11,23
10309,10467,7,6,12,25
10309,10468,3,2,6,11
10309,10469,2,4,9,15
10309,10470,0,0,3,3
10309,10471,0,0,2,2
10309,10472,3,2,8,13
10309,10473,2,1,4,7
10309,10474,1,0,0,1
10309,10475,1,2,5,8
10309,11001,0,0,1,1
10309,11004,1,3,3,7
10309,11101,0,1,3,4
10309,11102,0,2,0,2
10309,11103,0,2,4,6
10309,11104,0,1,1,2
10309,11105,0,1,2,3
10309,11106,2,4,6,12
10309,11109,1,0,1,2
10309,11201,2,3,3,8
10309,11203,8,9,10,27
10309,11204,4,7,14,25
10309,11205,2,4,4,10
10309,11206,5,6,9,20
10309,11207,3,9,8,20
10309,11208,8,6,12,26
10309,11209,8,8,19,35
10309,11210,2,8,11,21
10309,11211,3,1,2,6
10309,11212,8,9,12,29
10309,11213,4,6,8,18
10309,11214,13,10,26,49
10309,11215,7,4,13,24
10309,11216,2,5,2,9
10309,11217,2,1,3,6
10309,11218,9,11,11,31
10309,11219,8,12,5,25
10309,11220,17,19,10,46
10309,11221,4,4,3,11
10309,11222,1,2,1,4
10309,11223,6,10,14,30
10309,11224,2,4,8,14
10309,11225,5,4,3,12
10309,11226,6,11,25,42
10309,11228,8,5,12,25
10309,11229,8,4,12,24
10309,11230,2,8,9,19
10309,11231,1,3,8,12
10309,11232,2,1,5,8
10309,11233,3,9,6,18
10309,11234,10,2,16,28
10309,11235,4,10,6,20
10309,11236,6,5,30,41
10309,11237,1,0,6,7
10309,11238,3,3,6,12
10309,11354,3,2,4,9
10309,11355,1,1,3,5
10309,11356,2,1,5,8
10309,11357,2,3,5,10
10309,11358,4,0,5,9
10309,11360,2,1,2,5
10309,11361,0,0,2,2
10309,11362,1,0,1,2
10309,11363,1,0,0,1
10309,11364,1,0,1,2
10309,11365,2,0,1,3
10309,11366,1,0,1,2
10309,11367,0,1,5,6
10309,11368,7,3,9,19
10309,11369,1,1,4,6
10309,11370,3,2,2,7
10309,11372,3,3,5,11
10309,11373,2,6,10,18
10309,11374,1,2,3,6
10309,11375,3,1,6,10
10309,11377,4,1,8,13
10309,11378,1,3,5,9
10309,11379,1,0,4,5
10309,11385,4,7,15,26
10309,11411,0,1,3,4
10309,11412,5,4,3,12
10309,11413,2,4,5,11
10309,11414,1,1,7,9
10309,11415,3,0,3,6
10309,11416,3,1,5,9
10309,11417,1,3,10,14
10309,11418,2,5,5,12
10309,11419,2,4,7,13
10309,11420,3,4,7,14
10309,11421,2,4,1,7
10309,11422,1,2,4,7
10309,11423,0,1,3,4
10309,11426,0,1,5,6
10309,11427,1,0,1,2
10309,11428,0,2,5,7
10309,11429,2,3,3,8
10309,11432,1,2,8,11
10309,11433,1,6,4,11
10309,11434,7,7,8,22
10309,11435,1,2,6,9
10309,11436,0,2,1,3
10309,11691,5,4,8,17
10309,11692,1,4,1,6
10309,11693,1,2,1,4
10309,11694,0,0,1,1
10309,11697,0,0,1,1
10310,10001,0,0,3,3
10310,10002,8,2,9,19
10310,10003,1,2,4,7
10310,10004,1,1,2,4
10310,10005,1,1,2,4
10310,10006,1,2,1,4
10310,10007,2,0,0,2
10310,10009,0,4,5,9
10310,10010,0,1,3,4
10310,10011,0,2,4,6
10310,10012,1,3,0,4
10310,10013,2,2,5,9
10310,10014,6,2,3,11
10310,10016,0,1,3,4
10310,10017,0,0,2,2
10310,10019,0,0,1,1
10310,10021,0,1,3,4
10310,10022,0,1,2,3
10310,10023,1,0,0,1
10310,10024,0,4,3,7
10310,10025,1,2,4,7
10310,10026,4,3,3,10
10310,10027,3,1,6,10
10310,10028,1,0,2,3
10310,10029,3,2,5,10
10310,10030,0,2,3,5
10310,10031,0,3,5,8
10310,10032,0,2,5,7
10310,10033,0,3,4,7
10310,10034,0,1,2,3
10310,10035,0,2,4,6
10310,10036,0,1,2,3
10310,10037,0,3,1,4
10310,10038,2,0,4,6
10310,10039,0,4,2,6
10310,10040,1,2,5,8
10310,10065,1,0,0,1
10310,10075,1,1,1,3
10310,10128,0,1,9,10
10310,10280,1,1,4,6
10310,10282,1,1,0,2
10310,10301,67,145,238,450
10310,10302,44,118,106,268
10310,10303,56,109,111,276
10310,10304,68,112,141,321
10310,10305,53,94,131,278
10310,10306,99,105,218,422
10310,10307,7,15,51,73
10310,10308,45,39,91,175
10310,10309,37,65,141,243
10310,10310,150,190,248,588
10310,10312,96,94,229,419
10310,10314,164,256,445,865
10310,10451,2,4,1,7
10310,10452,4,0,3,7
10310,10453,2,3,6,11
10310,10454,1,1,1,3
10310,10455,3,4,3,10
10310,10456,1,5,8,14
10310,10457,1,5,5,11
10310,10458,2,3,10,15
10310,10459,2,2,3,7
10310,10460,0,1,3,4
10310,10461,0,2,6,8
10310,10462,0,0,7,7
10310,10463,2,3,2,7
10310,10464,0,0,1,1
10310,10465,3,0,2,5
10310,10466,1,1,4,6
10310,10467,9,6,8,23
10310,10468,4,2,8,14
10310,10469,3,3,4,10
10310,10470,1,1,4,6
10310,10471,1,3,1,5
10310,10472,5,2,3,10
10310,10473,2,7,6,15
10310,10474,0,1,0,1
10310,10475,0,3,3,6
10310,11004,0,1,1,2
10310,11101,1,0,3,4
10310,11102,0,2,8,10
10310,11103,0,1,4,5
10310,11104,0,1,3,4
10310,11105,1,0,6,7
10310,11106,2,2,4,8
10310,11109,0,1,0,1
10310,11201,2,2,7,11
10310,11203,3,3,20,26
10310,11204,14,12,19,45
10310,11205,2,3,8,13
10310,11206,4,5,6,15
10310,11207,2,3,11,16
10310,11208,10,6,13,29
10310,11209,17,16,46,79
10310,11210,3,6,8,17
10310,11211,4,8,11,23
10310,11212,7,5,14,26
10310,11213,7,6,10,23
10310,11214,10,18,36,64
10310,11215,8,9,21,38
10310,11216,3,3,8,14
10310,11217,2,1,12,15
10310,11218,4,8,19,31
10310,11219,7,14,10,31
10310,11220,18,12,33,63
10310,11221,2,4,6,12
10310,11222,1,3,4,8
10310,11223,13,12,26,51
10310,11224,6,8,9,23
10310,11225,2,3,10,15
10310,11226,5,12,23,40
10310,11228,4,8,22,34
10310,11229,1,3,14,18
10310,11230,7,8,21,36
10310,11231,3,8,8,19
10310,11232,3,3,4,10
10310,11233,4,3,5,12
10310,11234,2,10,32,44
10310,11235,5,12,29,46
10310,11236,6,9,25,40
10310,11237,1,2,3,6
10310,11238,2,2,7,11
10310,11239,4,2,5,11
10310,11354,1,3,4,8
10310,11355,2,0,3,5
10310,11356,1,1,1,3
10310,11357,3,1,1,5
10310,11358,0,4,4,8
10310,11360,1,0,6,7
10310,11361,2,1,4,7
10310,11362,0,0,3,3
10310,11364,1,1,2,4
10310,11365,1,1,5,7
10310,11366,1,0,1,2
10310,11367,1,2,2,5
10310,11368,5,3,8,16
10310,11369,3,0,5,8
10310,11370,4,4,3,11
10310,11372,4,0,8,12
10310,11373,8,3,3,14
10310,11374,0,0,3,3
10310,11375,1,1,5,7
10310,11377,2,6,13,21
10310,11378,1,4,2,7
10310,11379,3,1,4,8
10310,11385,4,4,12,20
10310,11411,0,1,2,3
10310,11412,0,1,1,2
10310,11413,1,3,2,6
10310,11414,2,0,6,8
10310,11415,1,0,4,5
10310,11416,1,3,3,7
10310,11417,5,5,3,13
10310,11418,2,4,10,16
10310,11419,3,1,9,13
10310,11420,3,4,11,18
10310,11421,3,2,9,14
10310,11422,0,4,3,7
10310,11423,1,2,5,8
10310,11426,1,0,4,5
10310,11427,0,0,3,3
10310,11428,0,1,3,4
10310,11429,0,0,4,4
10310,11432,4,4,5,13
10310,11433,0,1,3,4
10310,11434,1,4,5,10
10310,11435,1,4,6,11
10310,11436,1,1,1,3
10310,11691,7,5,7,19
10310,11692,0,2,4,6
10310,11693,0,0,2,2
10310,11694,2,0,2,4
10310,11697,0,0,2,2
10311,10001,1,0,1,2
10311,10003,1,0,0,1
10311,10009,1,0,0,1
10311,10011,0,0,1,1
10311,10012,0,0,1,1
10311,10019,0,0,4,4
10311,10025,0,1,0,1
10311,10301,2,8,4,14
10311,10302,1,4,1,6
10311,10303,3,4,5,12
10311,10304,1,2,3,6
10311,10305,1,3,7,11
10311,10306,3,3,18,24
10311,10307,0,4,3,7
10311,10308,1,5,3,9
10311,10309,3,5,6,14
10311,10310,0,2,3,5
10311,10312,8,11,14,33
10311,10314,14,14,13,41
10311,10452,0,0,1,1
10311,10456,0,0,1,1
10311,10463,1,1,0,2
10311,10470,0,0,1,1
10311,11203,0,0,1,1
10311,11204,0,0,1,1
10311,11208,1,0,1,2
10311,11210,1,0,0,1
10311,11211,0,0,1,1
10311,11213,0,1,0,1
10311,11219,0,1,1,2
10311,11220,0,2,0,2
10311,11221,0,1,1,2
10311,11224,0,1,0,1
10311,11228,0,0,1,1
10311,11230,0,0,1,1
10311,11234,0,1,1,2
10311,11236,1,0,0,1
10311,11237,0,1,1,2
10311,11355,0,1,0,1
10311,11358,0,0,1,1
10311,11368,1,0,1,2
10311,11373,1,0,1,2
10311,11374,0,1,0,1
10311,11419,0,0,1,1
10311,11428,0,0,1,1
10311,11691,1,0,0,1
10311,11693,1,0,0,1
10312,10001,0,0,2,2
10312,10002,5,4,2,11
10312,10003,2,0,2,4
10312,10005,0,0,1,1
10312,10007,0,0,1,1
10312,10009,5,1,3,9
10312,10010,0,0,1,1
10312,10011,0,1,3,4
10312,10012,0,0,1,1
10312,10013,0,1,4,5
10312,10014,1,0,4,5
10312,10016,1,1,4,6
10312,10019,0,1,2,3
10312,10021,1,1,1,3
10312,10022,0,1,2,3
10312,10023,0,1,2,3
10312,10024,3,0,1,4
10312,10025,1,2,5,8
10312,10026,1,0,2,3
10312,10027,1,5,2,8
10312,10028,1,0,0,1
10312,10029,0,4,7,11
10312,10030,1,0,1,2
10312,10031,1,0,2,3
10312,10032,1,2,3,6
10312,10033,2,1,2,5
10312,10034,3,5,2,10
10312,10035,2,2,1,5
10312,10036,0,0,1,1
10312,10037,1,2,1,4
10312,10038,0,1,1,2
10312,10039,2,2,1,5
10312,10040,1,0,2,3
10312,10065,1,0,1,2
10312,10075,0,0,2,2
10312,10128,1,0,3,4
10312,10280,0,0,1,1
10312,10301,38,35,51,124
10312,10302,35,51,16,102
10312,10303,45,32,34,111
10312,10304,65,74,45,184
10312,10305,60,54,63,177
10312,10306,144,118,114,376
10312,10307,46,52,55,153
10312,10308,149,120,95,364
10312,10309,195,137,123,455
10312,10310,33,28,29,90
10312,10312,461,425,335,1221
10312,10314,204,202,125,531
10312,10451,0,6,3,9
10312,10452,2,5,11,18
10312,10453,4,4,7,15
10312,10454,1,4,4,9
10312,10455,2,0,3,5
10312,10456,4,9,9,22
10312,10457,1,4,2,7
10312,10458,7,5,11,23
10312,10459,3,2,2,7
10312,10460,3,2,9,14
10312,10461,1,0,4,5
10312,10462,1,5,7,13
10312,10463,1,1,7,9
10312,10465,1,2,6,9
10312,10466,4,3,5,12
10312,10467,7,7,7,21
10312,10468,4,3,7,14
10312,10469,1,3,8,12
10312,10470,0,1,2,3
10312,10471,1,0,2,3
10312,10472,1,5,4,10
10312,10473,6,5,7,18
10312,10474,1,2,3,6
10312,10475,2,0,4,6
10312,11001,1,0,1,2
10312,11005,1,0,1,2
10312,11101,2,0,3,5
10312,11102,0,1,6,7
10312,11103,2,0,4,6
10312,11104,0,1,2,3
10312,11105,2,0,2,4
10312,11106,1,2,4,7
10312,11201,3,1,6,10
10312,11203,5,8,19,32
10312,11204,5,12,10,27
10312,11205,1,2,6,9
10312,11206,4,5,9,18
10312,11207,4,13,13,30
10312,11208,8,4,12,24
10312,11209,10,16,28,54
10312,11210,2,6,11,19
10312,11211,4,8,4,16
10312,11212,4,10,12,26
10312,11213,3,5,10,18
10312,11214,12,15,21,48
10312,11215,1,3,6,10
10312,11216,4,5,3,12
10312,11217,0,2,10,12
10312,11218,5,9,11,25
10312,11219,10,10,7,27
10312,11220,20,18,7,45
10312,11221,3,3,5,11
10312,11222,0,2,0,2
10312,11223,7,15,14,36
10312,11224,3,10,13,26
10312,11225,1,3,12,16
10312,11226,6,8,22,36
10312,11228,8,6,11,25
10312,11229,10,7,23,40
10312,11230,5,8,12,25
10312,11231,1,0,9,10
10312,11232,4,1,3,8
10312,11233,3,3,7,13
10312,11234,6,5,25,36
10312,11235,10,7,19,36
10312,11236,7,10,17,34
10312,11237,4,3,4,11
10312,11238,2,1,4,7
10312,11239,0,1,2,3
10312,11354,3,1,6,10
10312,11355,2,2,11,15
10312,11356,1,3,2,6
10312,11357,2,2,4,8
10312,11358,2,1,2,5
10312,11360,2,3,4,9
10312,11361,2,2,2,6
10312,11362,2,1,1,4
10312,11364,1,1,2,4
10312,11365,0,0,2,2
10312,11367,0,0,5,5
10312,11368,3,8,11,22
10312,11369,1,0,0,1
10312,11370,1,3,5,9
10312,11372,4,0,5,9
10312,11373,2,2,4,8
10312,11374,2,1,7,10
10312,11375,5,6,5,16
10312,11377,0,6,5,11
10312,11378,3,0,7,10
10312,11379,2,4,9,15
10312,11385,4,7,10,21
10312,11411,2,2,2,6
10312,11412,1,0,2,3
10312,11413,2,3,5,10
10312,11414,3,1,5,9
10312,11415,0,1,1,2
10312,11416,0,0,4,4
10312,11417,0,2,8,10
10312,11418,3,2,4,9
10312,11419,2,2,4,8
10312,11420,3,2,6,11
10312,11421,0,1,4,5
10312,11422,1,2,6,9
10312,11423,0,1,2,3
10312,11426,1,1,4,6
10312,11427,1,1,6,8
10312,11428,2,3,3,8
10312,11429,2,1,4,7
10312,11432,1,7,5,13
10312,11433,1,1,5,7
10312,11434,3,1,15,19
10312,11435,2,4,3,9
10312,11436,0,0,5,5
10312,11691,4,7,12,23
10312,11692,1,1,3,5
10312,11693,0,4,4,8
10312,11694,1,3,5,9
10314,10001,5,2,6,13
10314,10002,14,13,24,51
10314,10003,6,5,13,24
10314,10005,0,0,1,1
10314,10006,0,1,1,2
10314,10007,0,3,3,6
10314,10009,8,5,18,31
10314,10010,4,1,12,17
10314,10011,3,4,14,21
10314,10012,3,0,3,6
10314,10013,3,1,4,8
10314,10014,4,4,8,16
10314,10016,7,9,15,31
10314,10017,1,4,4,9
10314,10018,0,0,4,4
10314,10019,8,6,10,24
10314,10021,7,3,15,25
10314,10022,1,2,8,11
10314,10023,10,5,7,22
10314,10024,5,3,12,20
10314,10025,11,13,28,52
10314,10026,4,5,3,12
10314,10027,11,17,16,44
10314,10028,3,3,14,20
10314,10029,10,8,25,43
10314,10030,6,6,7,19
10314,10031,11,11,17,39
10314,10032,6,6,13,25
10314,10033,8,7,12,27
10314,10034,5,4,11,20
10314,10035,3,6,13,22
10314,10036,4,0,9,13
10314,10037,2,3,3,8
10314,10038,3,3,6,12
10314,10039,6,4,8,18
10314,10040,5,6,9,20
10314,10044,0,0,4,4
10314,10065,1,0,8,9
10314,10069,0,1,1,2
10314,10075,2,0,6,8
10314,10128,2,6,12,20
10314,10162,0,0,1,1
10314,10280,1,1,3,5
10314,10301,283,360,230,873
10314,10302,185,272,125,582
10314,10303,291,413,173,877
10314,10304,222,327,206,755
10314,10305,232,244,229,705
10314,10306,333,332,397,1062
10314,10307,100,83,126,309
10314,10308,201,199,195,595
10314,10309,197,249,233,679
10314,10310,209,309,173,691
10314,10312,460,513,469,1442
10314,10314,1135,1234,890,3259
10314,10451,10,13,11,34
10314,10452,15,16,12,43
10314,10453,13,22,17,52
10314,10454,3,5,6,14
10314,10455,2,9,4,15
10314,10456,11,24,7,42
10314,10457,16,13,14,43
10314,10458,16,14,13,43
10314,10459,3,12,7,22
10314,10460,15,14,14,43
10314,10461,8,5,20,33
10314,10462,12,18,14,44
10314,10463,10,6,22,38
10314,10464,3,0,1,4
10314,10465,6,14,15,35
10314,10466,18,25,15,58
10314,10467,15,26,22,63
10314,10468,15,16,13,44
10314,10469,17,14,13,44
10314,10470,7,7,7,21
10314,10471,4,4,10,18
10314,10472,8,11,22,41
10314,10473,9,14,12,35
10314,10474,2,1,1,4
10314,10475,3,12,13,28
10314,11001,0,0,1,1
10314,11004,3,5,5,13
10314,11005,1,0,2,3
10314,11040,2,0,1,3
10314,11101,6,5,5,16
10314,11102,5,5,11,21
10314,11103,2,3,7,12
10314,11104,7,4,10,21
10314,11105,3,7,8,18
10314,11106,5,4,10,19
10314,11109,1,0,0,1
10314,11201,7,8,16,31
10314,11203,26,47,46,119
10314,11204,26,36,36,98
10314,11205,6,9,14,29
10314,11206,11,18,20,49
10314,11207,28,42,35,105
10314,11208,35,28,33,96
10314,11209,48,44,64,156
10314,11210,30,26,28,84
10314,11211,7,5,22,34
10314,11212,33,33,33,99
10314,11213,21,22,42,85
10314,11214,32,35,54,121
10314,11215,13,19,26,58
10314,11216,13,21,26,60
10314,11217,12,6,11,29
10314,11218,27,15,19,61
10314,11219,25,31,32,88
10314,11220,46,74,39,159
10314,11221,13,26,24,63
10314,11222,1,1,13,15
10314,11223,21,30,50,101
10314,11224,17,22,40,79
10314,11225,26,27,28,81
10314,11226,31,63,56,150
10314,11228,14,34,38,86
10314,11229,25,34,47,106
10314,11230,27,30,31,88
10314,11231,6,7,13,26
10314,11232,9,16,11,36
10314,11233,30,22,23,75
10314,11234,30,33,56,119
10314,11235,26,19,52,97
10314,11236,28,39,73,140
10314,11237,9,11,11,31
10314,11238,8,19,18,45
10314,11239,4,4,8,16
10314,11354,10,6,6,22
10314,11355,8,13,18,39
10314,11356,7,6,5,18
10314,11357,12,9,9,30
10314,11358,7,1,8,16
10314,11360,3,1,3,7
10314,11361,2,3,14,19
10314,11362,0,6,9,15
10314,11363,2,1,0,3
10314,11364,3,8,16,27
10314,11365,4,4,14,22
10314,11366,3,1,5,9
10314,11367,4,7,18,29
10314,11368,20,19,27,66
10314,11369,6,6,7,19
10314,11370,9,9,8,26
10314,11372,8,9,6,23
10314,11373,20,16,19,55
10314,11374,7,6,27,40
10314,11375,6,11,19,36
10314,11377,11,14,30,55
10314,11378,8,13,21,42
10314,11379,3,10,18,31
10314,11385,23,26,59,108
10314,11411,1,10,5,16
10314,11412,7,8,11,26
10314,11413,9,8,20,37
10314,11414,4,8,10,22
10314,11415,5,5,3,13
10314,11416,4,7,4,15
10314,11417,7,5,6,18
10314,11418,8,15,8,31
10314,11419,13,15,21,49
10314,11420,8,7,19,34
10314,11421,14,12,14,40
10314,11422,5,13,16,34
10314,11423,6,9,13,28
10314,11426,7,3,7,17
10314,11427,5,8,7,20
10314,11428,6,7,8,21
10314,11429,5,10,9,24
10314,11432,9,10,9,28
10314,11433,6,11,14,31
10314,11434,9,16,27,52
10314,11435,14,11,15,40
10314,11436,2,2,6,10
10314,11691,12,19,30,61
10314,11692,6,7,11,24
10314,11693,2,9,9,20
10314,11694,8,6,11,25
10314,11697,0,3,5,8
10451,10001,3,6,14,23
10451,10002,12,16,25,53
10451,10003,6,13,16,35
10451,10004,0,3,4,7
10451,10005,1,0,5,6
10451,10006,0,0,1,1
10451,10007,0,0,1,1
10451,10009,8,14,40,62
10451,10010,2,4,26,32
10451,10011,7,5,25,37
10451,10012,3,2,12,17
10451,10013,5,2,12,19
10451,10014,5,2,9,16
10451,10016,8,7,38,53
10451,10017,6,0,4,10
10451,10018,0,2,6,8
10451,10019,6,7,19,32
10451,10021,4,4,24,32
10451,10022,3,4,15,22
10451,10023,6,27,41,74
10451,10024,8,14,58,80
10451,10025,20,40,92,152
10451,10026,26,38,84,148
10451,10027,31,74,78,183
10451,10028,6,6,31,43
10451,10029,42,82,112,236
10451,10030,27,24,62,113
10451,10031,44,69,77,190
10451,10032,33,86,74,193
10451,10033,27,65,76,168
10451,10034,19,49,69,137
10451,10035,27,47,55,129
10451,10036,6,3,16,25
10451,10037,6,23,51,80
10451,10038,0,5,7,12
10451,10039,21,49,52,122
10451,10040,30,59,57,146
10451,10044,1,2,10,13
10451,10065,3,3,16,22
10451,10069,0,2,1,3
10451,10075,2,7,18,27
10451,10128,10,9,65,84
10451,10280,1,1,4,6
10451,10282,0,2,2,4
10451,10301,6,3,26,35
10451,10302,3,4,9,16
10451,10303,5,8,16,29
10451,10304,4,7,23,34
10451,10305,3,3,20,26
10451,10306,9,11,20,40
10451,10307,2,0,6,8
10451,10308,3,3,15,21
10451,10309,4,8,16,28
10451,10310,3,5,12,20
10451,10312,7,8,35,50
10451,10314,5,14,50,69
10451,10451,147,248,120,515
10451,10452,146,229,128,503
10451,10453,105,212,125,442
10451,10454,61,114,62,237
10451,10455,93,144,66,303
10451,10456,177,340,143,660
10451,10457,108,219,85,412
10451,10458,111,222,107,440
10451,10459,70,117,82,269
10451,10460,76,167,84,327
10451,10461,31,64,135,230
10451,10462,91,129,183,403
10451,10463,40,74,135,249
10451,10464,2,2,17,21
10451,10465,30,57,99,186
10451,10466,66,97,124,287
10451,10467,99,196,149,444
10451,10468,101,170,106,377
10451,10469,50,88,155,293
10451,10470,8,17,27,52
10451,10471,9,10,44,63
10451,10472,83,150,92,325
10451,10473,41,120,123,284
10451,10474,14,28,16,58
10451,10475,31,49,112,192
10451,11001,0,1,5,6
10451,11004,2,1,18,21
10451,11005,0,0,2,2
10451,11040,0,0,2,2
10451,11101,12,15,31,58
10451,11102,8,25,47,80
10451,11103,8,14,43,65
10451,11104,5,22,32,59
10451,11105,6,19,52,77
10451,11106,12,18,47,77
10451,11109,1,0,7,8
10451,11201,8,5,32,45
10451,11203,11,42,60,113
10451,11204,7,10,22,39
10451,11205,5,12,15,32
10451,11206,9,23,44,76
10451,11207,17,27,45,89
10451,11208,19,30,50,99
10451,11209,3,9,30,42
10451,11210,9,12,46,67
10451,11211,12,18,32,62
10451,11212,13,34,63,110
10451,11213,16,22,39,77
10451,11214,11,22,29,62
10451,11215,6,10,38,54
10451,11216,8,14,34,56
10451,11217,6,2,23,31
10451,11218,5,5,25,35
10451,11219,4,20,22,46
10451,11220,14,13,32,59
10451,11221,11,18,33,62
10451,11222,5,10,17,32
10451,11223,6,23,28,57
10451,11224,3,8,16,27
10451,11225,10,11,49,70
10451,11226,18,40,54,112
10451,11228,4,10,21,35
10451,11229,6,12,35,53
10451,11230,13,16,43,72
10451,11231,3,2,20,25
10451,11232,3,3,11,17
10451,11233,16,26,32,74
10451,11234,18,21,69,108
10451,11235,4,10,27,41
10451,11236,9,20,76,105
10451,11237,3,16,37,56
10451,11238,13,4,30,47
10451,11239,1,2,6,9
10451,11354,12,17,36,65
10451,11355,27,25,56,108
10451,11356,13,15,29,57
10451,11357,6,16,47,69
10451,11358,10,14,31,55
10451,11360,3,2,24,29
10451,11361,3,2,18,23
10451,11362,2,4,15,21
10451,11363,1,0,1,2
10451,11364,5,10,22,37
10451,11365,8,9,38,55
10451,11366,4,3,8,15
10451,11367,6,3,32,41
10451,11368,24,57,52,133
10451,11369,15,24,39,78
10451,11370,13,14,22,49
10451,11371,0,2,0,2
10451,11372,20,24,64,108
10451,11373,14,46,69,129
10451,11374,1,13,30,44
10451,11375,9,14,56,79
10451,11377,17,57,87,161
10451,11378,5,10,22,37
10451,11379,3,12,20,35
10451,11385,13,32,69,114
10451,11411,2,6,19,27
10451,11412,10,13,26,49
10451,11413,5,9,50,64
10451,11414,2,3,8,13
10451,11415,3,5,13,21
10451,11416,3,9,20,32
10451,11417,3,7,13,23
10451,11418,6,10,21,37
10451,11419,4,16,33,53
10451,11420,6,16,32,54
10451,11421,3,10,21,34
10451,11422,6,7,25,38
10451,11423,6,4,26,36
10451,11426,5,1,14,20
10451,11427,2,7,22,31
10451,11428,2,5,29,36
10451,11429,4,6,27,37
10451,11432,6,13,40,59
10451,11433,5,12,23,40
10451,11434,16,19,43,78
10451,11435,9,16,37,62
10451,11436,3,4,12,19
10451,11691,9,11,27,47
10451,11692,1,8,15,24
10451,11693,1,1,6,8
10451,11694,3,3,8,14
10451,11697,1,1,0,2
10452,10001,0,2,5,7
10452,10002,2,4,13,19
10452,10003,5,3,7,15
10452,10005,0,0,2,2
10452,10006,1,0,1,2
10452,10007,1,0,2,3
10452,10009,2,3,10,15
10452,10010,0,0,8,8
10452,10011,4,2,10,16
10452,10012,0,2,2,4
10452,10013,2,1,2,5
10452,10014,1,2,4,7
10452,10016,0,0,7,7
10452,10017,0,0,1,1
10452,10019,3,7,7,17
10452,10021,2,3,14,19
10452,10022,0,0,2,2
10452,10023,8,10,23,41
10452,10024,2,4,24,30
10452,10025,7,16,36,59
10452,10026,6,20,18,44
10452,10027,12,33,41,86
10452,10028,2,5,13,20
10452,10029,16,42,31,89
10452,10030,10,15,25,50
10452,10031,10,23,32,65
10452,10032,17,29,24,70
10452,10033,7,29,32,68
10452,10034,13,15,20,48
10452,10035,18,17,19,54
10452,10036,1,0,2,3
10452,10037,12,6,12,30
10452,10038,3,0,3,6
10452,10039,12,20,23,55
10452,10040,7,21,32,60
10452,10044,2,0,0,2
10452,10065,2,6,8,16
10452,10069,0,0,1,1
10452,10075,3,1,10,14
10452,10128,5,6,29,40
10452,10282,0,0,1,1
10452,10301,0,0,7,7
10452,10302,1,0,4,5
10452,10303,2,0,3,5
10452,10304,2,2,10,14
10452,10305,0,2,7,9
10452,10306,3,2,12,17
10452,10307,0,0,2,2
10452,10308,1,1,9,11
10452,10309,0,0,4,4
10452,10310,1,2,4,7
10452,10312,0,6,15,21
10452,10314,4,5,11,20
10452,10451,32,60,39,131
10452,10452,254,419,105,778
10452,10453,90,143,41,274
10452,10454,28,24,21,73
10452,10455,14,61,35,110
10452,10456,96,117,59,272
10452,10457,49,95,49,193
10452,10458,45,77,57,179
10452,10459,22,56,27,105
10452,10460,31,64,32,127
10452,10461,13,25,49,87
10452,10462,27,35,80,142
10452,10463,25,33,60,118
10452,10464,2,4,5,11
10452,10465,9,22,34,65
10452,10466,22,33,53,108
10452,10467,33,85,55,173
10452,10468,33,89,25,147
10452,10469,25,45,64,134
10452,10470,5,5,8,18
10452,10471,6,13,21,40
10452,10472,28,42,39,109
10452,10473,37,50,47,134
10452,10474,6,13,9,28
10452,10475,5,16,40,61
10452,11004,1,1,2,4
10452,11005,0,1,0,1
10452,11101,7,4,11,22
10452,11102,7,11,9,27
10452,11103,10,9,17,36
10452,11104,0,1,7,8
10452,11105,6,4,19,29
10452,11106,3,11,20,34
10452,11109,1,0,1,2
10452,11201,3,1,14,18
10452,11203,3,7,13,23
10452,11204,1,3,6,10
10452,11205,1,3,11,15
10452,11206,4,11,19,34
10452,11207,7,17,15,39
10452,11208,8,24,16,48
10452,11209,2,3,5,10
10452,11210,4,3,11,18
10452,11211,2,5,19,26
10452,11212,3,10,15,28
10452,11213,2,6,6,14
10452,11214,2,6,13,21
10452,11215,1,1,11,13
10452,11216,4,6,10,20
10452,11217,2,1,9,12
10452,11218,2,3,7,12
10452,11219,4,2,11,17
10452,11220,5,4,9,18
10452,11221,3,10,11,24
10452,11222,0,2,4,6
10452,11223,1,5,4,10
10452,11224,1,2,9,12
10452,11225,3,4,8,15
10452,11226,4,7,24,35
10452,11228,1,1,3,5
10452,11229,3,7,6,16
10452,11230,2,5,10,17
10452,11231,3,2,17,22
10452,11232,1,4,5,10
10452,11233,1,9,8,18
10452,11234,3,4,13,20
10452,11235,3,7,6,16
10452,11236,5,6,19,30
10452,11237,2,10,7,19
10452,11238,2,3,10,15
10452,11239,2,1,1,4
10452,11354,6,13,18,37
10452,11355,11,11,13,35
10452,11356,3,6,7,16
10452,11357,11,6,22,39
10452,11358,6,7,19,32
10452,11360,2,3,7,12
10452,11361,1,4,6,11
10452,11362,1,5,8,14
10452,11363,0,0,4,4
10452,11364,1,2,10,13
10452,11365,6,1,14,21
10452,11366,2,2,1,5
10452,11367,3,7,4,14
10452,11368,9,10,13,32
10452,11369,5,3,3,11
10452,11370,1,6,8,15
10452,11372,3,6,18,27
10452,11373,4,5,8,17
10452,11374,1,1,10,12
10452,11375,0,4,21,25
10452,11377,4,8,24,36
10452,11378,0,4,9,13
10452,11379,0,2,5,7
10452,11385,3,11,24,38
10452,11411,1,0,4,5
10452,11412,3,6,10,19
10452,11413,2,3,10,15
10452,11414,0,3,6,9
10452,11415,2,2,4,8
10452,11416,1,3,8,12
10452,11417,2,5,6,13
10452,11418,2,4,4,10
10452,11419,1,3,9,13
10452,11420,1,3,6,10
10452,11421,3,4,4,11
10452,11422,0,1,9,10
10452,11423,1,1,5,7
10452,11426,0,1,5,6
10452,11427,1,3,5,9
10452,11428,1,1,5,7
10452,11429,3,0,5,8
10452,11432,1,10,9,20
10452,11433,2,5,7,14
10452,11434,2,6,13,21
10452,11435,3,7,8,18
10452,11436,1,1,3,5
10452,11691,4,5,12,21
10452,11692,0,1,1,2
10452,11693,0,0,1,1
10452,11694,0,0,3,3
10453,10001,2,4,2,8
10453,10002,6,9,11,26
10453,10003,3,2,5,10
10453,10005,0,1,0,1
10453,10007,0,1,2,3
10453,10009,1,7,15,23
10453,10010,0,0,1,1
10453,10011,0,5,5,10
10453,10012,0,1,0,1
10453,10013,1,1,5,7
10453,10014,1,2,4,7
10453,10016,3,3,2,8
10453,10017,0,1,2,3
10453,10019,3,3,4,10
10453,10021,0,0,7,7
10453,10022,1,2,3,6
10453,10023,3,9,15,27
10453,10024,0,4,9,13
10453,10025,5,11,23,39
10453,10026,4,13,23,40
10453,10027,16,25,22,63
10453,10028,2,2,4,8
10453,10029,16,35,26,77
10453,10030,3,15,19,37
10453,10031,13,28,21,62
10453,10032,11,24,20,55
10453,10033,24,26,24,74
10453,10034,9,30,37,76
10453,10035,8,14,12,34
10453,10036,1,0,3,4
10453,10037,2,8,14,24
10453,10038,1,0,1,2
10453,10039,9,10,15,34
10453,10040,11,26,21,58
10453,10044,0,2,2,4
10453,10065,2,0,7,9
10453,10069,0,1,1,2
10453,10075,0,2,2,4
10453,10128,2,3,9,14
10453,10301,3,3,11,17
10453,10302,0,1,5,6
10453,10303,1,2,5,8
10453,10304,4,4,7,15
10453,10305,1,1,8,10
10453,10306,1,0,6,7
10453,10307,0,1,3,4
10453,10308,0,3,5,8
10453,10309,3,2,4,9
10453,10310,2,0,4,6
10453,10312,0,4,11,15
10453,10314,2,2,16,20
10453,10451,21,52,40,113
10453,10452,69,105,58,232
10453,10453,231,331,90,652
10453,10454,18,35,26,79
10453,10455,13,43,24,80
10453,10456,61,95,67,223
10453,10457,54,102,36,192
10453,10458,54,77,27,158
10453,10459,31,57,32,120
10453,10460,24,60,44,128
10453,10461,25,26,41,92
10453,10462,34,62,58,154
10453,10463,18,55,66,139
10453,10464,1,0,4,5
10453,10465,16,16,38,70
10453,10466,17,44,47,108
10453,10467,45,88,63,196
10453,10468,79,114,63,256
10453,10469,19,52,69,140
10453,10470,3,9,18,30
10453,10471,8,8,24,40
10453,10472,14,62,34,110
10453,10473,27,47,65,139
10453,10474,2,12,4,18
10453,10475,9,21,24,54
10453,11001,0,1,0,1
10453,11004,0,2,2,4
10453,11005,0,1,0,1
10453,11040,1,0,1,2
10453,11101,2,4,4,10
10453,11102,3,1,5,9
10453,11103,1,1,7,9
10453,11104,2,0,4,6
10453,11105,3,2,8,13
10453,11106,3,5,7,15
10453,11201,1,3,9,13
10453,11203,8,10,9,27
10453,11204,4,0,4,8
10453,11205,1,2,7,10
10453,11206,5,10,12,27
10453,11207,6,12,11,29
10453,11208,7,15,19,41
10453,11209,1,4,14,19
10453,11210,3,2,11,16
10453,11211,5,6,7,18
10453,11212,8,11,12,31
10453,11213,1,6,8,15
10453,11214,7,4,10,21
10453,11215,2,4,11,17
10453,11216,3,5,8,16
10453,11217,2,2,6,10
10453,11218,1,2,8,11
10453,11219,8,4,12,24
10453,11220,9,6,22,37
10453,11221,6,8,11,25
10453,11222,0,1,9,10
10453,11223,2,4,8,14
10453,11224,0,2,11,13
10453,11225,1,11,13,25
10453,11226,7,6,12,25
10453,11228,3,1,3,7
10453,11229,3,4,6,13
10453,11230,3,3,11,17
10453,11231,0,2,3,5
10453,11232,3,1,1,5
10453,11233,7,11,11,29
10453,11234,6,6,12,24
10453,11235,1,5,9,15
10453,11236,4,9,15,28
10453,11237,4,8,2,14
10453,11238,3,4,8,15
10453,11239,2,3,3,8
10453,11354,9,7,11,27
10453,11355,7,9,14,30
10453,11356,2,3,3,8
10453,11357,4,2,9,15
10453,11358,1,4,4,9
10453,11360,2,0,5,7
10453,11361,3,5,3,11
10453,11362,0,1,7,8
10453,11363,1,1,1,3
10453,11364,3,0,7,10
10453,11365,1,4,10,15
10453,11366,0,1,4,5
10453,11367,2,1,10,13
10453,11368,6,8,10,24
10453,11369,4,2,6,12
10453,11370,1,4,5,10
10453,11372,6,5,8,19
10453,11373,5,6,6,17
10453,11374,2,0,10,12
10453,11375,1,2,7,10
10453,11377,4,8,24,36
10453,11378,0,3,5,8
10453,11379,0,1,5,6
10453,11385,4,10,20,34
10453,11411,2,1,3,6
10453,11412,2,1,6,9
10453,11413,6,2,10,18
10453,11414,1,2,4,7
10453,11415,2,0,7,9
10453,11416,1,3,3,7
10453,11417,0,1,9,10
10453,11418,5,3,7,15
10453,11419,5,5,6,16
10453,11420,6,6,5,17
10453,11421,2,2,3,7
10453,11422,1,2,8,11
10453,11423,2,1,7,10
10453,11426,2,2,0,4
10453,11427,1,0,4,5
10453,11428,1,2,2,5
10453,11429,2,0,4,6
10453,11432,4,12,12,28
10453,11433,2,5,7,14
10453,11434,3,11,17,31
10453,11435,5,5,15,25
10453,11436,1,2,6,9
10453,11691,3,7,20,30
10453,11692,1,2,1,4
10453,11693,0,2,2,4
10453,11694,0,2,4,6
10454,10001,3,7,12,22
10454,10002,16,11,17,44
10454,10003,5,6,10,21
10454,10004,1,2,6,9
10454,10005,0,0,1,1
10454,10006,1,0,0,1
10454,10007,0,0,2,2
10454,10009,7,6,21,34
10454,10010,2,12,7,21
10454,10011,6,7,14,27
10454,10012,1,0,7,8
10454,10013,2,2,6,10
10454,10014,1,4,10,15
10454,10016,2,9,19,30
10454,10017,2,4,12,18
10454,10018,1,1,3,5
10454,10019,6,4,13,23
10454,10021,3,3,16,22
10454,10022,6,7,9,22
10454,10023,2,9,23,34
10454,10024,1,4,12,17
10454,10025,9,27,40,76
10454,10026,8,22,22,52
10454,10027,12,13,43,68
10454,10028,3,7,19,29
10454,10029,27,51,53,131
10454,10030,7,17,19,43
10454,10031,23,27,27,77
10454,10032,19,39,39,97
10454,10033,7,36,21,64
10454,10034,6,32,34,72
10454,10035,5,28,22,55
10454,10036,3,6,15,24
10454,10037,5,14,19,38
10454,10038,1,1,3,5
10454,10039,5,16,22,43
10454,10040,17,23,32,72
10454,10044,0,3,1,4
10454,10065,5,3,9,17
10454,10069,0,1,0,1
10454,10075,1,1,10,12
10454,10128,6,9,31,46
10454,10280,0,1,5,6
10454,10301,2,6,10,18
10454,10302,3,3,2,8
10454,10303,3,3,5,11
10454,10304,3,6,12,21
10454,10305,2,5,13,20
10454,10306,1,4,21,26
10454,10307,0,2,2,4
10454,10308,2,3,8,13
10454,10309,1,1,8,10
10454,10310,1,1,10,12
10454,10312,3,5,12,20
10454,10314,4,5,26,35
10454,10451,44,80,41,165
10454,10452,42,96,65,203
10454,10453,46,77,52,175
10454,10454,138,171,69,378
10454,10455,51,95,51,197
10454,10456,85,118,72,275
10454,10457,39,103,67,209
10454,10458,38,83,67,188
10454,10459,30,71,71,172
10454,10460,34,55,66,155
10454,10461,28,40,54,122
10454,10462,43,80,100,223
10454,10463,21,42,62,125
10454,10464,4,2,3,9
10454,10465,15,31,62,108
10454,10466,22,58,75,155
10454,10467,35,84,101,220
10454,10468,31,89,71,191
10454,10469,27,72,58,157
10454,10470,5,12,18,35
10454,10471,4,9,21,34
10454,10472,37,74,65,176
10454,10473,39,50,78,167
10454,10474,4,17,17,38
10454,10475,6,20,32,58
10454,11001,0,0,1,1
10454,11004,1,1,8,10
10454,11005,0,0,1,1
10454,11040,1,0,0,1
10454,11101,7,9,24,40
10454,11102,7,10,27,44
10454,11103,3,10,38,51
10454,11104,6,8,17,31
10454,11105,4,24,26,54
10454,11106,7,11,30,48
10454,11109,0,0,3,3
10454,11201,0,5,15,20
10454,11203,1,11,25,37
10454,11204,0,3,11,14
10454,11205,3,9,10,22
10454,11206,6,16,19,41
10454,11207,8,16,21,45
10454,11208,5,24,18,47
10454,11209,1,6,15,22
10454,11210,3,9,11,23
10454,11211,0,10,19,29
10454,11212,5,15,19,39
10454,11213,4,7,19,30
10454,11214,4,3,10,17
10454,11215,1,6,7,14
10454,11216,7,9,18,34
10454,11217,0,4,6,10
10454,11218,2,5,8,15
10454,11219,1,9,5,15
10454,11220,4,9,17,30
10454,11221,8,13,19,40
10454,11222,3,6,11,20
10454,11223,2,3,27,32
10454,11224,0,2,7,9
10454,11225,3,12,19,34
10454,11226,7,19,23,49
10454,11228,3,0,7,10
10454,11229,1,9,15,25
10454,11230,1,8,15,24
10454,11231,2,5,9,16
10454,11232,0,6,4,10
10454,11233,3,9,17,29
10454,11234,0,12,19,31
10454,11235,3,3,13,19
10454,11236,3,7,31,41
10454,11237,1,6,14,21
10454,11238,3,8,16,27
10454,11239,0,1,4,5
10454,11354,9,7,17,33
10454,11355,6,20,19,45
10454,11356,2,7,19,28
10454,11357,3,14,24,41
10454,11358,8,11,20,39
10454,11359,1,0,0,1
10454,11360,1,5,10,16
10454,11361,1,0,8,9
10454,11362,1,1,2,4
10454,11363,0,1,1,2
10454,11364,3,2,8,13
10454,11365,3,1,16,20
10454,11366,0,1,3,4
10454,11367,3,8,16,27
10454,11368,18,31,33,82
10454,11369,4,6,33,43
10454,11370,6,5,14,25
10454,11371,1,1,0,2
10454,11372,6,16,22,44
10454,11373,13,40,38,91
10454,11374,5,9,11,25
10454,11375,4,8,25,37
10454,11377,22,27,58,107
10454,11378,4,7,21,32
10454,11379,4,16,32,52
10454,11385,8,37,51,96
10454,11411,1,1,7,9
10454,11412,2,7,14,23
10454,11413,0,3,15,18
10454,11414,1,5,13,19
10454,11415,0,4,5,9
10454,11416,2,4,8,14
10454,11417,2,5,5,12
10454,11418,1,8,14,23
10454,11419,4,3,10,17
10454,11420,0,9,14,23
10454,11421,1,12,13,26
10454,11422,0,4,8,12
10454,11423,1,6,9,16
10454,11426,1,5,6,12
10454,11427,1,6,11,18
10454,11428,0,1,6,7
10454,11429,0,4,7,11
10454,11432,3,14,29,46
10454,11433,3,1,6,10
10454,11434,3,10,17,30
10454,11435,3,11,17,31
10454,11436,0,3,7,10
10454,11691,3,9,9,21
10454,11692,1,3,6,10
10454,11693,1,2,0,3
10454,11694,0,1,6,7
10454,11697,0,1,2,3
10455,10001,3,4,8,15
10455,10002,14,17,13,44
10455,10003,6,1,14,21
10455,10006,0,1,0,1
10455,10007,2,2,1,5
10455,10009,5,11,8,24
10455,10010,1,6,2,9
10455,10011,6,6,5,17
10455,10012,0,0,4,4
10455,10013,1,1,4,6
10455,10014,2,4,5,11
10455,10016,3,5,9,17
10455,10017,0,2,3,5
10455,10018,0,2,1,3
10455,10019,7,5,9,21
10455,10021,3,4,7,14
10455,10022,0,3,5,8
10455,10023,4,6,21,31
10455,10024,7,14,19,40
10455,10025,16,22,35,73
10455,10026,11,29,12,52
10455,10027,32,74,29,135
10455,10028,5,5,14,24
10455,10029,48,68,46,162
10455,10030,21,38,19,78
10455,10031,37,61,32,130
10455,10032,17,60,39,116
10455,10033,37,61,32,130
10455,10034,31,36,27,94
10455,10035,33,33,29,95
10455,10036,2,4,5,11
10455,10037,11,19,7,37
10455,10038,2,0,0,2
10455,10039,28,39,15,82
10455,10040,24,35,34,93
10455,10044,1,3,1,5
10455,10065,3,8,7,18
10455,10069,0,0,4,4
10455,10075,1,2,5,8
10455,10128,8,11,20,39
10455,10280,0,2,1,3
10455,10282,1,0,0,1
10455,10301,1,5,12,18
10455,10302,2,2,4,8
10455,10303,3,6,5,14
10455,10304,9,13,10,32
10455,10305,1,5,11,17
10455,10306,1,4,14,19
10455,10307,0,0,2,2
10455,10308,0,2,7,9
10455,10309,1,1,7,9
10455,10310,1,5,12,18
10455,10312,1,5,17,23
10455,10314,4,6,28,38
10455,10451,92,152,57,301
10455,10452,103,188,76,367
10455,10453,109,171,71,351
10455,10454,87,135,53,275
10455,10455,145,193,92,430
10455,10456,162,276,100,538
10455,10457,96,175,72,343
10455,10458,83,112,72,267
10455,10459,83,150,58,291
10455,10460,76,143,73,292
10455,10461,22,57,69,148
10455,10462,54,118,86,258
10455,10463,31,54,47,132
10455,10464,2,1,5,8
10455,10465,15,42,52,109
10455,10466,53,101,64,218
10455,10467,93,136,98,327
10455,10468,82,142,84,308
10455,10469,53,97,62,212
10455,10470,6,16,10,32
10455,10471,12,13,18,43
10455,10472,67,109,67,243
10455,10473,57,80,77,214
10455,10474,17,43,29,89
10455,10475,15,35,50,100
10455,11001,0,0,4,4
10455,11004,2,4,3,9
10455,11040,0,1,1,2
10455,11101,9,14,18,41
10455,11102,10,12,10,32
10455,11103,10,10,23,43
10455,11104,4,6,19,29
10455,11105,11,12,24,47
10455,11106,7,13,26,46
10455,11109,0,1,2,3
10455,11201,2,8,5,15
10455,11203,16,18,19,53
10455,11204,7,9,9,25
10455,11205,4,7,6,17
10455,11206,8,17,15,40
10455,11207,22,22,29,73
10455,11208,16,35,23,74
10455,11209,6,6,13,25
10455,11210,12,9,11,32
10455,11211,9,4,11,24
10455,11212,17,27,19,63
10455,11213,10,12,12,34
10455,11214,5,11,12,28
10455,11215,3,3,13,19
10455,11216,7,18,15,40
10455,11217,1,6,6,13
10455,11218,7,8,9,24
10455,11219,4,11,5,20
10455,11220,7,10,15,32
10455,11221,18,19,13,50
10455,11222,1,4,6,11
10455,11223,2,2,15,19
10455,11224,5,9,14,28
10455,11225,9,13,11,33
10455,11226,14,23,23,60
10455,11228,0,1,4,5
10455,11229,7,6,18,31
10455,11230,5,9,10,24
10455,11231,2,7,8,17
10455,11232,3,2,1,6
10455,11233,21,30,19,70
10455,11234,12,9,20,41
10455,11235,3,6,14,23
10455,11236,11,14,28,53
10455,11237,11,4,6,21
10455,11238,7,7,17,31
10455,11239,2,11,4,17
10455,11354,11,15,24,50
10455,11355,13,24,12,49
10455,11356,6,6,8,20
10455,11357,9,5,20,34
10455,11358,8,12,24,44
10455,11359,0,0,1,1
10455,11360,3,6,7,16
10455,11361,1,2,8,11
10455,11362,2,1,7,10
10455,11363,0,2,2,4
10455,11364,3,4,8,15
10455,11365,4,6,10,20
10455,11366,0,1,1,2
10455,11367,2,8,14,24
10455,11368,15,39,33,87
10455,11369,16,7,22,45
10455,11370,10,4,14,28
10455,11371,0,2,0,2
10455,11372,14,18,14,46
10455,11373,12,27,31,70
10455,11374,4,4,12,20
10455,11375,2,5,16,23
10455,11377,24,30,32,86
10455,11378,5,8,25,38
10455,11379,1,5,9,15
10455,11385,7,13,25,45
10455,11411,2,2,5,9
10455,11412,0,9,10,19
10455,11413,6,11,16,33
10455,11414,2,0,6,8
10455,11415,4,4,8,16
10455,11416,7,4,5,16
10455,11417,2,10,12,24
10455,11418,4,7,14,25
10455,11419,2,6,17,25
10455,11420,3,14,14,31
10455,11421,6,7,14,27
10455,11422,2,8,9,19
10455,11423,8,7,11,26
10455,11426,1,3,8,12
10455,11427,2,4,9,15
10455,11428,0,4,4,8
10455,11429,8,2,8,18
10455,11432,5,9,15,29
10455,11433,4,10,10,24
10455,11434,9,19,15,43
10455,11435,8,13,15,36
10455,11436,6,5,5,16
10455,11691,7,14,14,35
10455,11692,0,5,3,8
10455,11693,0,2,5,7
10455,11694,2,1,2,5
10455,11697,0,0,1,1
10456,10001,0,1,3,4
10456,10002,2,8,14,24
10456,10003,0,3,10,13
10456,10004,0,0,2,2
10456,10005,0,2,1,3
10456,10009,0,3,17,20
10456,10010,0,1,7,8
10456,10011,0,7,6,13
10456,10012,0,2,8,10
10456,10013,3,0,10,13
10456,10014,0,3,4,7
10456,10016,1,1,13,15
10456,10017,1,0,5,6
10456,10018,0,0,1,1
10456,10019,1,1,12,14
10456,10021,1,1,14,16
10456,10022,0,1,9,10
10456,10023,0,2,26,28
10456,10024,1,5,30,36
10456,10025,16,15,53,84
10456,10026,10,26,24,60
10456,10027,9,36,56,101
10456,10028,0,4,24,28
10456,10029,10,39,59,108
10456,10030,8,26,34,68
10456,10031,19,30,46,95
10456,10032,7,20,37,64
10456,10033,9,24,49,82
10456,10034,6,28,41,75
10456,10035,5,20,40,65
10456,10036,1,1,3,5
10456,10037,3,13,20,36
10456,10038,0,0,3,3
10456,10039,8,21,32,61
10456,10040,10,29,30,69
10456,10044,0,3,10,13
10456,10065,4,3,15,22
10456,10069,0,1,3,4
10456,10075,1,1,11,13
10456,10128,3,10,35,48
10456,10162,0,0,1,1
10456,10280,0,1,0,1
10456,10301,2,3,15,20
10456,10302,1,4,6,11
10456,10303,1,4,12,17
10456,10304,0,3,7,10
10456,10305,1,4,16,21
10456,10306,4,8,23,35
10456,10307,0,1,5,6
10456,10308,0,0,8,8
10456,10309,2,4,13,19
10456,10310,0,2,3,5
10456,10312,2,4,17,23
10456,10314,4,6,21,31
10456,10451,40,105,96,241
10456,10452,51,122,107,280
10456,10453,37,129,101,267
10456,10454,23,42,43,108
10456,10455,30,62,65,157
10456,10456,195,350,153,698
10456,10457,35,144,145,324
10456,10458,28,111,85,224
10456,10459,44,92,74,210
10456,10460,27,109,73,209
10456,10461,18,48,78,144
10456,10462,43,79,140,262
10456,10463,23,50,92,165
10456,10464,3,6,4,13
10456,10465,20,48,60,128
10456,10466,23,84,117,224
10456,10467,44,108,133,285
10456,10468,30,83,60,173
10456,10469,16,66,105,187
10456,10470,5,16,33,54
10456,10471,2,11,44,57
10456,10472,31,71,77,179
10456,10473,17,86,102,205
10456,10474,6,24,6,36
10456,10475,7,55,86,148
10456,11001,0,0,2,2
10456,11004,0,1,5,6
10456,11040,0,0,1,1
10456,11101,0,9,14,23
10456,11102,5,22,32,59
10456,11103,6,13,22,41
10456,11104,4,5,9,18
10456,11105,5,16,37,58
10456,11106,11,10,29,50
10456,11109,0,0,2,2
10456,11201,2,1,12,15
10456,11203,8,11,29,48
10456,11204,1,7,4,12
10456,11205,1,4,11,16
10456,11206,2,12,25,39
10456,11207,11,14,35,60
10456,11208,3,18,30,51
10456,11209,1,6,17,24
10456,11210,2,14,16,32
10456,11211,5,7,23,35
10456,11212,11,24,22,57
10456,11213,8,10,23,41
10456,11214,1,1,12,14
10456,11215,3,1,14,18
10456,11216,3,4,19,26
10456,11217,2,2,12,16
10456,11218,1,5,10,16
10456,11219,2,2,5,9
10456,11220,2,6,24,32
10456,11221,1,13,18,32
10456,11222,0,0,7,7
10456,11223,2,3,16,21
10456,11224,2,2,7,11
10456,11225,2,5,13,20
10456,11226,7,19,36,62
10456,11228,1,1,8,10
10456,11229,1,4,9,14
10456,11230,3,5,12,20
10456,11231,0,6,10,16
10456,11232,2,1,5,8
10456,11233,5,22,28,55
10456,11234,1,14,22,37
10456,11235,0,6,6,12
10456,11236,3,26,33,62
10456,11237,1,8,10,19
10456,11238,2,6,15,23
10456,11239,1,9,7,17
10456,11354,11,12,32,55
10456,11355,8,24,38,70
10456,11356,2,9,13,24
10456,11357,2,11,42,55
10456,11358,5,8,17,30
10456,11360,0,3,14,17
10456,11361,1,4,12,17
10456,11362,0,1,3,4
10456,11363,0,0,4,4
10456,11364,0,0,8,8
10456,11365,3,7,16,26
10456,11366,1,1,5,7
10456,11367,1,7,16,24
10456,11368,9,15,21,45
10456,11369,6,7,20,33
10456,11370,3,6,4,13
10456,11371,0,1,1,2
10456,11372,3,7,20,30
10456,11373,8,15,20,43
10456,11374,0,4,12,16
10456,11375,0,6,21,27
10456,11377,7,27,26,60
10456,11378,0,3,10,13
10456,11379,0,2,13,15
10456,11385,4,12,31,47
10456,11411,0,3,12,15
10456,11412,2,6,17,25
10456,11413,3,8,12,23
10456,11414,1,4,5,10
10456,11415,3,1,5,9
10456,11416,2,2,9,13
10456,11417,1,5,10,16
10456,11418,1,6,10,17
10456,11419,1,4,8,13
10456,11420,3,9,9,21
10456,11421,1,3,13,17
10456,11422,0,8,11,19
10456,11423,1,6,8,15
10456,11426,0,4,3,7
10456,11427,2,5,6,13
10456,11428,1,3,5,9
10456,11429,1,10,17,28
10456,11432,7,11,14,32
10456,11433,2,7,7,16
10456,11434,0,11,27,38
10456,11435,3,9,27,39
10456,11436,1,3,3,7
10456,11691,3,9,24,36
10456,11692,0,1,11,12
10456,11693,0,2,1,3
10456,11694,1,1,3,5
10456,11697,1,0,0,1
10457,10001,0,2,8,10
10457,10002,7,8,15,30
10457,10003,4,2,20,26
10457,10004,0,1,0,1
10457,10005,0,0,1,1
10457,10007,0,0,1,1
10457,10009,3,6,17,26
10457,10010,3,2,15,20
10457,10011,5,2,22,29
10457,10012,3,0,3,6
10457,10013,0,0,4,4
10457,10014,0,1,6,7
10457,10016,2,5,23,30
10457,10017,0,0,2,2
10457,10018,0,0,1,1
10457,10019,2,4,17,23
10457,10021,0,1,17,18
10457,10022,0,0,11,11
10457,10023,5,7,30,42
10457,10024,2,7,26,35
10457,10025,10,21,56,87
10457,10026,9,30,42,81
10457,10027,16,36,67,119
10457,10028,1,2,30,33
10457,10029,21,45,72,138
10457,10030,6,21,33,60
10457,10031,9,35,83,127
10457,10032,11,46,61,118
10457,10033,18,35,64,117
10457,10034,19,40,60,119
10457,10035,3,30,30,63
10457,10036,0,0,7,7
10457,10037,4,13,26,43
10457,10038,0,0,5,5
10457,10039,13,27,34,74
10457,10040,9,22,47,78
10457,10044,0,0,7,7
10457,10065,0,1,18,19
10457,10069,0,1,3,4
10457,10075,0,0,17,17
10457,10128,5,2,28,35
10457,10162,1,0,0,1
10457,10280,0,1,2,3
10457,10282,0,0,1,1
10457,10301,0,6,10,16
10457,10302,0,1,8,9
10457,10303,0,5,8,13
10457,10304,1,7,14,22
10457,10305,2,4,10,16
10457,10306,2,4,20,26
10457,10307,0,0,8,8
10457,10308,1,3,16,20
10457,10309,0,4,14,18
10457,10310,1,3,13,17
10457,10312,3,5,24,32
10457,10314,4,6,34,44
10457,10451,45,85,110,240
10457,10452,51,142,144,337
10457,10453,83,167,145,395
10457,10454,17,59,49,125
10457,10455,18,64,86,168
10457,10456,70,228,191,489
10457,10457,165,343,265,773
10457,10458,79,182,222,483
10457,10459,43,88,97,228
10457,10460,50,127,134,311
10457,10461,20,75,185,280
10457,10462,44,103,248,395
10457,10463,24,76,181,281
10457,10464,3,2,9,14
10457,10465,18,43,125,186
10457,10466,33,112,210,355
10457,10467,51,158,236,445
10457,10468,45,154,120,319
10457,10469,41,98,241,380
10457,10470,1,19,49,69
10457,10471,9,10,63,82
10457,10472,34,100,103,237
10457,10473,41,117,159,317
10457,10474,6,24,16,46
10457,10475,17,51,161,229
10457,11001,0,2,2,4
10457,11004,0,1,9,10
10457,11005,0,0,1,1
10457,11040,0,1,4,5
10457,11101,1,6,18,25
10457,11102,1,9,18,28
10457,11103,5,5,33,43
10457,11104,0,2,13,15
10457,11105,2,7,22,31
10457,11106,2,6,27,35
10457,11109,0,0,1,1
10457,11201,1,5,15,21
10457,11203,2,25,29,56
10457,11204,1,7,14,22
10457,11205,3,5,15,23
10457,11206,1,12,31,44
10457,11207,5,26,27,58
10457,11208,6,25,17,48
10457,11209,2,7,24,33
10457,11210,2,8,21,31
10457,11211,6,8,22,36
10457,11212,4,24,48,76
10457,11213,2,9,21,32
10457,11214,5,7,17,29
10457,11215,3,3,16,22
10457,11216,2,12,18,32
10457,11217,1,4,14,19
10457,11218,2,5,10,17
10457,11219,7,3,18,28
10457,11220,4,8,23,35
10457,11221,2,12,34,48
10457,11222,4,5,7,16
10457,11223,3,7,21,31
10457,11224,3,6,10,19
10457,11225,2,11,11,24
10457,11226,3,20,21,44
10457,11228,1,0,20,21
10457,11229,3,7,27,37
10457,11230,2,4,15,21
10457,11231,1,1,6,8
10457,11232,0,4,3,7
10457,11233,7,21,16,44
10457,11234,1,9,32,42
10457,11235,1,7,12,20
10457,11236,6,12,42,60
10457,11237,1,3,13,17
10457,11238,2,9,19,30
10457,11239,1,3,5,9
10457,11354,4,7,29,40
10457,11355,4,17,27,48
10457,11356,2,4,11,17
10457,11357,1,19,18,38
10457,11358,1,10,19,30
10457,11359,0,1,0,1
10457,11360,0,1,9,10
10457,11361,0,3,14,17
10457,11362,0,3,13,16
10457,11363,0,0,6,6
10457,11364,2,2,23,27
10457,11365,2,9,16,27
10457,11366,0,3,7,10
10457,11367,4,8,19,31
10457,11368,6,10,24,40
10457,11369,4,4,6,14
10457,11370,2,5,11,18
10457,11372,3,10,18,31
10457,11373,9,14,17,40
10457,11374,0,2,17,19
10457,11375,0,8,40,48
10457,11377,5,17,38,60
10457,11378,3,5,7,15
10457,11379,4,5,17,26
10457,11385,3,17,34,54
10457,11411,3,2,8,13
10457,11412,4,7,22,33
10457,11413,4,7,39,50
10457,11414,0,6,10,16
10457,11415,2,3,6,11
10457,11416,0,4,7,11
10457,11417,1,7,15,23
10457,11418,3,4,10,17
10457,11419,0,5,22,27
10457,11420,1,11,17,29
10457,11421,1,3,15,19
10457,11422,3,4,20,27
10457,11423,0,8,14,22
10457,11426,1,2,13,16
10457,11427,0,3,10,13
10457,11428,0,5,7,12
10457,11429,2,3,18,23
10457,11432,6,4,34,44
10457,11433,0,5,16,21
10457,11434,6,6,33,45
10457,11435,3,8,25,36
10457,11436,4,7,9,20
10457,11691,2,6,19,27
10457,11692,1,4,6,11
10457,11693,1,0,6,7
10457,11694,3,2,8,13
10457,11697,1,0,0,1
10458,10001,3,2,4,9
10458,10002,11,12,13,36
10458,10003,5,4,15,24
10458,10004,0,0,1,1
10458,10005,2,1,1,4
10458,10006,0,0,1,1
10458,10007,1,0,2,3
10458,10009,9,10,16,35
10458,10010,4,3,10,17
10458,10011,8,5,14,27
10458,10012,2,1,4,7
10458,10013,2,0,3,5
10458,10014,3,2,6,11
10458,10016,4,1,11,16
10458,10017,0,2,1,3
10458,10018,0,0,2,2
10458,10019,10,2,15,27
10458,10021,13,2,22,37
10458,10022,5,2,13,20
10458,10023,17,9,28,54
10458,10024,16,8,22,46
10458,10025,29,25,38,92
10458,10026,21,18,42,81
10458,10027,28,32,43,103
10458,10028,6,2,14,22
10458,10029,41,32,68,141
10458,10030,16,29,32,77
10458,10031,33,56,57,146
10458,10032,38,68,42,148
10458,10033,46,47,46,139
10458,10034,37,46,51,134
10458,10035,13,21,18,52
10458,10036,7,3,6,16
10458,10037,8,10,21,39
10458,10038,2,3,0,5
10458,10039,11,21,29,61
10458,10040,30,55,41,126
10458,10044,1,0,8,9
10458,10065,6,1,19,26
10458,10069,0,0,2,2
10458,10075,4,0,11,15
10458,10128,15,5,31,51
10458,10162,0,1,1,2
10458,10280,1,0,3,4
10458,10282,0,1,1,2
10458,10301,2,1,12,15
10458,10302,2,0,3,5
10458,10303,0,1,7,8
10458,10304,5,2,7,14
10458,10305,3,3,12,18
10458,10306,2,8,17,27
10458,10307,0,1,10,11
10458,10308,1,2,6,9
10458,10309,0,1,9,10
10458,10310,2,1,8,11
10458,10312,1,1,28,30
10458,10314,8,9,25,42
10458,10451,47,94,57,198
10458,10452,116,151,75,342
10458,10453,147,215,73,435
10458,10454,33,67,25,125
10458,10455,39,81,31,151
10458,10456,149,187,98,434
10458,10457,190,199,82,471
10458,10458,372,522,146,1040
10458,10459,53,85,63,201
10458,10460,91,128,62,281
10458,10461,55,102,148,305
10458,10462,105,146,145,396
10458,10463,78,123,177,378
10458,10464,10,8,15,33
10458,10465,27,59,130,216
10458,10466,58,121,146,325
10458,10467,140,230,177,547
10458,10468,192,220,96,508
10458,10469,73,111,174,358
10458,10470,8,33,34,75
10458,10471,23,14,41,78
10458,10472,69,107,62,238
10458,10473,64,102,97,263
10458,10474,9,19,8,36
10458,10475,38,56,80,174
10458,11001,2,0,1,3
10458,11004,1,1,7,9
10458,11005,0,1,2,3
10458,11101,4,3,9,16
10458,11102,8,5,8,21
10458,11103,4,5,15,24
10458,11104,6,5,9,20
10458,11105,7,3,15,25
10458,11106,10,8,11,29
10458,11109,1,1,0,2
10458,11201,9,6,16,31
10458,11203,13,19,25,57
10458,11204,4,4,12,20
10458,11205,4,5,11,20
10458,11206,12,12,24,48
10458,11207,23,31,22,76
10458,11208,17,32,23,72
10458,11209,7,6,20,33
10458,11210,6,10,25,41
10458,11211,9,12,19,40
10458,11212,16,27,25,68
10458,11213,7,11,17,35
10458,11214,6,12,12,30
10458,11215,4,7,16,27
10458,11216,7,7,17,31
10458,11217,4,7,12,23
10458,11218,4,11,10,25
10458,11219,3,3,8,14
10458,11220,9,22,13,44
10458,11221,8,14,16,38
10458,11222,4,3,13,20
10458,11223,4,11,18,33
10458,11224,0,6,12,18
10458,11225,11,13,12,36
10458,11226,15,25,27,67
10458,11228,4,0,6,10
10458,11229,12,13,13,38
10458,11230,7,12,16,35
10458,11231,6,2,7,15
10458,11232,7,4,4,15
10458,11233,12,12,19,43
10458,11234,16,11,40,67
10458,11235,5,6,22,33
10458,11236,11,25,39,75
10458,11237,7,10,6,23
10458,11238,12,7,21,40
10458,11239,1,2,4,7
10458,11354,6,11,14,31
10458,11355,14,9,28,51
10458,11356,3,5,15,23
10458,11357,5,12,21,38
10458,11358,6,10,18,34
10458,11359,0,0,1,1
10458,11360,3,1,7,11
10458,11361,2,3,9,14
10458,11362,1,3,7,11
10458,11363,1,0,3,4
10458,11364,9,4,15,28
10458,11365,9,7,13,29
10458,11366,0,0,4,4
10458,11367,12,7,13,32
10458,11368,15,22,25,62
10458,11369,7,4,9,20
10458,11370,5,6,7,18
10458,11372,9,13,15,37
10458,11373,10,25,25,60
10458,11374,3,3,25,31
10458,11375,7,9,23,39
10458,11377,13,11,22,46
10458,11378,5,2,15,22
10458,11379,4,2,19,25
10458,11385,22,15,31,68
10458,11411,4,3,7,14
10458,11412,3,6,9,18
10458,11413,7,7,21,35
10458,11414,6,2,7,15
10458,11415,3,5,7,15
10458,11416,3,5,7,15
10458,11417,3,5,4,12
10458,11418,9,7,17,33
10458,11419,5,14,13,32
10458,11420,1,5,23,29
10458,11421,16,9,16,41
10458,11422,2,6,14,22
10458,11423,3,5,7,15
10458,11426,3,0,12,15
10458,11427,6,0,6,12
10458,11428,5,6,7,18
10458,11429,10,4,5,19
10458,11432,12,13,14,39
10458,11433,6,7,11,24
10458,11434,10,9,16,35
10458,11435,7,12,20,39
10458,11436,4,3,4,11
10458,11691,10,13,13,36
10458,11692,4,3,6,13
10458,11693,0,1,4,5
10458,11694,4,2,6,12
10458,11697,1,0,3,4
10459,10001,1,3,2,6
10459,10002,4,8,13,25
10459,10003,1,4,5,10
10459,10006,0,0,1,1
10459,10007,0,0,1,1
10459,10009,4,7,8,19
10459,10010,0,1,3,4
10459,10011,0,4,8,12
10459,10012,0,1,2,3
10459,10014,0,4,3,7
10459,10016,1,1,4,6
10459,10017,0,0,2,2
10459,10019,1,3,5,9
10459,10021,1,3,4,8
10459,10022,0,1,5,6
10459,10023,3,3,17,23
10459,10024,1,7,9,17
10459,10025,10,16,46,72
10459,10026,5,12,13,30
10459,10027,15,21,29,65
10459,10028,1,4,13,18
10459,10029,10,23,31,64
10459,10030,2,11,17,30
10459,10031,9,35,28,72
10459,10032,10,22,21,53
10459,10033,12,23,20,55
10459,10034,4,22,7,33
10459,10035,8,13,19,40
10459,10036,0,1,2,3
10459,10037,5,8,12,25
10459,10038,0,2,3,5
10459,10039,9,12,15,36
10459,10040,8,21,16,45
10459,10044,1,1,1,3
10459,10065,5,1,12,18
10459,10069,1,0,0,1
10459,10075,0,2,4,6
10459,10128,4,6,17,27
10459,10162,0,1,0,1
10459,10280,0,0,1,1
10459,10282,0,1,2,3
10459,10301,3,6,7,16
10459,10302,1,0,2,3
10459,10303,1,5,3,9
10459,10304,3,4,3,10
10459,10305,0,4,13,17
10459,10306,1,5,13,19
10459,10307,1,1,3,5
10459,10308,0,2,7,9
10459,10309,0,1,7,8
10459,10310,3,1,4,8
10459,10312,3,5,15,23
10459,10314,1,4,10,15
10459,10451,14,42,34,90
10459,10452,30,75,39,144
10459,10453,27,96,39,162
10459,10454,22,49,22,93
10459,10455,38,79,25,142
10459,10456,53,166,77,296
10459,10457,40,82,42,164
10459,10458,32,69,27,128
10459,10459,134,244,93,471
10459,10460,35,89,57,181
10459,10461,21,34,51,106
10459,10462,25,81,74,180
10459,10463,17,35,47,99
10459,10464,4,1,4,9
10459,10465,11,19,30,60
10459,10466,38,69,41,148
10459,10467,23,71,61,155
10459,10468,21,53,37,111
10459,10469,20,63,49,132
10459,10470,5,4,16,25
10459,10471,5,8,13,26
10459,10472,36,80,27,143
10459,10473,33,94,58,185
10459,10474,14,46,24,84
10459,10475,1,25,28,54
10459,11003,0,1,0,1
10459,11004,1,5,7,13
10459,11040,0,1,1,2
10459,11101,7,17,11,35
10459,11102,7,12,16,35
10459,11103,6,11,20,37
10459,11104,0,0,8,8
10459,11105,4,13,18,35
10459,11106,9,17,17,43
10459,11109,0,1,4,5
10459,11201,3,4,6,13
10459,11203,6,12,12,30
10459,11204,2,5,7,14
10459,11205,3,6,6,15
10459,11206,4,15,18,37
10459,11207,9,26,14,49
10459,11208,6,25,18,49
10459,11209,6,6,13,25
10459,11210,2,8,11,21
10459,11211,4,4,13,21
10459,11212,9,18,16,43
10459,11213,7,4,13,24
10459,11214,2,5,11,18
10459,11215,4,4,11,19
10459,11216,3,10,9,22
10459,11217,4,1,6,11
10459,11218,1,5,7,13
10459,11219,1,4,5,10
10459,11220,2,4,8,14
10459,11221,3,21,13,37
10459,11222,2,3,6,11
10459,11223,1,8,8,17
10459,11224,3,5,4,12
10459,11225,4,6,12,22
10459,11226,4,11,17,32
10459,11228,0,3,8,11
10459,11229,2,3,9,14
10459,11230,1,7,19,27
10459,11231,0,4,4,8
10459,11232,0,4,3,7
10459,11233,5,9,9,23
10459,11234,7,12,21,40
10459,11235,3,3,9,15
10459,11236,7,13,20,40
10459,11237,4,6,5,15
10459,11238,2,5,9,16
10459,11239,2,3,3,8
10459,11354,6,13,10,29
10459,11355,12,13,17,42
10459,11356,3,9,12,24
10459,11357,4,11,24,39
10459,11358,9,5,17,31
10459,11359,1,0,0,1
10459,11360,0,3,10,13
10459,11361,1,4,7,12
10459,11362,0,4,9,13
10459,11363,0,2,0,2
10459,11364,1,1,11,13
10459,11365,1,5,9,15
10459,11366,0,0,2,2
10459,11367,3,4,9,16
10459,11368,10,33,29,72
10459,11369,5,17,9,31
10459,11370,2,6,7,15
10459,11371,0,1,1,2
10459,11372,8,8,21,37
10459,11373,8,18,17,43
10459,11374,4,2,5,11
10459,11375,1,0,15,16
10459,11377,8,15,22,45
10459,11378,1,2,9,12
10459,11379,0,3,8,11
10459,11385,8,17,23,48
10459,11411,0,1,4,5
10459,11412,0,7,8,15
10459,11413,2,3,4,9
10459,11414,2,3,6,11
10459,11415,0,2,1,3
10459,11416,1,4,3,8
10459,11417,3,3,3,9
10459,11418,3,4,4,11
10459,11419,4,11,8,23
10459,11420,0,7,11,18
10459,11421,2,8,13,23
10459,11422,3,7,6,16
10459,11423,2,5,4,11
10459,11426,1,2,5,8
10459,11427,4,2,7,13
10459,11428,0,3,6,9
10459,11429,1,4,6,11
10459,11430,0,1,0,1
10459,11432,1,7,10,18
10459,11433,2,6,5,13
10459,11434,3,14,15,32
10459,11435,4,8,17,29
10459,11436,0,6,5,11
10459,11691,3,6,5,14
10459,11692,0,2,1,3
10459,11693,0,0,1,1
10459,11694,0,0,9,9
10459,11697,1,0,2,3
10460,10001,2,1,2,5
10460,10002,0,3,6,9
10460,10003,2,2,3,7
10460,10005,0,1,0,1
10460,10006,0,0,1,1
10460,10009,3,3,6,12
10460,10010,0,3,1,4
10460,10011,4,3,10,17
10460,10012,1,1,3,5
10460,10013,1,1,2,4
10460,10014,0,2,4,6
10460,10016,0,3,6,9
10460,10017,1,0,1,2
10460,10019,0,2,3,5
10460,10021,0,1,6,7
10460,10022,0,0,2,2
10460,10023,0,6,11,17
10460,10024,2,5,6,13
10460,10025,2,11,28,41
10460,10026,8,11,13,32
10460,10027,11,23,30,64
10460,10028,2,0,8,10
10460,10029,18,24,25,67
10460,10030,5,10,14,29
10460,10031,8,16,24,48
10460,10032,13,13,16,42
10460,10033,10,9,12,31
10460,10034,22,29,18,69
10460,10035,8,23,8,39
10460,10036,1,0,0,1
10460,10037,3,5,6,14
10460,10038,2,0,0,2
10460,10039,6,6,11,23
10460,10040,7,16,22,45
10460,10044,0,1,1,2
10460,10065,0,0,2,2
10460,10069,0,1,1,2
10460,10075,1,0,2,3
10460,10128,1,4,5,10
10460,10162,1,0,0,1
10460,10280,0,0,1,1
10460,10282,1,0,1,2
10460,10301,3,5,8,16
10460,10302,2,1,4,7
10460,10303,6,3,5,14
10460,10304,4,4,6,14
10460,10305,3,3,5,11
10460,10306,0,1,12,13
10460,10307,1,2,2,5
10460,10308,1,0,4,5
10460,10309,0,0,6,6
10460,10310,2,0,4,6
10460,10312,1,1,13,15
10460,10314,7,6,17,30
10460,10451,34,35,20,89
10460,10452,31,55,29,115
10460,10453,29,61,39,129
10460,10454,20,23,12,55
10460,10455,13,36,26,75
10460,10456,54,77,34,165
10460,10457,69,65,43,177
10460,10458,42,72,54,168
10460,10459,36,66,23,125
10460,10460,120,165,55,340
10460,10461,21,24,59,104
10460,10462,40,71,56,167
10460,10463,17,31,30,78
10460,10464,0,1,9,10
10460,10465,19,15,45,79
10460,10466,39,37,41,117
10460,10467,40,86,65,191
10460,10468,30,68,26,124
10460,10469,32,52,43,127
10460,10470,4,10,21,35
10460,10471,5,3,24,32
10460,10472,44,66,26,136
10460,10473,23,66,31,120
10460,10474,7,6,4,17
10460,10475,13,25,30,68
10460,11001,0,1,0,1
10460,11004,0,1,6,7
10460,11040,1,0,3,4
10460,11101,0,3,1,4
10460,11102,6,6,13,25
10460,11103,7,3,10,20
10460,11104,1,0,2,3
10460,11105,4,7,11,22
10460,11106,2,9,13,24
10460,11109,0,1,0,1
10460,11201,2,1,12,15
10460,11203,2,11,14,27
10460,11204,2,5,8,15
10460,11205,4,3,3,10
10460,11206,5,6,8,19
10460,11207,5,8,17,30
10460,11208,4,13,10,27
10460,11209,4,6,10,20
10460,11210,1,3,8,12
10460,11211,1,7,12,20
10460,11212,9,9,11,29
10460,11213,1,2,22,25
10460,11214,1,3,4,8
10460,11215,0,3,16,19
10460,11216,3,4,6,13
10460,11217,3,4,2,9
10460,11218,0,3,6,9
10460,11219,2,1,9,12
10460,11220,2,2,9,13
10460,11221,3,12,13,28
10460,11222,0,8,11,19
10460,11223,3,1,9,13
10460,11224,1,3,5,9
10460,11225,8,2,12,22
10460,11226,9,4,14,27
10460,11228,1,1,2,4
10460,11229,5,2,8,15
10460,11230,3,4,15,22
10460,11231,0,0,8,8
10460,11232,1,3,6,10
10460,11233,4,11,10,25
10460,11234,5,10,19,34
10460,11235,5,5,10,20
10460,11236,4,4,8,16
10460,11237,1,9,8,18
10460,11238,1,5,9,15
10460,11239,0,2,0,2
10460,11354,5,10,15,30
10460,11355,11,11,14,36
10460,11356,3,5,11,19
10460,11357,3,11,19,33
10460,11358,1,8,6,15
10460,11359,0,0,1,1
10460,11360,2,2,10,14
10460,11361,1,2,9,12
10460,11362,3,3,4,10
10460,11363,3,0,2,5
10460,11364,1,5,4,10
10460,11365,3,4,8,15
10460,11366,2,2,3,7
10460,11367,2,2,14,18
10460,11368,9,9,19,37
10460,11369,0,2,1,3
10460,11370,0,6,5,11
10460,11372,2,13,11,26
10460,11373,8,9,16,33
10460,11374,1,4,7,12
10460,11375,2,5,15,22
10460,11377,4,7,10,21
10460,11378,1,1,7,9
10460,11379,2,5,9,16
10460,11385,3,12,20,35
10460,11411,0,0,7,7
10460,11412,2,4,8,14
10460,11413,0,4,12,16
10460,11414,1,5,4,10
10460,11415,0,3,2,5
10460,11416,0,1,6,7
10460,11417,0,2,5,7
10460,11418,1,1,6,8
10460,11419,1,2,15,18
10460,11420,0,2,9,11
10460,11421,3,3,9,15
10460,11422,2,2,6,10
10460,11423,1,2,6,9
10460,11426,0,1,1,2
10460,11427,2,3,6,11
10460,11428,0,3,3,6
10460,11429,3,1,4,8
10460,11432,1,3,14,18
10460,11433,2,3,8,13
10460,11434,3,5,10,18
10460,11435,1,5,7,13
10460,11436,1,3,2,6
10460,11691,3,4,9,16
10460,11692,0,1,1,2
10460,11693,0,2,1,3
10460,11694,0,2,3,5
10461,10001,9,2,8,19
10461,10002,13,27,26,66
10461,10003,10,11,30,51
10461,10004,0,1,0,1
10461,10005,0,1,4,5
10461,10006,0,0,3,3
10461,10007,2,1,4,7
10461,10009,8,8,33,49
10461,10010,2,7,22,31
10461,10011,7,8,25,40
10461,10012,3,7,8,18
10461,10013,2,7,5,14
10461,10014,2,3,19,24
10461,10016,7,8,29,44
10461,10017,0,3,11,14
10461,10018,3,2,2,7
10461,10019,7,8,19,34
10461,10021,8,3,38,49
10461,10022,0,3,24,27
10461,10023,14,7,56,77
10461,10024,3,7,36,46
10461,10025,18,25,72,115
10461,10026,26,27,37,90
10461,10027,28,45,77,150
10461,10028,2,11,46,59
10461,10029,46,69,92,207
10461,10030,18,28,34,80
10461,10031,33,55,66,154
10461,10032,36,69,64,169
10461,10033,42,65,77,184
10461,10034,40,66,80,186
10461,10035,23,34,40,97
10461,10036,6,2,11,19
10461,10037,7,14,27,48
10461,10038,2,6,7,15
10461,10039,16,17,33,66
10461,10040,30,56,49,135
10461,10044,3,2,19,24
10461,10065,2,4,37,43
10461,10069,2,4,5,11
10461,10075,2,4,32,38
10461,10128,2,12,70,84
10461,10162,0,0,1,1
10461,10280,1,0,1,2
10461,10282,0,0,3,3
10461,10301,7,15,25,47
10461,10302,3,6,12,21
10461,10303,7,9,18,34
10461,10304,6,9,25,40
10461,10305,6,12,21,39
10461,10306,6,7,34,47
10461,10307,1,4,9,14
10461,10308,2,4,7,13
10461,10309,3,9,15,27
10461,10310,6,5,12,23
10461,10312,8,7,25,40
10461,10314,13,28,47,88
10461,10451,82,102,90,274
10461,10452,110,210,145,465
10461,10453,118,223,169,510
10461,10454,34,86,58,178
10461,10455,44,113,86,243
10461,10456,143,258,213,614
10461,10457,109,259,127,495
10461,10458,121,220,166,507
10461,10459,78,166,95,339
10461,10460,111,227,145,483
10461,10461,329,615,745,1689
10461,10462,203,406,450,1059
10461,10463,78,109,257,444
10461,10464,12,13,53,78
10461,10465,167,184,292,643
10461,10466,110,283,363,756
10461,10467,167,393,488,1048
10461,10468,124,237,163,524
10461,10469,138,274,461,873
10461,10470,15,37,70,122
10461,10471,13,29,97,139
10461,10472,96,255,149,500
10461,10473,142,214,264,620
10461,10474,26,36,16,78
10461,10475,78,138,275,491
10461,11001,2,2,2,6
10461,11004,5,14,28,47
10461,11005,0,0,3,3
10461,11040,0,1,2,3
10461,11101,9,11,26,46
10461,11102,5,11,21,37
10461,11103,7,5,23,35
10461,11104,9,4,17,30
10461,11105,6,8,33,47
10461,11106,10,14,29,53
10461,11109,2,2,2,6
10461,11201,2,10,34,46
10461,11203,17,42,62,121
10461,11204,15,18,25,58
10461,11205,13,14,21,48
10461,11206,13,24,41,78
10461,11207,43,62,40,145
10461,11208,31,68,48,147
10461,11209,5,10,35,50
10461,11210,18,28,45,91
10461,11211,7,16,37,60
10461,11212,29,38,71,138
10461,11213,19,30,43,92
10461,11214,12,28,38,78
10461,11215,7,15,33,55
10461,11216,21,22,24,67
10461,11217,6,8,16,30
10461,11218,11,12,33,56
10461,11219,10,16,34,60
10461,11220,19,22,23,64
10461,11221,26,30,34,90
10461,11222,1,4,4,9
10461,11223,16,26,31,73
10461,11224,10,19,24,53
10461,11225,16,24,31,71
10461,11226,25,50,67,142
10461,11228,7,8,15,30
10461,11229,13,17,34,64
10461,11230,7,15,34,56
10461,11231,4,8,15,27
10461,11232,5,9,8,22
10461,11233,26,32,46,104
10461,11234,15,42,67,124
10461,11235,17,17,51,85
10461,11236,24,55,68,147
10461,11237,10,18,14,42
10461,11238,6,16,35,57
10461,11239,5,10,8,23
10461,11354,52,50,85,187
10461,11355,76,67,100,243
10461,11356,11,16,30,57
10461,11357,17,44,86,147
10461,11358,21,21,50,92
10461,11359,0,1,5,6
10461,11360,9,12,35,56
10461,11361,10,13,27,50
10461,11362,6,11,21,38
10461,11363,0,5,11,16
10461,11364,12,18,47,77
10461,11365,15,15,43,73
10461,11366,2,3,18,23
10461,11367,7,17,52,76
10461,11368,31,62,50,143
10461,11369,9,19,24,52
10461,11370,7,12,18,37
10461,11372,16,31,42,89
10461,11373,29,42,60,131
10461,11374,5,15,57,77
10461,11375,10,14,79,103
10461,11377,20,19,61,100
10461,11378,4,5,28,37
10461,11379,6,13,34,53
10461,11385,11,21,72,104
10461,11411,7,12,15,34
10461,11412,10,17,36,63
10461,11413,14,18,44,76
10461,11414,3,6,21,30
10461,11415,2,4,20,26
10461,11416,1,11,26,38
10461,11417,9,8,18,35
10461,11418,7,16,27,50
10461,11419,10,15,42,67
10461,11420,12,17,29,58
10461,11421,14,21,32,67
10461,11422,7,17,35,59
10461,11423,10,9,24,43
10461,11426,6,10,31,47
10461,11427,7,16,34,57
10461,11428,5,12,20,37
10461,11429,11,14,30,55
10461,11432,17,30,62,109
10461,11433,15,12,34,61
10461,11434,27,37,57,121
10461,11435,18,23,45,86
10461,11436,4,8,16,28
10461,11691,17,30,44,91
10461,11692,7,6,13,26
10461,11693,3,4,3,10
10461,11694,1,7,16,24
10461,11697,2,0,5,7
10462,10001,2,2,2,6
10462,10002,4,12,12,28
10462,10003,2,8,9,19
10462,10004,0,0,1,1
10462,10006,0,0,1,1
10462,10007,1,0,2,3
10462,10009,6,8,11,25
10462,10010,2,1,5,8
10462,10011,3,2,8,13
10462,10012,0,2,3,5
10462,10013,3,2,4,9
10462,10014,2,1,5,8
10462,10016,2,2,7,11
10462,10017,0,1,2,3
10462,10018,0,0,2,2
10462,10019,2,4,6,12
10462,10021,2,2,8,12
10462,10022,1,0,5,6
10462,10023,3,2,6,11
10462,10024,2,6,8,16
10462,10025,18,13,15,46
10462,10026,13,17,14,44
10462,10027,13,21,14,48
10462,10028,1,2,5,8
10462,10029,25,45,27,97
10462,10030,10,14,12,36
10462,10031,29,47,21,97
10462,10032,28,75,28,131
10462,10033,27,78,13,118
10462,10034,34,57,27,118
10462,10035,9,16,11,36
10462,10036,5,3,3,11
10462,10037,4,6,9,19
10462,10038,0,0,6,6
10462,10039,18,26,7,51
10462,10040,50,57,20,127
10462,10044,1,2,4,7
10462,10065,0,2,3,5
10462,10069,0,0,1,1
10462,10075,0,1,3,4
10462,10119,0,0,1,1
10462,10128,2,7,8,17
10462,10280,0,2,1,3
10462,10282,1,0,1,2
10462,10301,6,3,13,22
10462,10302,0,2,4,6
10462,10303,2,5,5,12
10462,10304,1,2,13,16
10462,10305,4,5,14,23
10462,10306,2,4,17,23
10462,10307,1,2,5,8
10462,10308,0,1,15,16
10462,10309,1,1,18,20
10462,10310,2,4,13,19
10462,10312,1,2,25,28
10462,10314,6,12,25,43
10462,10451,86,130,20,236
10462,10452,125,201,51,377
10462,10453,121,204,35,360
10462,10454,50,80,15,145
10462,10455,75,100,26,201
10462,10456,171,242,51,464
10462,10457,160,228,50,438
10462,10458,116,224,42,382
10462,10459,76,124,37,237
10462,10460,159,208,64,431
10462,10461,101,158,97,356
10462,10462,377,506,248,1131
10462,10463,56,100,55,211
10462,10464,6,4,3,13
10462,10465,58,88,96,242
10462,10466,71,155,73,299
10462,10467,157,281,77,515
10462,10468,140,205,69,414
10462,10469,81,148,88,317
10462,10470,18,22,29,69
10462,10471,11,16,25,52
10462,10472,193,239,63,495
10462,10473,121,164,94,379
10462,10474,17,14,4,35
10462,10475,33,87,47,167
10462,11001,1,2,3,6
10462,11004,3,4,3,10
10462,11005,1,1,0,2
10462,11040,0,1,1,2
10462,11101,3,1,7,11
10462,11102,5,10,5,20
10462,11103,4,11,10,25
10462,11104,4,3,6,13
10462,11105,5,6,19,30
10462,11106,5,9,10,24
10462,11109,1,0,2,3
10462,11201,1,11,4,16
10462,11203,14,30,18,62
10462,11204,7,14,12,33
10462,11205,2,7,7,16
10462,11206,19,15,12,46
10462,11207,20,42,17,79
10462,11208,42,51,19,112
10462,11209,5,4,17,26
10462,11210,11,13,14,38
10462,11211,10,12,7,29
10462,11212,26,35,11,72
10462,11213,15,14,12,41
10462,11214,11,15,6,32
10462,11215,7,3,11,21
10462,11216,1,13,9,23
10462,11217,6,4,5,15
10462,11218,11,10,9,30
10462,11219,9,8,11,28
10462,11220,50,14,12,76
10462,11221,7,26,15,48
10462,11222,2,3,3,8
10462,11223,3,11,9,23
10462,11224,3,7,7,17
10462,11225,9,18,9,36
10462,11226,20,22,22,64
10462,11228,3,4,8,15
10462,11229,3,7,12,22
10462,11230,9,6,14,29
10462,11231,4,0,2,6
10462,11232,7,5,2,14
10462,11233,14,26,14,54
10462,11234,9,15,18,42
10462,11235,5,5,8,18
10462,11236,19,21,17,57
10462,11237,5,19,6,30
10462,11238,4,9,10,23
10462,11239,3,9,3,15
10462,11354,47,21,25,93
10462,11355,79,48,25,152
10462,11356,13,13,14,40
10462,11357,13,19,22,54
10462,11358,20,18,15,53
10462,11359,0,1,0,1
10462,11360,4,5,15,24
10462,11361,6,9,15,30
10462,11362,2,1,2,5
10462,11363,2,0,1,3
10462,11364,7,9,11,27
10462,11365,12,18,19,49
10462,11366,3,3,4,10
10462,11367,11,13,15,39
10462,11368,33,36,20,89
10462,11369,13,5,6,24
10462,11370,7,5,10,22
10462,11372,15,22,14,51
10462,11373,30,24,24,78
10462,11374,3,9,9,21
10462,11375,5,6,30,41
10462,11377,9,21,26,56
10462,11378,7,3,10,20
10462,11379,6,1,7,14
10462,11385,16,19,18,53
10462,11411,5,5,4,14
10462,11412,5,7,12,24
10462,11413,5,5,11,21
10462,11414,1,3,10,14
10462,11415,3,5,6,14
10462,11416,3,8,7,18
10462,11417,8,9,6,23
10462,11418,8,18,3,29
10462,11419,7,25,13,45
10462,11420,4,15,9,28
10462,11421,3,8,7,18
10462,11422,3,5,10,18
10462,11423,4,9,5,18
10462,11426,1,3,7,11
10462,11427,6,8,7,21
10462,11428,3,4,10,17
10462,11429,5,1,15,21
10462,11432,17,20,17,54
10462,11433,9,5,12,26
10462,11434,13,15,16,44
10462,11435,15,15,21,51
10462,11436,4,7,3,14
10462,11691,11,7,14,32
10462,11692,5,5,3,13
10462,11693,0,3,3,6
10462,11694,2,3,3,8
10463,10001,0,6,5,11
10463,10002,4,16,10,30
10463,10003,2,6,8,16
10463,10004,1,0,0,1
10463,10005,0,1,0,1
10463,10006,0,1,0,1
10463,10007,1,1,0,2
10463,10009,5,10,8,23
10463,10010,1,3,5,9
10463,10011,4,6,7,17
10463,10012,1,0,3,4
10463,10013,0,0,5,5
10463,10014,2,4,3,9
10463,10016,2,0,11,13
10463,10017,0,0,4,4
10463,10018,0,1,1,2
10463,10019,0,9,10,19
10463,10021,3,3,7,13
10463,10022,1,0,6,7
10463,10023,7,8,20,35
10463,10024,9,14,16,39
10463,10025,15,20,26,61
10463,10026,19,26,16,61
10463,10027,21,37,22,80
10463,10028,0,5,6,11
10463,10029,25,35,15,75
10463,10030,11,31,19,61
10463,10031,43,39,27,109
10463,10032,19,45,30,94
10463,10033,34,60,46,140
10463,10034,19,80,34,133
10463,10035,8,21,6,35
10463,10036,3,0,5,8
10463,10037,6,14,14,34
10463,10038,0,1,0,1
10463,10039,15,17,16,48
10463,10040,34,61,35,130
10463,10044,0,3,2,5
10463,10065,0,1,4,5
10463,10069,1,1,1,3
10463,10075,1,2,7,10
10463,10119,0,1,0,1
10463,10128,4,8,13,25
10463,10282,1,0,0,1
10463,10301,7,4,6,17
10463,10302,2,2,3,7
10463,10303,1,3,5,9
10463,10304,7,8,5,20
10463,10305,1,5,16,22
10463,10306,3,14,10,27
10463,10307,1,2,3,6
10463,10308,2,5,8,15
10463,10309,1,1,8,10
10463,10310,3,1,1,5
10463,10312,8,10,30,48
10463,10314,11,11,15,37
10463,10451,34,103,31,168
10463,10452,66,152,55,273
10463,10453,80,137,70,287
10463,10454,19,28,41,88
10463,10455,26,50,19,95
10463,10456,61,129,59,249
10463,10457,79,155,54,288
10463,10458,66,212,85,363
10463,10459,34,47,30,111
10463,10460,51,104,49,204
10463,10461,29,42,50,121
10463,10462,43,115,104,262
10463,10463,358,527,393,1278
10463,10464,1,4,3,8
10463,10465,27,37,50,114
10463,10466,74,165,112,351
10463,10467,89,210,126,425
10463,10468,136,232,81,449
10463,10469,64,142,105,311
10463,10470,9,25,32,66
10463,10471,52,58,101,211
10463,10472,44,84,61,189
10463,10473,37,72,67,176
10463,10474,13,15,6,34
10463,10475,24,68,76,168
10463,11001,0,1,2,3
10463,11004,5,2,2,9
10463,11005,0,1,0,1
10463,11040,0,1,0,1
10463,11101,3,7,4,14
10463,11102,4,4,12,20
10463,11103,3,6,5,14
10463,11104,6,5,7,18
10463,11105,6,2,5,13
10463,11106,4,5,10,19
10463,11109,0,2,0,2
10463,11201,2,7,21,30
10463,11203,14,8,26,48
10463,11204,3,7,3,13
10463,11205,5,5,12,22
10463,11206,9,7,13,29
10463,11207,12,22,30,64
10463,11208,9,28,14,51
10463,11209,3,6,11,20
10463,11210,5,14,10,29
10463,11211,4,12,14,30
10463,11212,14,27,20,61
10463,11213,9,8,23,40
10463,11214,8,11,8,27
10463,11215,6,5,5,16
10463,11216,4,12,17,33
10463,11217,2,10,7,19
10463,11218,2,3,6,11
10463,11219,1,7,10,18
10463,11220,4,9,11,24
10463,11221,13,8,19,40
10463,11222,3,6,3,12
10463,11223,4,11,9,24
10463,11224,3,3,9,15
10463,11225,7,11,9,27
10463,11226,13,28,21,62
10463,11228,1,8,5,14
10463,11229,11,16,18,45
10463,11230,10,6,14,30
10463,11231,1,4,4,9
10463,11232,2,4,4,10
10463,11233,5,11,9,25
10463,11234,4,16,15,35
10463,11235,10,10,14,34
10463,11236,8,23,23,54
10463,11237,5,3,3,11
10463,11238,5,4,9,18
10463,11239,4,3,3,10
10463,11354,7,11,9,27
10463,11355,19,17,24,60
10463,11356,5,6,5,16
10463,11357,7,5,11,23
10463,11358,5,6,16,27
10463,11360,6,3,5,14
10463,11361,3,1,7,11
10463,11362,3,4,7,14
10463,11363,2,3,3,8
10463,11364,6,6,15,27
10463,11365,6,6,8,20
10463,11366,2,1,4,7
10463,11367,7,6,15,28
10463,11368,6,13,19,38
10463,11369,1,14,4,19
10463,11370,2,3,8,13
10463,11372,10,14,12,36
10463,11373,4,15,18,37
10463,11374,1,4,8,13
10463,11375,6,9,25,40
10463,11377,3,19,19,41
10463,11378,4,5,7,16
10463,11379,1,8,12,21
10463,11385,5,24,17,46
10463,11411,2,6,5,13
10463,11412,7,11,6,24
10463,11413,3,17,11,31
10463,11414,0,2,6,8
10463,11415,0,2,2,4
10463,11416,1,3,7,11
10463,11417,2,3,10,15
10463,11418,2,5,5,12
10463,11419,5,5,19,29
10463,11420,3,9,12,24
10463,11421,5,6,7,18
10463,11422,3,8,12,23
10463,11423,1,6,9,16
10463,11426,5,3,5,13
10463,11427,1,5,9,15
10463,11428,0,5,5,10
10463,11429,1,8,7,16
10463,11432,11,14,13,38
10463,11433,4,14,5,23
10463,11434,14,12,15,41
10463,11435,3,12,12,27
10463,11436,3,2,4,9
10463,11691,5,13,11,29
10463,11692,1,5,2,8
10463,11693,1,5,8,14
10463,11694,1,3,10,14
10463,11697,1,1,0,2
10464,10002,2,0,0,2
10464,10005,0,0,1,1
10464,10009,2,0,0,2
10464,10014,0,0,3,3
10464,10019,2,0,0,2
10464,10022,1,0,2,3
10464,10024,0,0,1,1
10464,10025,0,2,1,3
10464,10026,1,4,0,5
10464,10027,3,1,0,4
10464,10028,0,1,0,1
10464,10029,1,2,0,3
10464,10030,1,1,0,2
10464,10031,1,5,3,9
10464,10032,2,1,3,6
10464,10033,0,7,6,13
10464,10034,0,5,0,5
10464,10036,0,1,1,2
10464,10037,1,0,0,1
10464,10039,1,4,0,5
10464,10040,4,3,4,11
10464,10075,0,1,0,1
10464,10128,0,1,2,3
10464,10304,0,0,2,2
10464,10305,0,1,0,1
10464,10312,1,0,1,2
10464,10314,2,0,4,6
10464,10451,3,8,5,16
10464,10452,7,11,5,23
10464,10453,5,16,6,27
10464,10454,5,2,7,14
10464,10455,5,10,4,19
10464,10456,2,12,3,17
10464,10457,12,16,6,34
10464,10458,9,31,11,51
10464,10459,8,8,1,17
10464,10460,9,16,6,31
10464,10461,19,29,13,61
10464,10462,14,24,13,51
10464,10463,3,6,6,15
10464,10464,32,63,62,157
10464,10465,16,29,10,55
10464,10466,0,16,7,23
10464,10467,20,40,18,78
10464,10468,5,23,2,30
10464,10469,15,6,3,24
10464,10470,1,0,0,1
10464,10471,1,1,0,2
10464,10472,8,29,11,48
10464,10473,5,19,3,27
10464,10474,1,2,0,3
10464,10475,5,11,2,18
10464,11105,0,1,0,1
10464,11106,0,0,1,1
10464,11201,0,0,1,1
10464,11203,0,2,2,4
10464,11204,1,0,0,1
10464,11206,1,2,1,4
10464,11207,0,1,1,2
10464,11208,0,3,0,3
10464,11209,1,0,0,1
10464,11210,1,0,1,2
10464,11211,1,1,0,2
10464,11212,0,0,1,1
10464,11213,0,0,4,4
10464,11214,1,0,0,1
10464,11218,0,1,0,1
10464,11219,0,2,0,2
10464,11221,0,0,2,2
10464,11222,0,2,1,3
10464,11225,0,1,3,4
10464,11226,0,2,0,2
10464,11228,2,1,1,4
10464,11230,1,2,2,5
10464,11232,1,1,0,2
10464,11233,0,1,1,2
10464,11234,0,0,2,2
10464,11235,0,1,0,1
10464,11236,1,0,1,2
10464,11238,0,0,1,1
10464,11239,3,0,0,3
10464,11354,5,0,0,5
10464,11355,3,2,2,7
10464,11356,0,0,2,2
10464,11357,2,2,0,4
10464,11358,2,2,2,6
10464,11361,4,0,2,6
10464,11362,0,1,2,3
10464,11364,2,0,0,2
10464,11365,0,4,0,4
10464,11366,1,0,0,1
10464,11367,5,0,1,6
10464,11368,7,6,2,15
10464,11369,0,0,1,1
10464,11372,2,1,0,3
10464,11373,5,4,1,10
10464,11374,2,0,0,2
10464,11377,1,1,3,5
10464,11378,1,0,1,2
10464,11379,0,1,1,2
10464,11385,3,3,0,6
10464,11412,0,0,4,4
10464,11413,1,3,1,5
10464,11416,0,2,0,2
10464,11419,1,0,0,1
10464,11420,0,0,1,1
10464,11421,1,0,0,1
10464,11426,0,0,1,1
10464,11427,1,0,1,2
10464,11432,0,1,2,3
10464,11433,0,1,0,1
10464,11435,0,1,0,1
10464,11691,1,1,0,2
10464,11693,1,0,0,1
10464,11694,2,0,0,2
10464,11697,0,1,0,1
10465,10001,1,1,2,4
10465,10002,2,5,3,10
10465,10003,2,0,8,10
10465,10005,0,0,1,1
10465,10006,0,0,1,1
10465,10007,0,0,2,2
10465,10009,2,3,11,16
10465,10010,0,1,10,11
10465,10011,0,2,1,3
10465,10013,0,1,3,4
10465,10014,0,0,1,1
10465,10016,1,2,13,16
10465,10017,0,0,1,1
10465,10018,0,0,1,1
10465,10019,0,1,3,4
10465,10021,1,0,7,8
10465,10022,3,0,4,7
10465,10023,5,2,8,15
10465,10024,1,4,6,11
10465,10025,4,3,13,20
10465,10026,2,9,9,20
10465,10027,4,5,12,21
10465,10028,0,2,3,5
10465,10029,9,8,16,33
10465,10030,4,8,12,24
10465,10031,10,14,20,44
10465,10032,3,17,13,33
10465,10033,9,8,14,31
10465,10034,8,13,18,39
10465,10035,5,9,10,24
10465,10036,0,1,6,7
10465,10037,1,10,6,17
10465,10038,0,1,1,2
10465,10039,0,5,13,18
10465,10040,9,7,9,25
10465,10044,0,2,1,3
10465,10065,0,0,6,6
10465,10069,0,1,0,1
10465,10075,1,1,3,5
10465,10128,1,1,10,12
10465,10280,1,0,0,1
10465,10282,0,1,0,1
10465,10301,2,2,7,11
10465,10302,0,3,3,6
10465,10303,2,1,10,13
10465,10304,2,5,5,12
10465,10305,1,2,11,14
10465,10306,3,6,9,18
10465,10307,0,0,6,6
10465,10308,0,2,9,11
10465,10309,2,1,4,7
10465,10310,2,2,4,8
10465,10312,2,4,9,15
10465,10314,1,5,16,22
10465,10451,9,16,19,44
10465,10452,21,41,27,89
10465,10453,24,40,20,84
10465,10454,10,20,11,41
10465,10455,17,24,24,65
10465,10456,29,60,29,118
10465,10457,42,42,23,107
10465,10458,25,30,40,95
10465,10459,14,30,18,62
10465,10460,26,60,32,118
10465,10461,67,85,75,227
10465,10462,54,79,86,219
10465,10463,14,14,42,70
10465,10464,4,6,8,18
10465,10465,219,243,155,617
10465,10466,38,54,66,158
10465,10467,52,76,40,168
10465,10468,27,48,32,107
10465,10469,43,84,85,212
10465,10470,7,8,13,28
10465,10471,2,6,9,17
10465,10472,28,53,35,116
10465,10473,50,78,57,185
10465,10474,5,7,6,18
10465,10475,20,33,61,114
10465,11001,0,2,4,6
10465,11003,0,0,1,1
10465,11004,1,0,10,11
10465,11005,1,1,1,3
10465,11101,3,10,10,23
10465,11102,4,12,8,24
10465,11103,5,9,8,22
10465,11104,1,3,4,8
10465,11105,7,7,11,25
10465,11106,8,9,15,32
10465,11109,1,0,0,1
10465,11201,1,3,9,13
10465,11203,7,7,19,33
10465,11204,2,1,4,7
10465,11205,1,2,5,8
10465,11206,2,8,14,24
10465,11207,6,9,12,27
10465,11208,10,9,13,32
10465,11209,2,2,12,16
10465,11210,5,1,13,19
10465,11211,1,8,4,13
10465,11212,10,10,18,38
10465,11213,3,4,10,17
10465,11214,3,3,6,12
10465,11215,0,1,4,5
10465,11216,2,5,5,12
10465,11217,1,2,8,11
10465,11218,1,3,10,14
10465,11219,1,3,8,12
10465,11220,2,8,8,18
10465,11221,2,6,4,12
10465,11222,0,2,3,5
10465,11223,1,1,9,11
10465,11224,3,6,5,14
10465,11225,5,9,7,21
10465,11226,10,2,10,22
10465,11228,1,3,0,4
10465,11229,1,2,10,13
10465,11230,6,4,13,23
10465,11231,0,0,9,9
10465,11232,0,2,3,5
10465,11233,6,6,9,21
10465,11234,6,5,22,33
10465,11235,1,4,9,14
10465,11236,4,8,17,29
10465,11237,2,6,9,17
10465,11238,3,6,5,14
10465,11239,0,4,8,12
10465,11354,16,13,17,46
10465,11355,24,18,13,55
10465,11356,3,5,15,23
10465,11357,7,13,25,45
10465,11358,12,9,23,44
10465,11360,0,3,14,17
10465,11361,5,5,15,25
10465,11362,3,3,11,17
10465,11363,3,1,8,12
10465,11364,3,8,20,31
10465,11365,4,9,18,31
10465,11366,1,5,4,10
10465,11367,4,7,20,31
10465,11368,21,21,17,59
10465,11369,8,6,13,27
10465,11370,7,5,5,17
10465,11371,0,1,1,2
10465,11372,9,8,17,34
10465,11373,13,17,18,48
10465,11374,4,0,12,16
10465,11375,2,2,23,27
10465,11377,9,7,23,39
10465,11378,0,4,8,12
10465,11379,2,2,15,19
10465,11385,5,8,26,39
10465,11411,1,5,10,16
10465,11412,5,8,12,25
10465,11413,6,11,19,36
10465,11414,2,5,9,16
10465,11415,2,1,1,4
10465,11416,2,3,5,10
10465,11417,2,3,6,11
10465,11418,4,2,7,13
10465,11419,0,9,7,16
10465,11420,2,4,11,17
10465,11421,1,1,7,9
10465,11422,3,9,18,30
10465,11423,6,1,11,18
10465,11426,3,3,6,12
10465,11427,4,3,12,19
10465,11428,5,5,2,12
10465,11429,6,1,17,24
10465,11432,8,8,17,33
10465,11433,3,3,8,14
10465,11434,6,12,22,40
10465,11435,4,11,15,30
10465,11436,4,8,3,15
10465,11691,1,5,21,27
10465,11692,0,1,5,6
10465,11693,0,1,3,4
10465,11694,1,0,4,5
10465,11697,0,1,0,1
10466,10001,0,1,1,2
10466,10002,8,6,8,22
10466,10003,0,3,8,11
10466,10004,0,0,2,2
10466,10007,0,0,2,2
10466,10009,2,6,5,13
10466,10010,1,1,8,10
10466,10011,0,3,2,5
10466,10012,0,0,1,1
10466,10013,3,2,2,7
10466,10014,1,1,4,6
10466,10016,0,3,8,11
10466,10017,1,1,6,8
10466,10018,1,1,1,3
10466,10019,2,1,4,7
10466,10021,1,0,12,13
10466,10022,0,3,6,9
10466,10023,3,4,12,19
10466,10024,1,3,10,14
10466,10025,7,9,21,37
10466,10026,4,11,18,33
10466,10027,4,14,28,46
10466,10028,0,1,10,11
10466,10029,8,27,19,54
10466,10030,3,11,7,21
10466,10031,7,20,15,42
10466,10032,5,23,22,50
10466,10033,7,16,34,57
10466,10034,10,24,31,65
10466,10035,4,14,6,24
10466,10036,0,1,6,7
10466,10037,1,7,6,14
10466,10038,1,0,3,4
10466,10039,3,13,4,20
10466,10040,10,23,12,45
10466,10044,0,0,3,3
10466,10065,0,0,12,12
10466,10069,0,0,2,2
10466,10075,0,0,5,5
10466,10128,0,2,12,14
10466,10280,0,0,2,2
10466,10301,2,6,4,12
10466,10302,1,4,3,8
10466,10303,3,1,8,12
10466,10304,3,3,2,8
10466,10305,1,1,11,13
10466,10306,3,2,8,13
10466,10307,0,1,2,3
10466,10308,1,2,9,12
10466,10309,2,6,6,14
10466,10310,1,1,4,6
10466,10312,1,4,18,23
10466,10314,1,4,16,21
10466,10451,23,51,22,96
10466,10452,17,70,40,127
10466,10453,40,111,57,208
10466,10454,12,18,13,43
10466,10455,12,35,25,72
10466,10456,37,111,38,186
10466,10457,38,106,40,184
10466,10458,37,100,41,178
10466,10459,15,41,26,82
10466,10460,33,71,41,145
10466,10461,35,67,90,192
10466,10462,47,117,126,290
10466,10463,34,51,88,173
10466,10464,5,0,13,18
10466,10465,23,43,73,139
10466,10466,160,351,232,743
10466,10467,85,224,143,452
10466,10468,44,101,62,207
10466,10469,67,177,143,387
10466,10470,11,42,43,96
10466,10471,7,14,40,61
10466,10472,23,73,48,144
10466,10473,30,83,71,184
10466,10474,5,6,8,19
10466,10475,22,81,80,183
10466,11001,1,1,1,3
10466,11004,1,0,5,6
10466,11101,2,2,3,7
10466,11102,4,1,4,9
10466,11103,2,2,7,11
10466,11104,3,3,5,11
10466,11105,0,2,9,11
10466,11106,3,5,12,20
10466,11201,2,4,11,17
10466,11203,6,10,11,27
10466,11204,2,4,3,9
10466,11205,0,5,6,11
10466,11206,4,13,10,27
10466,11207,13,15,19,47
10466,11208,9,13,17,39
10466,11209,1,5,5,11
10466,11210,9,11,6,26
10466,11211,0,5,15,20
10466,11212,13,19,14,46
10466,11213,1,8,12,21
10466,11214,3,3,12,18
10466,11215,1,5,10,16
10466,11216,4,8,6,18
10466,11217,1,1,6,8
10466,11218,2,7,10,19
10466,11219,4,4,5,13
10466,11220,2,7,6,15
10466,11221,4,7,12,23
10466,11222,0,0,3,3
10466,11223,3,6,7,16
10466,11224,2,3,2,7
10466,11225,2,6,11,19
10466,11226,9,18,12,39
10466,11228,1,1,3,5
10466,11229,4,5,11,20
10466,11230,5,6,15,26
10466,11231,0,1,4,5
10466,11232,1,1,5,7
10466,11233,9,16,8,33
10466,11234,4,11,20,35
10466,11235,0,7,9,16
10466,11236,10,15,19,44
10466,11237,2,2,5,9
10466,11238,2,6,3,11
10466,11239,1,3,4,8
10466,11354,2,10,17,29
10466,11355,6,8,14,28
10466,11356,1,3,8,12
10466,11357,3,5,9,17
10466,11358,3,1,11,15
10466,11360,2,0,11,13
10466,11361,3,5,9,17
10466,11362,0,3,5,8
10466,11363,0,0,1,1
10466,11364,1,2,12,15
10466,11365,2,6,10,18
10466,11366,0,1,0,1
10466,11367,2,5,7,14
10466,11368,10,14,10,34
10466,11369,2,8,2,12
10466,11370,6,12,7,25
10466,11372,6,11,4,21
10466,11373,5,11,12,28
10466,11374,0,2,16,18
10466,11375,4,6,15,25
10466,11377,5,9,7,21
10466,11378,2,3,9,14
10466,11379,2,2,12,16
10466,11385,1,12,19,32
10466,11411,2,3,3,8
10466,11412,4,8,10,22
10466,11413,4,7,15,26
10466,11414,3,2,7,12
10466,11415,1,4,3,8
10466,11416,3,3,6,12
10466,11417,2,1,9,12
10466,11418,2,5,4,11
10466,11419,2,7,4,13
10466,11420,3,2,9,14
10466,11421,0,7,2,9
10466,11422,5,8,12,25
10466,11423,5,6,10,21
10466,11426,2,2,9,13
10466,11427,1,1,8,10
10466,11428,2,2,2,6
10466,11429,6,4,5,15
10466,11432,4,12,18,34
10466,11433,2,7,8,17
10466,11434,3,13,17,33
10466,11435,6,10,12,28
10466,11436,2,3,1,6
10466,11691,3,7,12,22
10466,11692,1,1,4,6
10466,11693,0,0,1,1
10466,11694,0,1,3,4
10467,10001,2,0,8,10
10467,10002,12,12,24,48
10467,10003,4,7,25,36
10467,10005,0,0,4,4
10467,10009,3,5,31,39
10467,10010,0,3,18,21
10467,10011,5,5,22,32
10467,10012,2,0,6,8
10467,10013,2,0,4,6
10467,10014,0,1,14,15
10467,10016,3,6,32,41
10467,10017,0,2,12,14
10467,10018,0,1,2,3
10467,10019,2,4,21,27
10467,10021,2,5,60,67
10467,10022,1,1,18,20
10467,10023,6,2,54,62
10467,10024,2,10,30,42
10467,10025,12,19,83,114
10467,10026,17,43,43,103
10467,10027,23,26,53,102
10467,10028,1,4,54,59
10467,10029,26,46,67,139
10467,10030,12,26,38,76
10467,10031,20,35,46,101
10467,10032,24,55,54,133
10467,10033,30,50,97,177
10467,10034,11,32,49,92
10467,10035,15,21,30,66
10467,10036,2,5,13,20
10467,10037,5,12,23,40
10467,10038,1,4,8,13
10467,10039,7,28,32,67
10467,10040,15,34,50,99
10467,10044,0,0,11,11
10467,10065,1,1,38,40
10467,10069,0,2,7,9
10467,10075,0,1,26,27
10467,10128,5,9,63,77
10467,10162,0,1,1,2
10467,10280,1,0,3,4
10467,10282,1,0,5,6
10467,10301,0,4,15,19
10467,10302,0,3,6,9
10467,10303,1,1,9,11
10467,10304,3,10,8,21
10467,10305,3,8,14,25
10467,10306,2,7,21,30
10467,10307,0,0,5,5
10467,10308,1,1,5,7
10467,10309,1,2,16,19
10467,10310,1,8,13,22
10467,10312,1,7,22,30
10467,10314,7,9,21,37
10467,10451,55,110,83,248
10467,10452,73,196,153,422
10467,10453,95,192,172,459
10467,10454,42,75,55,172
10467,10455,59,103,61,223
10467,10456,136,195,171,502
10467,10457,106,213,110,429
10467,10458,139,253,188,580
10467,10459,68,109,83,260
10467,10460,93,181,132,406
10467,10461,58,174,327,559
10467,10462,132,286,405,823
10467,10463,100,175,355,630
10467,10464,6,9,35,50
10467,10465,51,92,235,378
10467,10466,199,479,494,1172
10467,10467,511,905,825,2241
10467,10468,151,246,183,580
10467,10469,201,412,549,1162
10467,10470,23,86,124,233
10467,10471,18,21,149,188
10467,10472,99,178,143,420
10467,10473,76,198,226,500
10467,10474,11,19,19,49
10467,10475,95,217,342,654
10467,11001,1,1,5,7
10467,11004,1,8,11,20
10467,11040,0,0,4,4
10467,11101,2,7,14,23
10467,11102,1,4,16,21
10467,11103,1,4,25,30
10467,11104,0,6,13,19
10467,11105,2,0,12,14
10467,11106,1,4,13,18
10467,11109,0,0,6,6
10467,11201,3,8,18,29
10467,11203,26,54,33,113
10467,11204,2,3,15,20
10467,11205,0,8,17,25
10467,11206,10,24,20,54
10467,11207,24,41,28,93
10467,11208,23,48,27,98
10467,11209,1,12,16,29
10467,11210,14,30,35,79
10467,11211,2,8,35,45
10467,11212,33,55,30,118
10467,11213,14,34,31,79
10467,11214,1,4,23,28
10467,11215,0,4,17,21
10467,11216,15,29,14,58
10467,11217,9,2,12,23
10467,11218,3,11,16,30
10467,11219,2,6,11,19
10467,11220,10,11,17,38
10467,11221,10,22,22,54
10467,11222,0,2,6,8
10467,11223,4,8,13,25
10467,11224,0,10,11,21
10467,11225,18,40,27,85
10467,11226,23,41,38,102
10467,11228,1,3,11,15
10467,11229,3,12,32,47
10467,11230,5,18,24,47
10467,11231,2,1,8,11
10467,11232,0,1,5,6
10467,11233,20,24,26,70
10467,11234,11,30,27,68
10467,11235,3,5,25,33
10467,11236,23,45,31,99
10467,11237,7,8,14,29
10467,11238,7,17,18,42
10467,11239,3,4,5,12
10467,11354,5,8,25,38
10467,11355,12,20,33,65
10467,11356,3,4,8,15
10467,11357,11,11,17,39
10467,11358,4,3,18,25
10467,11360,4,4,10,18
10467,11361,3,8,14,25
10467,11362,2,5,9,16
10467,11363,1,0,4,5
10467,11364,6,7,20,33
10467,11365,4,9,25,38
10467,11366,2,5,7,14
10467,11367,5,13,22,40
10467,11368,10,15,34,59
10467,11369,1,7,15,23
10467,11370,2,7,7,16
10467,11372,3,10,15,28
10467,11373,4,10,43,57
10467,11374,2,2,31,35
10467,11375,4,6,50,60
10467,11377,4,13,37,54
10467,11378,1,5,15,21
10467,11379,1,8,10,19
10467,11385,9,18,42,69
10467,11411,3,5,11,19
10467,11412,7,14,28,49
10467,11413,5,16,26,47
10467,11414,1,8,12,21
10467,11415,1,5,4,10
10467,11416,0,2,15,17
10467,11417,3,10,13,26
10467,11418,3,4,14,21
10467,11419,2,7,17,26
10467,11420,8,11,21,40
10467,11421,2,7,15,24
10467,11422,6,12,26,44
10467,11423,1,6,13,20
10467,11426,1,6,11,18
10467,11427,6,3,18,27
10467,11428,3,5,20,28
10467,11429,6,6,22,34
10467,11432,7,22,33,62
10467,11433,4,11,16,31
10467,11434,9,17,29,55
10467,11435,3,11,28,42
10467,11436,4,5,13,22
10467,11691,11,13,25,49
10467,11692,4,5,8,17
10467,11693,1,0,5,6
10467,11694,3,3,6,12
10467,11697,0,0,3,3
10468,10001,0,2,2,4
10468,10002,5,4,10,19
10468,10003,1,3,3,7
10468,10004,1,0,0,1
10468,10005,0,1,0,1
10468,10007,1,1,0,2
10468,10009,2,4,6,12
10468,10010,0,1,7,8
10468,10011,4,3,8,15
10468,10012,0,0,1,1
10468,10013,1,2,4,7
10468,10014,2,0,2,4
10468,10016,0,1,6,7
10468,10017,0,0,2,2
10468,10018,0,0,1,1
10468,10019,2,0,4,6
10468,10021,1,4,4,9
10468,10022,0,1,5,6
10468,10023,5,5,6,16
10468,10024,8,0,13,21
10468,10025,9,5,19,33
10468,10026,15,20,11,46
10468,10027,16,24,24,64
10468,10028,2,0,0,2
10468,10029,8,17,16,41
10468,10030,10,3,15,28
10468,10031,22,16,27,65
10468,10032,19,18,11,48
10468,10033,30,41,18,89
10468,10034,34,30,26,90
10468,10035,9,6,11,26
10468,10036,0,0,3,3
10468,10037,7,7,8,22
10468,10038,3,1,2,6
10468,10039,11,12,15,38
10468,10040,8,15,19,42
10468,10044,2,0,0,2
10468,10065,1,2,3,6
10468,10069,2,0,0,2
10468,10075,0,0,2,2
10468,10128,3,2,9,14
10468,10301,3,2,11,16
10468,10302,2,1,6,9
10468,10303,0,2,7,9
10468,10304,0,1,10,11
10468,10305,2,3,7,12
10468,10306,0,3,15,18
10468,10307,0,0,2,2
10468,10308,1,1,6,8
10468,10309,0,2,9,11
10468,10310,1,3,10,14
10468,10312,3,5,15,23
10468,10314,1,7,9,17
10468,10451,26,38,21,85
10468,10452,44,53,39,136
10468,10453,93,176,63,332
10468,10454,17,20,14,51
10468,10455,16,28,9,53
10468,10456,46,69,40,155
10468,10457,48,99,46,193
10468,10458,110,158,68,336
10468,10459,40,44,25,109
10468,10460,36,45,31,112
10468,10461,30,30,48,108
10468,10462,37,65,58,160
10468,10463,50,78,73,201
10468,10464,2,1,3,6
10468,10465,16,25,44,85
10468,10466,26,58,52,136
10468,10467,68,91,74,233
10468,10468,246,331,89,666
10468,10469,35,57,67,159
10468,10470,8,10,8,26
10468,10471,12,9,28,49
10468,10472,25,44,29,98
10468,10473,39,37,46,122
10468,10474,3,8,7,18
10468,10475,13,30,37,80
10468,11001,0,1,2,3
10468,11004,0,3,4,7
10468,11005,0,1,0,1
10468,11101,4,2,4,10
10468,11102,2,1,4,7
10468,11103,3,0,5,8
10468,11104,3,2,4,9
10468,11105,4,3,3,10
10468,11106,2,3,4,9
10468,11109,1,2,2,5
10468,11201,4,1,6,11
10468,11203,8,3,11,22
10468,11204,0,1,5,6
10468,11205,5,4,3,12
10468,11206,5,5,9,19
10468,11207,6,16,9,31
10468,11208,10,13,11,34
10468,11209,3,4,10,17
10468,11210,7,4,8,19
10468,11211,4,7,10,21
10468,11212,7,6,10,23
10468,11213,2,12,12,26
10468,11214,3,4,8,15
10468,11215,1,3,8,12
10468,11216,6,2,4,12
10468,11217,2,2,10,14
10468,11218,8,5,7,20
10468,11219,4,1,7,12
10468,11220,4,3,8,15
10468,11221,2,7,5,14
10468,11222,2,2,0,4
10468,11223,2,2,4,8
10468,11224,1,4,7,12
10468,11225,12,4,7,23
10468,11226,10,11,10,31
10468,11228,2,2,3,7
10468,11229,5,3,12,20
10468,11230,6,4,13,23
10468,11231,2,0,5,7
10468,11232,2,5,3,10
10468,11233,8,9,7,24
10468,11234,5,6,18,29
10468,11235,4,4,5,13
10468,11236,8,0,18,26
10468,11237,2,3,7,12
10468,11238,5,3,11,19
10468,11239,0,1,3,4
10468,11354,7,6,8,21
10468,11355,12,12,10,34
10468,11356,3,0,2,5
10468,11357,3,2,3,8
10468,11358,3,4,7,14
10468,11360,2,0,4,6
10468,11361,3,4,5,12
10468,11362,2,2,7,11
10468,11363,0,1,3,4
10468,11364,3,3,12,18
10468,11365,4,2,10,16
10468,11366,0,0,2,2
10468,11367,3,2,9,14
10468,11368,5,9,15,29
10468,11369,1,3,4,8
10468,11370,3,5,1,9
10468,11372,4,9,7,20
10468,11373,13,8,8,29
10468,11374,0,1,10,11
10468,11375,7,9,20,36
10468,11377,11,7,12,30
10468,11378,4,0,3,7
10468,11379,1,1,9,11
10468,11385,6,10,26,42
10468,11411,0,1,6,7
10468,11412,2,2,6,10
10468,11413,1,5,10,16
10468,11414,0,0,5,5
10468,11415,0,5,3,8
10468,11416,1,2,1,4
10468,11417,3,3,4,10
10468,11418,0,8,4,12
10468,11419,3,7,7,17
10468,11420,5,5,9,19
10468,11421,2,10,4,16
10468,11422,1,1,4,6
10468,11423,5,2,1,8
10468,11426,0,2,6,8
10468,11427,1,2,8,11
10468,11428,1,1,4,6
10468,11429,3,6,10,19
10468,11432,9,3,6,18
10468,11433,2,4,7,13
10468,11434,7,4,3,14
10468,11435,3,10,13,26
10468,11436,2,1,1,4
10468,11691,7,2,11,20
10468,11692,1,1,0,2
10468,11693,0,1,1,2
10468,11694,0,2,1,3
10468,11697,0,0,1,1
10469,10001,1,0,1,2
10469,10002,3,6,5,14
10469,10003,1,2,4,7
10469,10007,0,0,1,1
10469,10009,6,3,6,15
10469,10010,0,2,3,5
10469,10011,0,2,6,8
10469,10012,0,0,2,2
10469,10013,0,2,3,5
10469,10014,3,0,2,5
10469,10016,1,1,1,3
10469,10017,0,1,0,1
10469,10019,1,1,10,12
10469,10021,0,0,3,3
10469,10022,0,2,2,4
10469,10023,0,1,4,5
10469,10024,3,2,4,9
10469,10025,5,9,10,24
10469,10026,10,10,12,32
10469,10027,4,13,14,31
10469,10028,1,0,6,7
10469,10029,2,23,9,34
10469,10030,4,16,6,26
10469,10031,6,14,12,32
10469,10032,13,26,12,51
10469,10033,7,11,13,31
10469,10034,6,15,16,37
10469,10035,2,9,4,15
10469,10036,0,2,3,5
10469,10037,3,9,2,14
10469,10038,1,0,3,4
10469,10039,4,14,8,26
10469,10040,2,11,11,24
10469,10044,0,0,1,1
10469,10065,0,1,2,3
10469,10069,0,1,0,1
10469,10075,1,1,4,6
10469,10128,0,3,4,7
10469,10162,0,0,1,1
10469,10280,0,1,0,1
10469,10282,0,0,1,1
10469,10301,1,2,4,7
10469,10302,1,2,3,6
10469,10303,1,2,3,6
10469,10304,1,5,4,10
10469,10305,0,3,2,5
10469,10306,1,1,8,10
10469,10307,2,0,5,7
10469,10308,0,0,7,7
10469,10309,1,2,3,6
10469,10310,0,3,3,6
10469,10312,1,2,7,10
10469,10314,1,3,10,14
10469,10451,9,54,22,85
10469,10452,22,57,38,117
10469,10453,23,64,32,119
10469,10454,9,36,11,56
10469,10455,15,28,20,63
10469,10456,29,103,43,175
10469,10457,23,82,36,141
10469,10458,42,100,35,177
10469,10459,21,54,38,113
10469,10460,24,93,26,143
10469,10461,32,86,94,212
10469,10462,68,130,98,296
10469,10463,12,33,49,94
10469,10464,7,3,3,13
10469,10465,22,59,77,158
10469,10466,81,278,150,509
10469,10467,80,293,150,523
10469,10468,40,72,44,156
10469,10469,186,389,227,802
10469,10470,16,33,27,76
10469,10471,4,8,21,33
10469,10472,29,84,66,179
10469,10473,26,68,56,150
10469,10474,4,6,0,10
10469,10475,32,111,64,207
10469,11001,0,1,1,2
10469,11004,2,3,2,7
10469,11101,1,6,1,8
10469,11102,3,4,6,13
10469,11103,4,0,7,11
10469,11104,2,3,6,11
10469,11105,2,3,4,9
10469,11106,0,3,6,9
10469,11109,0,0,1,1
10469,11201,1,4,4,9
10469,11203,4,12,16,32
10469,11204,0,4,5,9
10469,11205,2,3,2,7
10469,11206,3,6,6,15
10469,11207,5,14,13,32
10469,11208,6,15,10,31
10469,11209,3,3,11,17
10469,11210,3,6,7,16
10469,11211,2,2,6,10
10469,11212,9,16,11,36
10469,11213,5,7,9,21
10469,11214,0,2,5,7
10469,11215,2,0,7,9
10469,11216,1,9,3,13
10469,11217,1,2,5,8
10469,11218,2,3,6,11
10469,11219,3,5,11,19
10469,11220,2,3,5,10
10469,11221,1,8,9,18
10469,11222,1,0,3,4
10469,11223,2,2,6,10
10469,11224,2,5,3,10
10469,11225,5,7,6,18
10469,11226,2,12,11,25
10469,11228,1,0,5,6
10469,11229,1,3,7,11
10469,11230,2,2,10,14
10469,11231,0,2,1,3
10469,11232,0,0,4,4
10469,11233,3,6,5,14
10469,11234,4,6,18,28
10469,11235,3,4,12,19
10469,11236,3,13,19,35
10469,11237,1,3,2,6
10469,11238,0,4,6,10
10469,11239,1,3,3,7
10469,11354,9,9,12,30
10469,11355,9,13,14,36
10469,11356,3,4,6,13
10469,11357,3,6,8,17
10469,11358,5,10,13,28
10469,11359,0,1,0,1
10469,11360,1,4,7,12
10469,11361,1,4,12,17
10469,11362,1,2,5,8
10469,11363,1,0,0,1
10469,11364,2,3,13,18
10469,11365,3,6,9,18
10469,11366,1,1,1,3
10469,11367,4,4,7,15
10469,11368,11,18,11,40
10469,11369,2,4,7,13
10469,11370,5,5,6,16
10469,11372,9,9,8,26
10469,11373,6,7,23,36
10469,11374,1,4,9,14
10469,11375,2,1,18,21
10469,11377,4,8,19,31
10469,11378,1,0,9,10
10469,11379,1,3,5,9
10469,11385,5,9,11,25
10469,11411,2,4,4,10
10469,11412,3,7,9,19
10469,11413,3,5,16,24
10469,11414,0,4,7,11
10469,11415,0,1,3,4
10469,11416,1,1,0,2
10469,11417,1,2,2,5
10469,11418,0,3,3,6
10469,11419,2,7,9,18
10469,11420,1,4,3,8
10469,11421,0,6,6,12
10469,11422,1,2,5,8
10469,11423,5,4,4,13
10469,11426,0,2,1,3
10469,11427,0,4,5,9
10469,11428,4,3,6,13
10469,11429,4,6,6,16
10469,11432,3,6,7,16
10469,11433,1,3,9,13
10469,11434,5,3,6,14
10469,11435,6,3,8,17
10469,11436,4,3,5,12
10469,11691,2,6,12,20
10469,11692,0,3,3,6
10469,11694,0,1,3,4
10469,11697,0,1,0,1
10470,10001,0,0,1,1
10470,10002,2,1,0,3
10470,10003,0,1,0,1
10470,10009,2,0,3,5
10470,10011,0,0,2,2
10470,10013,1,0,1,2
10470,10014,0,1,3,4
10470,10016,0,0,1,1
10470,10018,0,0,1,1
10470,10021,0,1,1,2
10470,10022,0,0,1,1
10470,10023,1,0,0,1
10470,10024,0,3,1,4
10470,10025,1,0,6,7
10470,10026,1,3,2,6
10470,10027,0,2,6,8
10470,10028,0,0,2,2
10470,10029,5,10,1,16
10470,10030,1,3,3,7
10470,10031,4,6,14,24
10470,10032,3,10,2,15
10470,10033,3,9,8,20
10470,10034,2,8,12,22
10470,10035,3,3,1,7
10470,10038,0,0,3,3
10470,10039,1,1,3,5
10470,10040,2,7,11,20
10470,10044,1,0,0,1
10470,10128,3,0,1,4
10470,10280,0,0,1,1
10470,10282,0,0,1,1
10470,10301,1,6,6,13
10470,10302,1,5,4,10
10470,10303,4,3,4,11
10470,10304,5,3,16,24
10470,10305,0,5,11,16
10470,10306,2,2,17,21
10470,10307,1,0,0,1
10470,10308,0,1,4,5
10470,10309,2,1,4,7
10470,10310,1,2,9,12
10470,10312,3,3,9,15
10470,10314,1,9,22,32
10470,10451,4,11,3,18
10470,10452,7,12,13,32
10470,10453,12,28,17,57
10470,10454,1,7,1,9
10470,10455,1,6,3,10
10470,10456,6,19,19,44
10470,10457,15,22,25,62
10470,10458,4,33,17,54
10470,10459,7,13,5,25
10470,10460,9,19,16,44
10470,10461,4,8,10,22
10470,10462,8,28,17,53
10470,10463,6,11,13,30
10470,10464,1,0,1,2
10470,10465,3,7,12,22
10470,10466,27,56,53,136
10470,10467,23,44,37,104
10470,10468,9,43,19,71
10470,10469,17,32,43,92
10470,10470,33,51,53,137
10470,10471,3,4,5,12
10470,10472,12,16,13,41
10470,10473,9,12,9,30
10470,10474,0,2,0,2
10470,10475,15,26,17,58
10470,11005,0,0,1,1
10470,11101,0,0,3,3
10470,11102,0,2,2,4
10470,11103,0,0,3,3
10470,11104,1,1,4,6
10470,11105,0,1,2,3
10470,11106,1,2,2,5
10470,11201,0,0,2,2
10470,11203,3,4,9,16
10470,11204,0,2,9,11
10470,11205,0,0,3,3
10470,11206,1,1,3,5
10470,11207,5,1,6,12
10470,11208,5,1,6,12
10470,11209,0,1,2,3
10470,11210,1,2,8,11
10470,11211,0,0,1,1
10470,11212,2,6,13,21
10470,11213,0,1,4,5
10470,11214,1,2,7,10
10470,11215,0,1,2,3
10470,11216,2,4,2,8
10470,11217,0,0,1,1
10470,11218,1,4,10,15
10470,11219,1,4,20,25
10470,11220,3,0,6,9
10470,11221,0,3,5,8
10470,11222,0,0,1,1
10470,11223,0,4,7,11
10470,11224,2,1,4,7
10470,11225,3,5,9,17
10470,11226,5,6,11,22
10470,11228,1,0,4,5
10470,11229,0,1,12,13
10470,11230,2,5,15,22
10470,11231,0,1,1,2
10470,11233,0,1,10,11
10470,11234,0,1,19,20
10470,11235,1,4,11,16
10470,11236,7,3,15,25
10470,11237,1,1,3,5
10470,11238,1,0,6,7
10470,11239,2,0,0,2
10470,11354,0,1,4,5
10470,11355,3,1,4,8
10470,11356,0,1,0,1
10470,11357,0,2,2,4
10470,11358,0,0,2,2
10470,11360,0,0,1,1
10470,11361,0,0,4,4
10470,11362,0,0,3,3
10470,11363,0,1,2,3
10470,11364,0,4,4,8
10470,11365,2,1,9,12
10470,11366,1,2,6,9
10470,11367,0,4,8,12
10470,11368,1,5,6,12
10470,11369,0,2,4,6
10470,11370,4,5,2,11
10470,11372,1,4,7,12
10470,11373,0,6,9,15
10470,11374,1,1,4,6
10470,11375,0,1,9,10
10470,11377,1,3,8,12
10470,11378,2,3,6,11
10470,11379,3,4,8,15
10470,11385,1,6,9,16
10470,11411,0,0,1,1
10470,11412,3,6,3,12
10470,11413,1,3,6,10
10470,11414,0,2,3,5
10470,11415,1,1,2,4
10470,11416,1,2,1,4
10470,11417,0,1,1,2
10470,11418,1,1,2,4
10470,11419,0,5,1,6
10470,11420,0,0,3,3
10470,11421,1,1,4,6
10470,11422,3,2,2,7
10470,11423,2,4,5,11
10470,11426,0,1,2,3
10470,11427,1,0,4,5
10470,11428,0,0,3,3
10470,11429,1,0,3,4
10470,11432,1,4,6,11
10470,11433,0,4,6,10
10470,11434,5,9,6,20
10470,11435,1,5,11,17
10470,11436,0,1,4,5
10470,11691,0,1,8,9
10470,11692,0,1,4,5
10470,11693,0,0,2,2
10470,11694,0,0,5,5
10470,11697,0,0,2,2
10471,10001,2,0,3,5
10471,10002,1,3,7,11
10471,10003,3,1,7,11
10471,10004,1,0,1,2
10471,10009,4,3,10,17
10471,10010,2,0,11,13
10471,10011,3,2,4,9
10471,10012,0,0,7,7
10471,10013,2,0,6,8
10471,10014,1,2,7,10
10471,10016,5,2,6,13
10471,10017,2,1,2,5
10471,10019,4,2,9,15
10471,10021,4,2,12,18
10471,10022,2,2,4,8
10471,10023,6,7,29,42
10471,10024,10,5,44,59
10471,10025,12,12,48,72
10471,10026,7,7,20,34
10471,10027,5,12,30,47
10471,10028,6,2,11,19
10471,10029,10,9,11,30
10471,10030,7,7,7,21
10471,10031,22,32,25,79
10471,10032,16,20,13,49
10471,10033,27,44,41,112
10471,10034,16,29,40,85
10471,10035,4,8,6,18
10471,10036,0,0,2,2
10471,10037,3,5,5,13
10471,10038,0,1,2,3
10471,10039,4,2,7,13
10471,10040,26,34,35,95
10471,10044,1,0,0,1
10471,10065,2,1,9,12
10471,10069,2,0,1,3
10471,10075,1,0,7,8
10471,10128,5,7,21,33
10471,10280,0,0,2,2
10471,10282,0,0,1,1
10471,10301,2,4,5,11
10471,10302,2,2,2,6
10471,10303,3,4,2,9
10471,10304,3,3,3,9
10471,10305,7,4,1,12
10471,10306,5,3,2,10
10471,10307,0,0,1,1
10471,10308,3,0,0,3
10471,10309,3,0,0,3
10471,10310,1,3,2,6
10471,10312,4,0,5,9
10471,10314,7,1,7,15
10471,10451,7,35,21,63
10471,10452,22,49,17,88
10471,10453,33,74,36,143
10471,10454,11,29,8,48
10471,10455,7,32,11,50
10471,10456,20,62,33,115
10471,10457,23,61,16,100
10471,10458,45,56,40,141
10471,10459,11,14,11,36
10471,10460,23,33,36,92
10471,10461,14,20,23,57
10471,10462,46,37,37,120
10471,10463,170,162,328,660
10471,10464,3,2,1,6
10471,10465,25,11,19,55
10471,10466,38,114,78,230
10471,10467,68,108,70,246
10471,10468,36,84,60,180
10471,10469,42,91,70,203
10471,10470,20,14,24,58
10471,10471,145,136,290,571
10471,10472,13,19,17,49
10471,10473,18,29,22,69
10471,10474,3,5,3,11
10471,10475,13,44,42,99
10471,11001,0,0,1,1
10471,11004,0,1,4,5
10471,11040,0,0,1,1
10471,11101,3,0,2,5
10471,11102,6,5,4,15
10471,11103,8,3,10,21
10471,11104,2,1,4,7
10471,11105,4,2,12,18
10471,11106,4,6,5,15
10471,11109,0,1,2,3
10471,11201,1,2,12,15
10471,11203,9,13,6,28
10471,11204,4,2,6,12
10471,11205,2,1,11,14
10471,11206,6,3,1,10
10471,11207,5,8,2,15
10471,11208,6,2,4,12
10471,11209,3,4,5,12
10471,11210,8,3,8,19
10471,11211,6,7,5,18
10471,11212,9,12,7,28
10471,11213,6,2,6,14
10471,11214,6,0,4,10
10471,11215,2,4,16,22
10471,11216,2,1,3,6
10471,11217,1,0,5,6
10471,11218,1,1,4,6
10471,11219,6,3,3,12
10471,11220,0,8,4,12
10471,11221,2,2,2,6
10471,11222,2,1,1,4
10471,11223,4,1,4,9
10471,11224,1,0,0,1
10471,11225,9,13,3,25
10471,11226,16,9,13,38
10471,11228,4,2,4,10
10471,11229,2,1,4,7
10471,11230,2,1,4,7
10471,11231,1,0,5,6
10471,11232,1,1,3,5
10471,11233,6,6,3,15
10471,11234,8,6,8,22
10471,11235,0,7,4,11
10471,11236,5,8,10,23
10471,11237,1,2,1,4
10471,11238,6,4,9,19
10471,11239,1,2,3,6
10471,11354,2,1,2,5
10471,11355,6,1,6,13
10471,11356,1,1,3,5
10471,11357,4,2,1,7
10471,11358,1,1,3,5
10471,11360,4,0,3,7
10471,11361,1,1,2,4
10471,11362,1,1,2,4
10471,11363,0,0,1,1
10471,11364,2,1,4,7
10471,11365,2,4,4,10
10471,11366,3,0,2,5
10471,11367,1,4,5,10
10471,11368,3,7,5,15
10471,11369,4,4,3,11
10471,11370,1,3,5,9
10471,11372,2,5,2,9
10471,11373,5,10,6,21
10471,11374,1,4,10,15
10471,11375,5,3,5,13
10471,11377,7,6,17,30
10471,11378,1,1,3,5
10471,11379,2,0,5,7
10471,11385,4,3,14,21
10471,11411,0,1,1,2
10471,11412,4,3,2,9
10471,11413,4,0,4,8
10471,11414,2,0,1,3
10471,11415,2,2,0,4
10471,11416,1,0,2,3
10471,11417,1,2,2,5
10471,11418,2,0,4,6
10471,11419,4,1,6,11
10471,11420,3,2,5,10
10471,11421,5,3,1,9
10471,11422,1,1,4,6
10471,11423,2,4,2,8
10471,11426,3,1,1,5
10471,11427,1,0,1,2
10471,11428,1,2,1,4
10471,11429,0,1,2,3
10471,11432,3,3,4,10
10471,11433,6,2,2,10
10471,11434,5,3,3,11
10471,11435,3,2,5,10
10471,11436,0,1,0,1
10471,11691,8,5,3,16
10471,11692,1,2,1,4
10471,11693,1,1,0,2
10471,11694,2,2,0,4
10472,10001,1,2,0,3
10472,10002,5,2,3,10
10472,10003,2,4,2,8
10472,10004,0,0,1,1
10472,10009,1,1,5,7
10472,10010,0,1,1,2
10472,10011,0,1,4,5
10472,10012,2,0,1,3
10472,10016,0,0,7,7
10472,10017,0,0,1,1
10472,10019,1,1,2,4
10472,10021,1,1,3,5
10472,10022,0,1,1,2
10472,10023,3,1,3,7
10472,10024,2,2,0,4
10472,10025,5,6,6,17
10472,10026,4,4,14,22
10472,10027,8,14,13,35
10472,10028,0,1,3,4
10472,10029,11,16,17,44
10472,10030,5,7,7,19
10472,10031,12,16,8,36
10472,10032,3,12,12,27
10472,10033,8,20,12,40
10472,10034,7,10,7,24
10472,10035,5,12,9,26
10472,10036,0,2,0,2
10472,10037,2,1,5,8
10472,10038,2,0,0,2
10472,10039,5,6,12,23
10472,10040,6,19,20,45
10472,10044,0,0,1,1
10472,10065,0,0,4,4
10472,10069,0,1,1,2
10472,10075,1,0,0,1
10472,10128,0,1,3,4
10472,10282,1,0,0,1
10472,10301,2,2,8,12
10472,10302,0,0,4,4
10472,10303,1,1,3,5
10472,10304,2,0,4,6
10472,10305,0,1,5,6
10472,10306,3,5,11,19
10472,10308,0,2,6,8
10472,10309,0,1,5,6
10472,10310,0,1,1,2
10472,10312,3,1,13,17
10472,10314,0,1,10,11
10472,10451,8,26,13,47
10472,10452,21,35,21,77
10472,10453,25,40,18,83
10472,10454,9,10,13,32
10472,10455,15,30,9,54
10472,10456,30,56,22,108
10472,10457,36,54,27,117
10472,10458,25,52,24,101
10472,10459,15,52,22,89
10472,10460,33,55,21,109
10472,10461,35,33,29,97
10472,10462,56,63,48,167
10472,10463,13,32,35,80
10472,10464,0,3,3,6
10472,10465,22,21,47,90
10472,10466,18,35,30,83
10472,10467,16,67,32,115
10472,10468,22,35,28,85
10472,10469,17,39,43,99
10472,10470,1,6,7,14
10472,10471,7,7,18,32
10472,10472,172,225,43,440
10472,10473,37,72,40,149
10472,10474,5,8,8,21
10472,10475,12,14,26,52
10472,11004,1,0,0,1
10472,11005,0,0,2,2
10472,11040,0,0,1,1
10472,11101,3,6,5,14
10472,11102,10,8,10,28
10472,11103,5,8,12,25
10472,11104,1,1,2,4
10472,11105,5,4,15,24
10472,11106,5,9,15,29
10472,11109,1,0,1,2
10472,11201,0,2,5,7
10472,11203,2,11,9,22
10472,11204,1,5,5,11
10472,11205,1,1,3,5
10472,11206,7,9,9,25
10472,11207,0,7,6,13
10472,11208,4,8,5,17
10472,11209,0,7,5,12
10472,11210,1,3,3,7
10472,11211,2,4,6,12
10472,11212,3,5,11,19
10472,11213,1,3,6,10
10472,11214,1,5,8,14
10472,11215,2,2,2,6
10472,11216,3,1,5,9
10472,11217,3,3,3,9
10472,11218,4,2,4,10
10472,11219,3,2,7,12
10472,11220,2,6,10,18
10472,11221,2,6,13,21
10472,11222,0,2,3,5
10472,11223,0,4,11,15
10472,11224,1,8,7,16
10472,11225,3,2,5,10
10472,11226,2,7,5,14
10472,11228,0,3,4,7
10472,11229,3,1,7,11
10472,11230,0,1,2,3
10472,11231,0,1,5,6
10472,11232,2,0,2,4
10472,11233,3,3,5,11
10472,11234,4,3,11,18
10472,11235,1,1,4,6
10472,11236,2,8,4,14
10472,11237,1,2,5,8
10472,11238,2,2,6,10
10472,11239,1,2,0,3
10472,11354,6,7,8,21
10472,11355,16,16,17,49
10472,11356,3,3,5,11
10472,11357,5,8,11,24
10472,11358,7,3,16,26
10472,11360,6,5,4,15
10472,11361,1,2,8,11
10472,11362,1,0,4,5
10472,11363,0,0,4,4
10472,11364,1,3,5,9
10472,11365,3,7,10,20
10472,11366,1,0,2,3
10472,11367,2,8,6,16
10472,11368,12,19,17,48
10472,11369,5,6,11,22
10472,11370,4,10,6,20
10472,11371,0,0,1,1
10472,11372,6,15,16,37
10472,11373,9,7,14,30
10472,11374,0,0,4,4
10472,11375,0,0,10,10
10472,11377,1,15,13,29
10472,11378,0,2,6,8
10472,11379,0,4,7,11
10472,11385,1,4,13,18
10472,11411,0,1,3,4
10472,11412,1,4,7,12
10472,11413,1,1,11,13
10472,11414,1,2,3,6
10472,11415,1,1,3,5
10472,11416,1,5,1,7
10472,11417,2,5,7,14
10472,11418,0,1,3,4
10472,11419,1,2,6,9
10472,11420,2,3,8,13
10472,11421,1,4,4,9
10472,11422,0,3,5,8
10472,11423,3,7,4,14
10472,11426,1,1,5,7
10472,11427,0,3,2,5
10472,11428,4,2,6,12
10472,11429,1,1,2,4
10472,11432,4,8,10,22
10472,11433,0,3,3,6
10472,11434,6,5,12,23
10472,11435,1,5,6,12
10472,11436,2,2,1,5
10472,11691,4,2,6,12
10472,11692,0,0,1,1
10472,11693,0,1,2,3
10472,11694,0,1,2,3
10472,11697,0,0,3,3
10473,10001,1,3,1,5
10473,10002,5,4,9,18
10473,10003,2,3,10,15
10473,10004,0,0,1,1
10473,10005,0,0,1,1
10473,10007,0,1,1,2
10473,10009,3,4,12,19
10473,10010,0,0,6,6
10473,10011,2,1,5,8
10473,10012,0,0,4,4
10473,10013,0,0,2,2
10473,10014,0,1,3,4
10473,10016,1,1,1,3
10473,10017,0,0,2,2
10473,10018,0,1,1,2
10473,10019,0,2,5,7
10473,10021,1,1,4,6
10473,10022,0,0,2,2
10473,10023,1,7,3,11
10473,10024,2,5,4,11
10473,10025,10,19,23,52
10473,10026,8,12,19,39
10473,10027,12,21,26,59
10473,10028,0,1,1,2
10473,10029,13,27,31,71
10473,10030,6,8,19,33
10473,10031,10,28,22,60
10473,10032,13,24,28,65
10473,10033,6,17,23,46
10473,10034,7,17,16,40
10473,10035,7,30,18,55
10473,10036,0,0,5,5
10473,10037,7,6,10,23
10473,10038,1,0,2,3
10473,10039,5,11,19,35
10473,10040,5,16,19,40
10473,10065,2,1,3,6
10473,10069,0,2,0,2
10473,10075,1,0,4,5
10473,10128,3,1,10,14
10473,10280,1,0,0,1
10473,10301,2,6,8,16
10473,10302,3,4,4,11
10473,10303,2,2,1,5
10473,10304,3,6,13,22
10473,10305,4,4,12,20
10473,10306,5,6,19,30
10473,10307,1,0,4,5
10473,10308,1,3,11,15
10473,10309,1,5,8,14
10473,10310,1,1,7,9
10473,10312,9,9,14,32
10473,10314,5,8,16,29
10473,10451,20,60,26,106
10473,10452,21,87,36,144
10473,10453,37,71,50,158
10473,10454,13,41,12,66
10473,10455,26,43,25,94
10473,10456,28,96,33,157
10473,10457,25,81,35,141
10473,10458,35,72,35,142
10473,10459,32,75,29,136
10473,10460,40,91,40,171
10473,10461,21,52,44,117
10473,10462,67,128,80,275
10473,10463,8,31,27,66
10473,10464,2,2,8,12
10473,10465,34,56,61,151
10473,10466,30,62,51,143
10473,10467,51,105,66,222
10473,10468,22,63,44,129
10473,10469,34,58,51,143
10473,10470,2,8,11,21
10473,10471,2,7,10,19
10473,10472,68,174,56,298
10473,10473,145,270,103,518
10473,10474,2,20,6,28
10473,10475,19,21,57,97
10473,11001,1,1,1,3
10473,11004,0,5,2,7
10473,11005,0,1,0,1
10473,11040,0,0,1,1
10473,11101,4,8,13,25
10473,11102,7,6,14,27
10473,11103,8,13,20,41
10473,11104,3,2,5,10
10473,11105,10,14,13,37
10473,11106,7,6,16,29
10473,11109,0,1,0,1
10473,11201,1,5,8,14
10473,11203,9,13,16,38
10473,11204,3,4,9,16
10473,11205,3,2,12,17
10473,11206,4,7,9,20
10473,11207,12,23,17,52
10473,11208,6,20,27,53
10473,11209,3,5,12,20
10473,11210,4,10,13,27
10473,11211,5,7,10,22
10473,11212,10,20,17,47
10473,11213,6,5,12,23
10473,11214,0,3,11,14
10473,11215,1,5,9,15
10473,11216,4,9,14,27
10473,11217,3,4,4,11
10473,11218,5,6,9,20
10473,11219,4,2,8,14
10473,11220,4,4,12,20
10473,11221,8,11,19,38
10473,11222,1,5,3,9
10473,11223,4,4,14,22
10473,11224,5,2,3,10
10473,11225,6,5,12,23
10473,11226,8,28,13,49
10473,11228,2,1,6,9
10473,11229,2,3,21,26
10473,11230,4,6,7,17
10473,11231,1,1,5,7
10473,11232,2,1,5,8
10473,11233,3,11,16,30
10473,11234,7,21,23,51
10473,11235,2,4,6,12
10473,11236,7,17,16,40
10473,11237,11,8,3,22
10473,11238,1,9,12,22
10473,11239,1,4,3,8
10473,11354,6,7,13,26
10473,11355,12,14,18,44
10473,11356,5,7,17,29
10473,11357,5,9,23,37
10473,11358,7,4,15,26
10473,11359,0,1,0,1
10473,11360,2,4,18,24
10473,11361,3,3,16,22
10473,11362,1,2,7,10
10473,11363,0,1,3,4
10473,11364,2,4,17,23
10473,11365,4,10,19,33
10473,11366,1,4,1,6
10473,11367,5,17,13,35
10473,11368,25,31,17,73
10473,11369,6,13,20,39
10473,11370,3,8,12,23
10473,11371,0,1,1,2
10473,11372,8,16,18,42
10473,11373,8,19,25,52
10473,11374,1,3,5,9
10473,11375,4,5,16,25
10473,11377,10,16,32,58
10473,11378,1,5,2,8
10473,11379,1,1,6,8
10473,11385,4,14,22,40
10473,11411,4,8,3,15
10473,11412,5,6,10,21
10473,11413,11,11,15,37
10473,11414,6,2,6,14
10473,11415,1,5,8,14
10473,11416,0,2,5,7
10473,11417,1,2,7,10
10473,11418,1,5,9,15
10473,11419,4,6,9,19
10473,11420,5,3,8,16
10473,11421,3,3,7,13
10473,11422,5,6,12,23
10473,11423,2,8,7,17
10473,11426,1,3,5,9
10473,11427,2,5,9,16
10473,11428,5,4,6,15
10473,11429,4,5,8,17
10473,11432,10,9,13,32
10473,11433,7,7,12,26
10473,11434,7,14,17,38
10473,11435,5,7,10,22
10473,11436,4,7,3,14
10473,11691,6,7,13,26
10473,11692,2,1,5,8
10473,11693,0,1,4,5
10473,11694,2,1,4,7
10473,11697,0,0,1,1
10474,10001,2,4,6,12
10474,10002,4,12,25,41
10474,10003,0,5,19,24
10474,10005,0,0,2,2
10474,10007,0,1,0,1
10474,10009,5,7,21,33
10474,10010,0,1,14,15
10474,10011,2,4,17,23
10474,10012,0,2,4,6
10474,10013,2,2,4,8
10474,10014,1,6,6,13
10474,10016,3,3,11,17
10474,10017,0,0,1,1
10474,10018,1,0,3,4
10474,10019,1,5,7,13
10474,10021,2,6,22,30
10474,10022,1,1,8,10
10474,10023,2,7,22,31
10474,10024,2,8,20,30
10474,10025,5,17,44,66
10474,10026,1,35,34,70
10474,10027,13,53,49,115
10474,10028,4,2,38,44
10474,10029,5,91,75,171
10474,10030,0,23,45,68
10474,10031,15,82,77,174
10474,10032,12,56,46,114
10474,10033,15,66,63,144
10474,10034,11,40,54,105
10474,10035,19,54,19,92
10474,10036,0,1,7,8
10474,10037,2,15,18,35
10474,10038,0,3,4,7
10474,10039,7,37,18,62
10474,10040,4,53,58,115
10474,10044,0,4,1,5
10474,10065,2,10,16,28
10474,10069,0,3,4,7
10474,10075,1,5,23,29
10474,10128,5,11,39,55
10474,10162,0,0,1,1
10474,10280,0,1,2,3
10474,10282,0,1,2,3
10474,10301,0,2,12,14
10474,10302,0,0,5,5
10474,10303,0,3,6,9
10474,10304,2,3,7,12
10474,10305,1,0,17,18
10474,10306,0,6,34,40
10474,10307,0,2,14,16
10474,10308,0,3,25,28
10474,10309,0,4,21,25
10474,10310,1,2,5,8
10474,10312,3,4,36,43
10474,10314,0,3,33,36
10474,10451,22,123,71,216
10474,10452,42,240,199,481
10474,10453,45,208,162,415
10474,10454,31,110,89,230
10474,10455,26,184,141,351
10474,10456,43,294,203,540
10474,10457,33,241,144,418
10474,10458,28,187,144,359
10474,10459,59,233,160,452
10474,10460,43,213,191,447
10474,10461,22,55,162,239
10474,10462,25,163,182,370
10474,10463,21,59,90,170
10474,10464,1,4,4,9
10474,10465,17,48,110,175
10474,10466,19,106,112,237
10474,10467,33,179,183,395
10474,10468,42,193,116,351
10474,10469,28,72,106,206
10474,10470,3,8,14,25
10474,10471,3,2,34,39
10474,10472,49,259,208,516
10474,10473,37,182,194,413
10474,10474,53,156,101,310
10474,10475,14,39,67,120
10474,11001,0,0,2,2
10474,11004,0,3,5,8
10474,11040,0,1,1,2
10474,11101,4,5,19,28
10474,11102,4,25,25,54
10474,11103,4,14,34,52
10474,11104,4,3,22,29
10474,11105,7,22,36,65
10474,11106,9,17,34,60
10474,11109,1,0,5,6
10474,11201,2,6,17,25
10474,11203,2,15,10,27
10474,11204,1,5,13,19
10474,11205,0,7,8,15
10474,11206,10,10,23,43
10474,11207,9,22,40,71
10474,11208,5,15,37,57
10474,11209,1,10,21,32
10474,11210,3,16,25,44
10474,11211,0,9,30,39
10474,11212,6,25,25,56
10474,11213,2,13,22,37
10474,11214,1,5,20,26
10474,11215,5,7,19,31
10474,11216,0,5,18,23
10474,11217,1,3,10,14
10474,11218,4,9,14,27
10474,11219,0,4,19,23
10474,11220,6,6,20,32
10474,11221,7,13,29,49
10474,11222,3,9,9,21
10474,11223,1,8,12,21
10474,11224,0,5,6,11
10474,11225,2,14,17,33
10474,11226,3,29,39,71
10474,11228,1,5,9,15
10474,11229,4,8,20,32
10474,11230,2,15,16,33
10474,11231,4,2,9,15
10474,11232,1,2,7,10
10474,11233,4,18,25,47
10474,11234,3,22,19,44
10474,11235,3,10,16,29
10474,11236,2,19,23,44
10474,11237,3,8,22,33
10474,11238,2,9,21,32
10474,11239,0,4,5,9
10474,11354,5,11,31,47
10474,11355,18,21,25,64
10474,11356,1,13,20,34
10474,11357,2,8,38,48
10474,11358,6,21,30,57
10474,11360,5,6,16,27
10474,11361,1,13,29,43
10474,11362,0,6,8,14
10474,11363,0,5,3,8
10474,11364,5,17,35,57
10474,11365,3,8,21,32
10474,11366,2,7,7,16
10474,11367,4,8,22,34
10474,11368,12,59,71,142
10474,11369,9,38,29,76
10474,11370,6,10,17,33
10474,11372,3,15,32,50
10474,11373,9,13,62,84
10474,11374,5,9,26,40
10474,11375,9,12,38,59
10474,11377,9,31,70,110
10474,11378,3,9,41,53
10474,11379,5,11,38,54
10474,11385,10,38,90,138
10474,11411,3,5,9,17
10474,11412,3,6,12,21
10474,11413,2,6,11,19
10474,11414,2,4,13,19
10474,11415,2,8,11,21
10474,11416,3,7,11,21
10474,11417,2,7,22,31
10474,11418,5,13,20,38
10474,11419,3,15,22,40
10474,11420,1,20,25,46
10474,11421,2,15,28,45
10474,11422,1,5,12,18
10474,11423,1,7,16,24
10474,11426,0,3,8,11
10474,11427,1,12,16,29
10474,11428,1,7,4,12
10474,11429,0,4,6,10
10474,11432,1,22,23,46
10474,11433,1,6,14,21
10474,11434,2,12,20,34
10474,11435,2,29,26,57
10474,11436,1,3,4,8
10474,11691,1,4,14,19
10474,11692,0,0,3,3
10474,11693,0,0,3,3
10474,11694,0,0,5,5
10475,10001,0,2,3,5
10475,10002,8,6,5,19
10475,10003,4,1,3,8
10475,10005,0,1,0,1
10475,10009,4,2,4,10
10475,10010,2,0,3,5
10475,10011,4,2,1,7
10475,10012,1,1,2,4
10475,10013,4,0,3,7
10475,10014,0,1,1,2
10475,10016,0,0,1,1
10475,10017,0,1,2,3
10475,10018,0,0,1,1
10475,10019,1,1,8,10
10475,10021,2,2,3,7
10475,10022,0,1,1,2
10475,10023,4,2,7,13
10475,10024,3,2,6,11
10475,10025,6,8,15,29
10475,10026,6,21,4,31
10475,10027,11,14,15,40
10475,10028,1,0,2,3
10475,10029,9,19,23,51
10475,10030,2,7,6,15
10475,10031,13,13,17,43
10475,10032,7,17,25,49
10475,10033,10,15,16,41
10475,10034,4,15,9,28
10475,10035,13,5,6,24
10475,10036,2,4,2,8
10475,10037,1,7,4,12
10475,10039,6,7,4,17
10475,10040,11,14,16,41
10475,10065,1,1,1,3
10475,10075,0,0,2,2
10475,10128,3,1,4,8
10475,10280,1,1,2,4
10475,10301,5,2,8,15
10475,10302,2,2,2,6
10475,10303,2,6,5,13
10475,10304,8,4,4,16
10475,10305,8,5,4,17
10475,10306,10,9,14,33
10475,10307,2,2,5,9
10475,10308,4,1,3,8
10475,10309,4,4,14,22
10475,10310,0,4,4,8
10475,10312,4,8,8,20
10475,10314,13,12,13,38
10475,10451,24,39,40,103
10475,10452,37,53,37,127
10475,10453,38,51,29,118
10475,10454,30,25,15,70
10475,10455,25,27,27,79
10475,10456,61,53,63,177
10475,10457,49,43,53,145
10475,10458,53,78,51,182
10475,10459,10,41,39,90
10475,10460,41,49,37,127
10475,10461,38,49,104,191
10475,10462,70,70,114,254
10475,10463,29,21,33,83
10475,10464,4,0,3,7
10475,10465,19,30,72,121
10475,10466,96,145,148,389
10475,10467,91,147,119,357
10475,10468,39,53,47,139
10475,10469,92,150,127,369
10475,10470,9,18,31,58
10475,10471,4,8,18,30
10475,10472,50,42,51,143
10475,10473,56,57,64,177
10475,10474,11,8,6,25
10475,10475,98,196,275,569
10475,11001,0,2,4,6
10475,11004,2,3,4,9
10475,11005,1,0,3,4
10475,11040,2,0,0,2
10475,11101,7,4,5,16
10475,11102,5,7,8,20
10475,11103,8,7,4,19
10475,11104,7,0,2,9
10475,11105,7,6,6,19
10475,11106,2,3,6,11
10475,11109,0,0,1,1
10475,11201,2,5,6,13
10475,11203,6,11,11,28
10475,11204,2,3,4,9
10475,11205,2,5,2,9
10475,11206,8,4,3,15
10475,11207,13,20,12,45
10475,11208,13,17,11,41
10475,11209,2,1,7,10
10475,11210,10,8,7,25
10475,11211,0,4,14,18
10475,11212,15,15,15,45
10475,11213,4,4,3,11
10475,11214,3,3,10,16
10475,11215,3,2,4,9
10475,11216,5,7,9,21
10475,11217,3,4,2,9
10475,11218,1,2,3,6
10475,11219,3,4,3,10
10475,11220,8,3,11,22
10475,11221,3,9,7,19
10475,11222,0,1,2,3
10475,11223,3,2,5,10
10475,11224,6,5,4,15
10475,11225,6,7,8,21
10475,11226,11,9,14,34
10475,11228,1,2,4,7
10475,11229,4,2,12,18
10475,11230,7,5,5,17
10475,11231,0,1,4,5
10475,11232,1,4,3,8
10475,11233,11,4,12,27
10475,11234,14,13,15,42
10475,11235,7,3,2,12
10475,11236,12,19,20,51
10475,11237,6,1,8,15
10475,11238,2,3,10,15
10475,11239,2,4,2,8
10475,11354,11,12,12,35
10475,11355,17,19,17,53
10475,11356,6,8,14,28
10475,11357,13,7,33,53
10475,11358,9,6,9,24
10475,11359,1,0,1,2
10475,11360,3,1,7,11
10475,11361,3,3,6,12
10475,11362,2,1,5,8
10475,11363,0,0,3,3
10475,11364,6,4,5,15
10475,11365,7,7,7,21
10475,11366,2,1,2,5
10475,11367,4,3,8,15
10475,11368,22,15,14,51
10475,11369,1,7,3,11
10475,11370,5,3,3,11
10475,11372,7,9,12,28
10475,11373,13,9,9,31
10475,11374,2,4,7,13
10475,11375,2,4,7,13
10475,11377,7,12,17,36
10475,11378,3,3,6,12
10475,11379,5,5,5,15
10475,11385,10,14,15,39
10475,11411,1,6,7,14
10475,11412,11,7,16,34
10475,11413,8,6,9,23
10475,11414,3,2,8,13
10475,11415,2,4,7,13
10475,11416,3,5,8,16
10475,11417,5,2,5,12
10475,11418,5,4,5,14
10475,11419,4,9,14,27
10475,11420,5,6,9,20
10475,11421,5,5,9,19
10475,11422,6,4,4,14
10475,11423,7,3,2,12
10475,11426,1,3,5,9
10475,11427,2,3,6,11
10475,11428,2,6,6,14
10475,11429,12,3,11,26
10475,11432,16,12,13,41
10475,11433,4,3,12,19
10475,11434,7,8,16,31
10475,11435,5,11,11,27
10475,11436,1,4,5,10
10475,11691,6,8,13,27
10475,11692,2,3,6,11
10475,11693,0,1,6,7
10475,11694,1,3,7,11
10475,11697,0,1,1,2
11001,10002,1,0,0,1
11001,10003,0,0,1,1
11001,10005,0,1,0,1
11001,10021,0,0,1,1
11001,10024,0,0,2,2
11001,10027,0,1,0,1
11001,10029,0,1,1,2
11001,10030,0,2,1,3
11001,10032,0,0,1,1
11001,10033,0,0,1,1
11001,10039,0,0,1,1
11001,10040,0,2,0,2
11001,10301,1,0,0,1
11001,10303,0,1,0,1
11001,10305,0,0,1,1
11001,10309,0,0,1,1
11001,10314,0,0,1,1
11001,10453,2,1,1,4
11001,10456,1,1,0,2
11001,10457,1,1,0,2
11001,10458,2,0,0,2
11001,10460,0,1,0,1
11001,10462,1,0,2,3
11001,10465,1,0,1,2
11001,10466,0,1,0,1
11001,10467,1,0,0,1
11001,10468,0,1,0,1
11001,10471,1,0,1,2
11001,10473,1,0,3,4
11001,10475,1,0,0,1
11001,11001,13,12,4,29
11001,11004,6,9,2,17
11001,11040,1,1,0,2
11001,11102,0,1,1,2
11001,11103,0,1,0,1
11001,11105,0,1,0,1
11001,11106,0,2,0,2
11001,11203,0,0,1,1
11001,11207,0,2,1,3
11001,11208,2,3,1,6
11001,11209,0,0,1,1
11001,11210,0,1,1,2
11001,11211,1,0,2,3
11001,11212,2,1,0,3
11001,11215,0,0,1,1
11001,11218,1,0,0,1
11001,11219,1,0,0,1
11001,11220,0,0,1,1
11001,11223,0,0,1,1
11001,11224,0,0,2,2
11001,11226,1,0,1,2
11001,11230,1,0,0,1
11001,11233,0,0,1,1
11001,11234,0,0,1,1
11001,11236,0,0,1,1
11001,11354,0,0,3,3
11001,11355,2,3,3,8
11001,11356,0,0,1,1
11001,11357,0,1,2,3
11001,11358,6,0,2,8
11001,11360,0,1,1,2
11001,11361,0,0,5,5
11001,11362,1,1,0,2
11001,11363,0,2,3,5
11001,11364,0,1,1,2
11001,11365,0,2,0,2
11001,11366,0,1,0,1
11001,11367,0,1,2,3
11001,11368,5,1,1,7
11001,11369,1,2,2,5
11001,11370,0,1,0,1
11001,11372,1,5,3,9
11001,11373,7,5,0,12
11001,11374,0,1,2,3
11001,11375,0,1,1,2
11001,11377,0,1,0,1
11001,11378,0,0,1,1
11001,11379,0,2,0,2
11001,11385,1,5,4,10
11001,11411,1,1,0,2
11001,11412,2,0,1,3
11001,11413,2,0,5,7
11001,11414,0,0,1,1
11001,11415,0,0,1,1
11001,11416,1,0,1,2
11001,11417,0,1,0,1
11001,11418,1,1,0,2
11001,11419,5,1,0,6
11001,11420,4,0,1,5
11001,11421,0,0,2,2
11001,11422,1,0,0,1
11001,11423,0,0,2,2
11001,11426,1,7,0,8
11001,11427,1,6,0,7
11001,11428,4,6,1,11
11001,11429,1,2,0,3
11001,11432,1,6,0,7
11001,11433,2,0,0,2
11001,11434,2,1,0,3
11001,11435,2,2,0,4
11001,11436,1,0,0,1
11001,11691,0,1,0,1
11001,11692,0,0,2,2
11001,11693,0,0,1,1
11001,11694,2,0,0,2
11004,10001,1,1,6,8
11004,10002,1,0,9,10
11004,10003,2,1,1,4
11004,10004,0,0,1,1
11004,10005,0,0,1,1
11004,10006,0,0,1,1
11004,10009,6,3,3,12
11004,10010,1,0,5,6
11004,10011,1,1,7,9
11004,10012,0,1,2,3
11004,10013,2,1,5,8
11004,10014,3,2,6,11
11004,10016,4,2,7,13
11004,10017,1,0,2,3
11004,10018,1,0,1,2
11004,10019,0,0,8,8
11004,10021,0,0,9,9
11004,10022,0,0,8,8
11004,10023,2,0,10,12
11004,10024,0,0,7,7
11004,10025,1,2,12,15
11004,10026,0,0,1,1
11004,10027,0,3,11,14
11004,10028,3,1,13,17
11004,10029,1,4,15,20
11004,10030,1,0,0,1
11004,10031,1,0,6,7
11004,10032,3,2,5,10
11004,10033,0,2,6,8
11004,10034,0,1,3,4
11004,10035,0,1,3,4
11004,10036,0,0,4,4
11004,10037,2,4,2,8
11004,10038,0,2,0,2
11004,10039,1,0,3,4
11004,10040,1,1,2,4
11004,10044,0,2,8,10
11004,10065,0,0,14,14
11004,10075,0,0,10,10
11004,10128,0,0,19,19
11004,10280,1,0,2,3
11004,10282,0,0,2,2
11004,10301,0,7,20,27
11004,10302,0,1,17,18
11004,10303,2,6,11,19
11004,10304,3,11,19,33
11004,10305,5,8,44,57
11004,10306,2,11,51,64
11004,10307,1,4,12,17
11004,10308,1,7,20,28
11004,10309,6,13,29,48
11004,10310,1,3,13,17
11004,10312,4,16,68,88
11004,10314,7,13,72,92
11004,10451,3,1,3,7
11004,10452,2,5,8,15
11004,10453,0,3,10,13
11004,10454,0,0,2,2
11004,10456,1,3,6,10
11004,10457,1,2,3,6
11004,10458,0,5,4,9
11004,10459,2,1,6,9
11004,10460,1,0,2,3
11004,10461,2,3,20,25
11004,10462,3,3,14,20
11004,10463,3,4,8,15
11004,10464,1,1,3,5
11004,10465,6,10,25,41
11004,10466,1,5,13,19
11004,10467,3,6,15,24
11004,10468,0,4,10,14
11004,10469,2,6,17,25
11004,10470,0,2,2,4
11004,10471,1,3,7,11
11004,10472,4,9,17,30
11004,10473,3,7,13,23
11004,10475,2,2,9,13
11004,11001,18,6,15,39
11004,11004,48,62,122,232
11004,11005,0,0,1,1
11004,11040,7,10,11,28
11004,11101,4,3,20,27
11004,11102,1,1,10,12
11004,11103,2,5,12,19
11004,11104,1,5,10,16
11004,11105,0,2,7,9
11004,11106,2,3,11,16
11004,11109,0,0,5,5
11004,11201,1,2,7,10
11004,11203,2,7,21,30
11004,11204,1,2,5,8
11004,11205,0,2,7,9
11004,11206,2,6,8,16
11004,11207,0,11,30,41
11004,11208,6,25,37,68
11004,11209,1,5,13,19
11004,11210,3,4,13,20
11004,11211,4,5,12,21
11004,11212,5,6,11,22
11004,11213,1,1,5,7
11004,11214,0,5,9,14
11004,11215,0,1,7,8
11004,11216,2,0,7,9
11004,11217,0,1,4,5
11004,11218,1,2,3,6
11004,11219,3,1,7,11
11004,11220,1,0,7,8
11004,11221,2,7,5,14
11004,11222,0,0,4,4
11004,11223,2,5,15,22
11004,11224,3,5,5,13
11004,11225,2,4,10,16
11004,11226,2,9,17,28
11004,11228,1,4,7,12
11004,11229,3,1,14,18
11004,11230,1,2,7,10
11004,11231,1,1,6,8
11004,11232,0,1,1,2
11004,11233,1,3,12,16
11004,11234,0,10,24,34
11004,11235,3,1,8,12
11004,11236,2,10,27,39
11004,11237,0,1,8,9
11004,11238,2,2,9,13
11004,11239,0,2,5,7
11004,11354,9,18,31,58
11004,11355,8,15,33,56
11004,11356,2,7,18,27
11004,11357,6,5,40,51
11004,11358,7,12,48,67
11004,11360,1,4,25,30
11004,11361,4,6,46,56
11004,11362,17,7,51,75
11004,11363,0,0,12,12
11004,11364,13,26,62,101
11004,11365,9,11,51,71
11004,11366,7,3,37,47
11004,11367,6,10,52,68
11004,11368,7,22,36,65
11004,11369,1,6,18,25
11004,11370,7,4,13,24
11004,11371,1,0,1,2
11004,11372,8,8,26,42
11004,11373,8,22,38,68
11004,11374,2,6,46,54
11004,11375,11,16,98,125
11004,11377,7,10,44,61
11004,11378,4,11,32,47
11004,11379,5,15,40,60
11004,11385,7,13,47,67
11004,11411,7,12,59,78
11004,11412,9,38,59,106
11004,11413,15,33,72,120
11004,11414,1,7,21,29
11004,11415,1,1,21,23
11004,11416,5,4,10,19
11004,11417,5,7,22,34
11004,11418,7,6,28,41
11004,11419,13,11,33,57
11004,11420,15,21,37,73
11004,11421,2,6,15,23
11004,11422,7,32,53,92
11004,11423,7,23,68,98
11004,11426,33,37,78,148
11004,11427,17,21,61,99
11004,11428,15,19,52,86
11004,11429,9,19,70,98
11004,11432,19,27,58,104
11004,11433,9,14,35,58
11004,11434,11,43,77,131
11004,11435,2,18,48,68
11004,11436,6,9,19,34
11004,11451,0,1,0,1
11004,11691,1,16,38,55
11004,11692,1,5,6,12
11004,11693,1,3,9,13
11004,11694,3,1,16,20
11004,11697,0,1,2,3
11005,10023,0,0,1,1
11005,10028,0,1,0,1
11005,10032,0,1,0,1
11005,10075,0,0,1,1
11005,10128,0,0,1,1
11005,10456,0,0,1,1
11005,10461,0,0,1,1
11005,10465,1,0,4,5
11005,10472,0,0,4,4
11005,10473,0,1,0,1
11005,11004,0,1,0,1
11005,11005,0,4,5,9
11005,11103,0,0,2,2
11005,11105,0,0,1,1
11005,11106,0,1,0,1
11005,11203,0,1,0,1
11005,11204,0,1,0,1
11005,11208,0,0,2,2
11005,11230,0,0,1,1
11005,11234,0,0,1,1
11005,11236,0,1,0,1
11005,11239,0,0,1,1
11005,11354,0,1,2,3
11005,11355,1,1,0,2
11005,11357,0,0,1,1
11005,11358,3,0,4,7
11005,11360,2,0,1,3
11005,11362,0,0,1,1
11005,11364,1,1,0,2
11005,11365,0,1,0,1
11005,11366,1,0,1,2
11005,11367,1,0,2,3
11005,11368,1,2,0,3
11005,11369,0,1,0,1
11005,11370,0,0,1,1
11005,11372,2,0,0,2
11005,11374,0,0,1,1
11005,11378,0,0,5,5
11005,11379,1,0,4,5
11005,11385,2,1,2,5
11005,11411,0,0,2,2
11005,11412,0,4,0,4
11005,11413,0,0,1,1
11005,11416,0,0,1,1
11005,11417,0,2,0,2
11005,11419,0,2,5,7
11005,11420,0,2,2,4
11005,11422,0,1,0,1
11005,11426,0,0,1,1
11005,11428,0,1,1,2
11005,11429,1,0,2,3
11005,11432,2,0,0,2
11005,11434,3,2,4,9
11005,11435,1,0,1,2
11005,11436,0,0,1,1
11005,11691,0,0,1,1
11005,11692,0,0,1,1
11040,10024,1,0,0,1
11040,10025,1,0,0,1
11040,10029,2,2,0,4
11040,10035,1,1,0,2
11040,10065,0,0,2,2
11040,10305,0,1,0,1
11040,10306,2,0,0,2
11040,10309,1,1,0,2
11040,10310,0,1,0,1
11040,10312,1,1,0,2
11040,10314,0,1,0,1
11040,10451,1,0,0,1
11040,10453,0,2,0,2
11040,10454,0,1,0,1
11040,10455,0,1,0,1
11040,10457,0,1,0,1
11040,10460,1,0,0,1
11040,10462,0,2,1,3
11040,10465,0,2,0,2
11040,10466,1,0,0,1
11040,10467,0,3,0,3
11040,10469,1,0,0,1
11040,10472,1,0,0,1
11040,10474,1,0,0,1
11040,10475,1,1,0,2
11040,11004,8,12,2,22
11040,11040,2,1,0,3
11040,11102,0,2,0,2
11040,11104,1,0,2,3
11040,11105,0,1,0,1
11040,11106,0,1,0,1
11040,11203,0,3,0,3
11040,11204,1,0,0,1
11040,11205,0,1,0,1
11040,11206,1,0,0,1
11040,11207,0,0,1,1
11040,11208,1,1,0,2
11040,11209,1,0,0,1
11040,11211,1,0,0,1
11040,11212,1,0,1,2
11040,11214,0,1,1,2
11040,11217,1,0,0,1
11040,11220,0,1,0,1
11040,11221,1,0,0,1
11040,11223,1,0,1,2
11040,11224,0,0,1,1
11040,11226,1,1,0,2
11040,11233,0,2,1,3
11040,11239,0,0,1,1
11040,11354,1,2,1,4
11040,11355,4,5,0,9
11040,11357,1,0,0,1
11040,11358,2,1,0,3
11040,11360,0,0,1,1
11040,11361,2,0,2,4
11040,11362,2,0,2,4
11040,11364,0,0,2,2
11040,11365,1,0,0,1
11040,11366,1,0,0,1
11040,11367,2,2,0,4
11040,11368,1,1,2,4
11040,11369,1,1,0,2
11040,11370,3,2,0,5
11040,11372,1,0,0,1
11040,11373,3,3,2,8
11040,11375,0,2,0,2
11040,11377,5,2,0,7
11040,11379,0,0,1,1
11040,11411,1,0,0,1
11040,11412,2,3,0,5
11040,11413,0,0,1,1
11040,11414,1,0,0,1
11040,11415,1,0,1,2
11040,11416,0,2,0,2
11040,11417,0,1,0,1
11040,11418,1,1,0,2
11040,11419,3,0,0,3
11040,11420,1,1,0,2
11040,11422,1,0,0,1
11040,11423,0,3,4,7
11040,11426,2,6,2,10
11040,11427,0,3,0,3
11040,11428,4,2,1,7
11040,11429,1,2,1,4
11040,11432,1,5,0,6
11040,11434,2,3,0,5
11040,11435,1,1,0,2
11040,11436,0,2,0,2
11040,11691,0,1,0,1
11040,11692,0,1,0,1
11101,10001,27,42,63,132
11101,10002,92,174,207,473
11101,10003,59,42,140,241
11101,10004,5,4,22,31
11101,10005,10,4,38,52
11101,10006,3,2,18,23
11101,10007,4,2,23,29
11101,10009,57,96,182,335
11101,10010,20,44,74,138
11101,10011,56,54,160,270
11101,10012,25,14,42,81
11101,10013,33,24,68,125
11101,10014,32,24,77,133
11101,10016,33,37,179,249
11101,10017,23,17,51,91
11101,10018,13,15,35,63
11101,10019,47,60,148,255
11101,10021,18,20,119,157
11101,10022,27,17,124,168
11101,10023,50,39,174,263
11101,10024,50,47,165,262
11101,10025,102,134,244,480
11101,10026,42,120,120,282
11101,10027,98,182,179,459
11101,10028,23,27,182,232
11101,10029,93,263,180,536
11101,10030,58,96,83,237
11101,10031,85,207,189,481
11101,10032,74,170,170,414
11101,10033,80,141,148,369
11101,10034,42,113,127,282
11101,10035,59,142,116,317
11101,10036,59,46,102,207
11101,10037,37,67,65,169
11101,10038,15,24,52,91
11101,10039,54,96,72,222
11101,10040,40,95,128,263
11101,10044,9,14,28,51
11101,10065,27,28,105,160
11101,10069,4,5,19,28
11101,10075,8,15,82,105
11101,10119,0,0,1,1
11101,10128,37,45,208,290
11101,10162,0,0,5,5
11101,10173,0,1,0,1
11101,10280,9,5,42,56
11101,10282,3,2,17,22
11101,10301,25,57,81,163
11101,10302,5,28,46,79
11101,10303,22,50,61,133
11101,10304,21,55,105,181
11101,10305,14,32,88,134
11101,10306,20,47,111,178
11101,10307,6,12,34,52
11101,10308,12,12,63,87
11101,10309,12,18,63,93
11101,10310,11,33,40,84
11101,10312,19,45,145,209
11101,10314,42,70,216,328
11101,10451,70,189,132,391
11101,10452,89,294,203,586
11101,10453,115,307,223,645
11101,10454,50,112,110,272
11101,10455,58,181,132,371
11101,10456,110,372,256,738
11101,10457,89,283,196,568
11101,10458,59,245,185,489
11101,10459,93,181,107,381
11101,10460,56,229,149,434
11101,10461,46,118,148,312
11101,10462,74,190,221,485
11101,10463,52,97,151,300
11101,10464,3,5,11,19
11101,10465,39,73,142,254
11101,10466,54,185,126,365
11101,10467,75,222,182,479
11101,10468,79,209,159,447
11101,10469,56,135,157,348
11101,10470,9,37,37,83
11101,10471,16,34,73,123
11101,10472,79,238,174,491
11101,10473,80,213,181,474
11101,10474,23,55,39,117
11101,10475,37,89,110,236
11101,11001,3,11,17,31
11101,11004,14,29,55,98
11101,11005,0,2,4,6
11101,11040,1,2,7,10
11101,11101,176,346,376,898
11101,11102,96,230,254,580
11101,11103,97,196,293,586
11101,11104,74,170,278,522
11101,11105,93,172,306,571
11101,11106,140,257,365,762
11101,11109,14,21,70,105
11101,11201,46,96,173,315
11101,11203,125,319,297,741
11101,11204,28,72,124,224
11101,11205,74,104,120,298
11101,11206,127,375,265,767
11101,11207,147,555,372,1074
11101,11208,148,463,339,950
11101,11209,36,73,194,303
11101,11210,68,191,169,428
11101,11211,78,209,352,639
11101,11212,111,462,212,785
11101,11213,82,249,193,524
11101,11214,46,110,150,306
11101,11215,49,63,251,363
11101,11216,85,205,198,488
11101,11217,37,74,139,250
11101,11218,44,100,206,350
11101,11219,35,84,114,233
11101,11220,59,182,148,389
11101,11221,115,370,297,782
11101,11222,65,139,264,468
11101,11223,46,100,148,294
11101,11224,36,123,93,252
11101,11225,91,194,195,480
11101,11226,120,433,330,883
11101,11228,15,46,85,146
11101,11229,32,106,141,279
11101,11230,70,130,189,389
11101,11231,35,69,118,222
11101,11232,21,57,88,166
11101,11233,131,336,255,722
11101,11234,102,230,338,670
11101,11235,45,77,131,253
11101,11236,130,391,349,870
11101,11237,46,201,170,417
11101,11238,44,133,195,372
11101,11239,15,41,37,93
11101,11354,82,138,206,426
11101,11355,141,255,199,595
11101,11356,31,89,125,245
11101,11357,64,110,311,485
11101,11358,69,103,208,380
11101,11359,0,1,1,2
11101,11360,20,37,110,167
11101,11361,36,51,141,228
11101,11362,22,29,58,109
11101,11363,4,18,32,54
11101,11364,35,48,134,217
11101,11365,59,109,239,407
11101,11366,12,29,55,96
11101,11367,52,116,189,357
11101,11368,228,709,472,1409
11101,11369,100,253,222,575
11101,11370,87,150,178,415
11101,11371,1,6,1,8
11101,11372,154,441,367,962
11101,11373,264,503,398,1165
11101,11374,57,104,272,433
11101,11375,70,131,404,605
11101,11377,287,553,565,1405
11101,11378,91,185,328,604
11101,11379,69,123,341,533
11101,11385,156,471,689,1316
11101,11411,46,95,122,263
11101,11412,65,166,170,401
11101,11413,58,212,175,445
11101,11414,20,49,166,235
11101,11415,39,69,162,270
11101,11416,47,109,146,302
11101,11417,37,115,181,333
11101,11418,65,145,233,443
11101,11419,67,190,242,499
11101,11420,61,209,254,524
11101,11421,87,229,269,585
11101,11422,40,124,118,282
11101,11423,44,147,148,339
11101,11426,16,38,84,138
11101,11427,33,65,119,217
11101,11428,34,72,115,221
11101,11429,49,114,105,268
11101,11430,0,1,2,3
11101,11432,109,271,235,615
11101,11433,75,197,122,394
11101,11434,101,315,226,642
11101,11435,76,242,285,603
11101,11436,32,94,77,203
11101,11691,64,158,165,387
11101,11692,22,65,59,146
11101,11693,16,43,55,114
11101,11694,10,29,87,126
11101,11697,5,7,24,36
11102,10001,1,4,4,9
11102,10002,7,13,15,35
11102,10003,2,4,21,27
11102,10004,2,3,4,9
11102,10005,1,1,1,3
11102,10006,1,1,0,2
11102,10009,9,4,22,35
11102,10010,2,5,9,16
11102,10011,3,10,12,25
11102,10012,0,2,4,6
11102,10013,2,5,7,14
11102,10014,5,2,1,8
11102,10016,2,4,11,17
11102,10017,2,3,2,7
11102,10018,0,3,8,11
11102,10019,4,7,11,22
11102,10021,2,2,8,12
11102,10022,4,11,8,23
11102,10023,1,4,17,22
11102,10024,1,13,9,23
11102,10025,2,18,34,54
11102,10026,5,9,9,23
11102,10027,7,19,19,45
11102,10028,4,5,18,27
11102,10029,12,35,45,92
11102,10030,4,10,11,25
11102,10031,2,10,14,26
11102,10032,4,9,11,24
11102,10033,3,15,11,29
11102,10034,0,10,6,16
11102,10035,11,17,9,37
11102,10036,2,4,9,15
11102,10037,2,13,6,21
11102,10038,3,3,4,10
11102,10039,1,7,6,14
11102,10040,3,7,11,21
11102,10044,2,4,4,10
11102,10065,1,2,7,10
11102,10069,0,1,3,4
11102,10075,0,2,15,17
11102,10128,8,11,51,70
11102,10162,0,0,1,1
11102,10282,0,2,0,2
11102,10301,0,4,3,7
11102,10302,0,1,1,2
11102,10303,1,2,4,7
11102,10304,1,5,4,10
11102,10305,0,2,9,11
11102,10306,1,1,14,16
11102,10307,1,0,4,5
11102,10308,0,2,3,5
11102,10309,2,1,2,5
11102,10310,0,2,5,7
11102,10312,2,8,12,22
11102,10314,0,4,12,16
11102,10451,3,13,7,23
11102,10452,9,28,11,48
11102,10453,14,33,16,63
11102,10454,6,12,5,23
11102,10455,4,13,5,22
11102,10456,14,25,13,52
11102,10457,9,21,11,41
11102,10458,8,16,11,35
11102,10459,7,21,20,48
11102,10460,13,20,11,44
11102,10461,7,11,13,31
11102,10462,16,27,26,69
11102,10463,5,19,17,41
11102,10464,1,1,2,4
11102,10465,4,8,12,24
11102,10466,16,20,9,45
11102,10467,13,39,14,66
11102,10468,6,25,17,48
11102,10469,8,23,14,45
11102,10470,1,3,9,13
11102,10471,3,4,2,9
11102,10472,5,27,13,45
11102,10473,14,27,25,66
11102,10474,1,5,0,6
11102,10475,1,3,10,14
11102,11001,3,0,3,6
11102,11004,1,7,8,16
11102,11005,1,2,2,5
11102,11040,1,0,0,1
11102,11101,19,35,18,72
11102,11102,109,166,108,383
11102,11103,48,57,48,153
11102,11104,11,20,28,59
11102,11105,44,88,55,187
11102,11106,52,65,45,162
11102,11109,0,2,1,3
11102,11201,6,7,9,22
11102,11203,5,43,16,64
11102,11204,5,5,6,16
11102,11205,11,10,7,28
11102,11206,19,20,18,57
11102,11207,15,36,35,86
11102,11208,11,33,24,68
11102,11209,2,8,9,19
11102,11210,8,47,9,64
11102,11211,7,17,15,39
11102,11212,20,42,19,81
11102,11213,10,37,28,75
11102,11214,7,14,13,34
11102,11215,6,5,13,24
11102,11216,10,24,12,46
11102,11217,2,13,7,22
11102,11218,2,9,9,20
11102,11219,5,5,6,16
11102,11220,3,7,10,20
11102,11221,10,26,19,55
11102,11222,3,12,14,29
11102,11223,1,15,7,23
11102,11224,1,9,2,12
11102,11225,10,42,13,65
11102,11226,12,68,17,97
11102,11228,1,10,1,12
11102,11229,1,14,15,30
11102,11230,3,29,6,38
11102,11231,1,10,6,17
11102,11232,1,5,2,8
11102,11233,17,35,19,71
11102,11234,11,61,37,109
11102,11235,1,9,6,16
11102,11236,13,91,42,146
11102,11237,7,14,8,29
11102,11238,9,13,15,37
11102,11239,4,5,3,12
11102,11354,12,23,14,49
11102,11355,11,37,28,76
11102,11356,5,22,13,40
11102,11357,17,26,38,81
11102,11358,9,24,19,52
11102,11359,0,1,2,3
11102,11360,5,12,22,39
11102,11361,6,25,24,55
11102,11362,4,5,12,21
11102,11363,1,0,1,2
11102,11364,5,9,18,32
11102,11365,11,10,18,39
11102,11366,4,8,7,19
11102,11367,7,9,22,38
11102,11368,33,53,36,122
11102,11369,14,42,20,76
11102,11370,20,29,21,70
11102,11372,24,44,19,87
11102,11373,28,55,35,118
11102,11374,10,19,22,51
11102,11375,9,24,39,72
11102,11377,52,56,53,161
11102,11378,10,19,22,51
11102,11379,4,22,32,58
11102,11385,21,42,37,100
11102,11411,1,8,8,17
11102,11412,4,8,7,19
11102,11413,6,8,16,30
11102,11414,4,2,11,17
11102,11415,5,8,11,24
11102,11416,4,10,7,21
11102,11417,9,8,6,23
11102,11418,8,13,15,36
11102,11419,9,14,17,40
11102,11420,3,20,22,45
11102,11421,9,18,12,39
11102,11422,9,11,17,37
11102,11423,3,9,12,24
11102,11426,0,9,7,16
11102,11427,5,12,13,30
11102,11428,8,11,16,35
11102,11429,8,21,5,34
11102,11432,13,31,26,70
11102,11433,5,12,1,18
11102,11434,3,23,7,33
11102,11435,12,30,19,61
11102,11436,2,6,7,15
11102,11691,3,7,2,12
11102,11692,1,4,1,6
11102,11693,1,2,2,5
11102,11694,2,3,1,6
11102,11697,0,3,0,3
11103,10001,3,4,9,16
11103,10002,9,9,14,32
11103,10003,3,5,12,20
11103,10004,2,1,1,4
11103,10005,0,1,4,5
11103,10006,1,0,0,1
11103,10007,0,2,2,4
11103,10009,7,7,14,28
11103,10010,2,1,7,10
11103,10011,5,3,8,16
11103,10012,3,5,3,11
11103,10013,3,4,5,12
11103,10014,7,3,6,16
11103,10016,5,5,8,18
11103,10017,0,3,1,4
11103,10018,0,2,3,5
11103,10019,7,8,18,33
11103,10021,4,5,13,22
11103,10022,4,6,8,18
11103,10023,2,3,7,12
11103,10024,5,4,8,17
11103,10025,8,10,20,38
11103,10026,2,5,7,14
11103,10027,16,13,12,41
11103,10028,8,6,5,19
11103,10029,15,21,13,49
11103,10030,6,10,5,21
11103,10031,10,19,15,44
11103,10032,11,19,7,37
11103,10033,8,9,8,25
11103,10034,5,9,10,24
11103,10035,4,9,9,22
11103,10036,4,3,7,14
11103,10037,0,4,5,9
11103,10038,0,2,2,4
11103,10039,5,4,6,15
11103,10040,3,9,11,23
11103,10044,1,1,3,5
11103,10065,3,3,6,12
11103,10069,0,1,0,1
11103,10075,4,0,4,8
11103,10128,1,4,14,19
11103,10162,0,0,1,1
11103,10280,0,1,0,1
11103,10282,0,0,1,1
11103,10301,1,1,5,7
11103,10302,1,1,2,4
11103,10303,1,1,3,5
11103,10304,1,2,9,12
11103,10305,3,8,10,21
11103,10306,3,3,13,19
11103,10307,0,1,3,4
11103,10308,3,0,11,14
11103,10309,0,2,9,11
11103,10310,1,4,4,9
11103,10312,7,4,19,30
11103,10314,3,9,17,29
11103,10451,9,11,12,32
11103,10452,13,32,18,63
11103,10453,13,25,29,67
11103,10454,16,10,8,34
11103,10455,5,9,5,19
11103,10456,9,38,21,68
11103,10457,16,22,12,50
11103,10458,6,20,18,44
11103,10459,8,10,19,37
11103,10460,6,24,14,44
11103,10461,5,11,16,32
11103,10462,23,36,22,81
11103,10463,1,11,21,33
11103,10464,0,0,1,1
11103,10465,2,16,16,34
11103,10466,9,23,17,49
11103,10467,14,35,29,78
11103,10468,14,21,13,48
11103,10469,14,12,25,51
11103,10470,7,5,2,14
11103,10471,2,4,5,11
11103,10472,6,17,22,45
11103,10473,9,12,16,37
11103,10474,2,6,2,10
11103,10475,4,8,7,19
11103,11001,2,2,4,8
11103,11004,4,4,10,18
11103,11005,1,1,6,8
11103,11101,30,37,18,85
11103,11102,76,92,40,208
11103,11103,126,229,104,459
11103,11104,16,20,18,54
11103,11105,67,96,61,224
11103,11106,67,72,64,203
11103,11109,2,3,5,10
11103,11201,8,18,19,45
11103,11203,7,13,19,39
11103,11204,5,7,11,23
11103,11205,4,14,7,25
11103,11206,14,21,23,58
11103,11207,21,27,27,75
11103,11208,17,26,21,64
11103,11209,9,9,6,24
11103,11210,10,13,4,27
11103,11211,14,24,21,59
11103,11212,14,29,20,63
11103,11213,9,16,19,44
11103,11214,2,6,8,16
11103,11215,3,11,22,36
11103,11216,5,4,15,24
11103,11217,6,8,4,18
11103,11218,7,3,9,19
11103,11219,5,6,6,17
11103,11220,11,16,14,41
11103,11221,16,23,12,51
11103,11222,5,10,15,30
11103,11223,2,10,9,21
11103,11224,3,5,10,18
11103,11225,6,5,14,25
11103,11226,10,14,14,38
11103,11228,3,5,4,12
11103,11229,5,9,10,24
11103,11230,5,9,4,18
11103,11231,3,10,13,26
11103,11232,3,6,4,13
11103,11233,19,18,30,67
11103,11234,11,26,42,79
11103,11235,1,7,25,33
11103,11236,14,41,39,94
11103,11237,7,14,13,34
11103,11238,7,6,7,20
11103,11239,0,2,1,3
11103,11354,13,27,29,69
11103,11355,48,31,31,110
11103,11356,13,31,14,58
11103,11357,31,51,64,146
11103,11358,18,25,35,78
11103,11360,6,18,17,41
11103,11361,8,15,25,48
11103,11362,8,11,20,39
11103,11363,1,3,9,13
11103,11364,4,9,21,34
11103,11365,14,34,24,72
11103,11366,8,10,15,33
11103,11367,4,19,19,42
11103,11368,45,89,43,177
11103,11369,47,53,37,137
11103,11370,40,53,33,126
11103,11371,0,2,0,2
11103,11372,34,61,52,147
11103,11373,52,82,26,160
11103,11374,19,25,26,70
11103,11375,25,36,33,94
11103,11377,72,81,65,218
11103,11378,21,35,17,73
11103,11379,15,20,41,76
11103,11385,30,61,67,158
11103,11411,10,8,13,31
11103,11412,8,7,16,31
11103,11413,8,12,21,41
11103,11414,1,8,10,19
11103,11415,11,12,8,31
11103,11416,10,10,7,27
11103,11417,11,5,12,28
11103,11418,19,21,17,57
11103,11419,10,27,21,58
11103,11420,8,22,23,53
11103,11421,20,27,17,64
11103,11422,1,10,20,31
11103,11423,5,9,13,27
11103,11426,4,7,3,14
11103,11427,7,10,11,28
11103,11428,6,5,9,20
11103,11429,6,6,2,14
11103,11432,15,42,32,89
11103,11433,10,13,9,32
11103,11434,12,20,26,58
11103,11435,7,25,30,62
11103,11436,5,4,6,15
11103,11691,1,6,5,12
11103,11692,0,1,3,4
11103,11693,0,1,1,2
11103,11694,0,2,7,9
11103,11697,0,1,2,3
11104,10001,2,4,4,10
11104,10002,10,14,1,25
11104,10003,6,5,16,27
11104,10004,3,1,2,6
11104,10005,0,1,3,4
11104,10006,0,0,1,1
11104,10007,1,0,5,6
11104,10009,5,11,6,22
11104,10010,1,4,4,9
11104,10011,4,2,4,10
11104,10012,0,2,1,3
11104,10013,1,1,5,7
11104,10014,1,1,6,8
11104,10016,3,3,12,18
11104,10017,2,0,0,2
11104,10018,2,3,2,7
11104,10019,4,1,7,12
11104,10021,1,2,7,10
11104,10022,1,3,5,9
11104,10023,2,1,12,15
11104,10024,2,6,13,21
11104,10025,6,9,15,30
11104,10026,6,3,2,11
11104,10027,6,8,4,18
11104,10028,0,4,6,10
11104,10029,14,15,10,39
11104,10030,4,7,2,13
11104,10031,7,18,8,33
11104,10032,9,13,11,33
11104,10033,9,11,6,26
11104,10034,3,5,9,17
11104,10035,9,5,5,19
11104,10036,2,3,2,7
11104,10037,3,4,3,10
11104,10038,0,1,4,5
11104,10039,5,6,4,15
11104,10040,4,3,3,10
11104,10044,2,0,2,4
11104,10065,2,2,6,10
11104,10069,0,0,1,1
11104,10075,1,1,6,8
11104,10128,6,5,7,18
11104,10162,0,0,1,1
11104,10280,2,0,3,5
11104,10282,0,0,1,1
11104,10301,2,5,2,9
11104,10302,1,0,0,1
11104,10303,3,1,4,8
11104,10304,3,3,3,9
11104,10305,2,0,4,6
11104,10306,2,2,7,11
11104,10307,0,1,2,3
11104,10308,1,1,3,5
11104,10309,2,1,5,8
11104,10310,0,1,3,4
11104,10312,2,4,4,10
11104,10314,3,4,6,13
11104,10451,16,8,2,26
11104,10452,17,15,14,46
11104,10453,15,15,6,36
11104,10454,9,7,1,17
11104,10455,12,12,6,30
11104,10456,24,29,13,66
11104,10457,15,18,3,36
11104,10458,8,17,5,30
11104,10459,7,10,2,19
11104,10460,9,16,6,31
11104,10461,4,5,5,14
11104,10462,8,14,18,40
11104,10463,4,8,8,20
11104,10465,2,3,6,11
11104,10466,4,10,5,19
11104,10467,10,14,9,33
11104,10468,8,10,4,22
11104,10469,4,9,6,19
11104,10470,0,4,1,5
11104,10471,1,2,3,6
11104,10472,9,16,9,34
11104,10473,7,12,10,29
11104,10474,3,3,0,6
11104,10475,5,5,3,13
11104,11001,0,2,0,2
11104,11004,0,2,6,8
11104,11005,0,0,1,1
11104,11040,0,0,2,2
11104,11101,25,30,11,66
11104,11102,18,16,7,41
11104,11103,16,16,8,40
11104,11104,93,112,58,263
11104,11105,16,13,14,43
11104,11106,10,23,16,49
11104,11109,3,4,5,12
11104,11201,3,11,15,29
11104,11203,12,21,12,45
11104,11204,7,3,2,12
11104,11205,7,7,9,23
11104,11206,21,27,7,55
11104,11207,17,26,15,58
11104,11208,22,36,16,74
11104,11209,5,6,11,22
11104,11210,9,7,8,24
11104,11211,13,16,17,46
11104,11212,11,28,5,44
11104,11213,10,28,10,48
11104,11214,1,5,5,11
11104,11215,6,5,15,26
11104,11216,12,11,14,37
11104,11217,2,5,2,9
11104,11218,8,8,7,23
11104,11219,4,4,6,14
11104,11220,6,11,11,28
11104,11221,12,22,12,46
11104,11222,5,5,24,34
11104,11223,1,5,4,10
11104,11224,3,5,1,9
11104,11225,12,10,11,33
11104,11226,21,28,10,59
11104,11228,0,2,5,7
11104,11229,3,6,10,19
11104,11230,6,9,6,21
11104,11231,1,6,5,12
11104,11232,4,2,1,7
11104,11233,14,24,14,52
11104,11234,12,13,18,43
11104,11235,3,7,8,18
11104,11236,14,28,7,49
11104,11237,10,12,9,31
11104,11238,9,9,12,30
11104,11239,0,1,2,3
11104,11354,19,9,12,40
11104,11355,23,15,13,51
11104,11356,14,10,10,34
11104,11357,6,5,7,18
11104,11358,8,8,12,28
11104,11359,2,0,0,2
11104,11360,2,5,11,18
11104,11361,7,6,5,18
11104,11362,1,1,5,7
11104,11363,1,0,1,2
11104,11364,0,12,3,15
11104,11365,4,14,18,36
11104,11366,2,3,1,6
11104,11367,8,10,13,31
11104,11368,55,91,9,155
11104,11369,33,45,4,82
11104,11370,4,13,7,24
11104,11372,42,60,13,115
11104,11373,60,80,27,167
11104,11374,19,18,17,54
11104,11375,8,30,19,57
11104,11377,90,148,60,298
11104,11378,19,23,16,58
11104,11379,14,10,12,36
11104,11385,26,28,17,71
11104,11411,6,10,6,22
11104,11412,4,11,9,24
11104,11413,9,17,10,36
11104,11414,4,4,10,18
11104,11415,5,8,7,20
11104,11416,11,4,1,16
11104,11417,7,11,5,23
11104,11418,15,20,15,50
11104,11419,12,29,10,51
11104,11420,14,12,8,34
11104,11421,12,26,10,48
11104,11422,7,8,3,18
11104,11423,11,9,6,26
11104,11426,2,1,2,5
11104,11427,4,6,3,13
11104,11428,5,2,5,12
11104,11429,7,8,5,20
11104,11430,0,2,1,3
11104,11432,13,24,23,60
11104,11433,11,16,4,31
11104,11434,28,14,13,55
11104,11435,18,21,15,54
11104,11436,4,7,3,14
11104,11691,8,12,5,25
11104,11692,5,4,1,10
11104,11693,1,5,1,7
11104,11694,1,2,6,9
11104,11697,0,0,2,2
11105,10001,1,2,2,5
11105,10002,10,10,19,39
11105,10003,4,3,16,23
11105,10004,1,0,3,4
11105,10005,1,2,0,3
11105,10007,1,0,0,1
11105,10009,9,14,14,37
11105,10010,0,4,5,9
11105,10011,3,6,11,20
11105,10012,0,6,6,12
11105,10013,4,4,4,12
11105,10014,6,4,7,17
11105,10016,3,5,11,19
11105,10017,1,2,7,10
11105,10018,1,1,3,5
11105,10019,4,9,13,26
11105,10021,1,5,10,16
11105,10022,5,8,5,18
11105,10023,4,1,8,13
11105,10024,6,3,15,24
11105,10025,8,22,18,48
11105,10026,8,16,9,33
11105,10027,9,13,22,44
11105,10028,0,5,8,13
11105,10029,8,12,19,39
11105,10030,2,11,4,17
11105,10031,5,11,9,25
11105,10032,9,5,8,22
11105,10033,5,7,11,23
11105,10034,5,7,4,16
11105,10035,8,17,8,33
11105,10036,2,2,7,11
11105,10037,4,5,9,18
11105,10038,5,4,6,15
11105,10039,4,4,8,16
11105,10040,5,10,6,21
11105,10044,1,0,4,5
11105,10065,1,3,11,15
11105,10069,0,2,1,3
11105,10075,1,1,7,9
11105,10119,0,1,0,1
11105,10128,6,6,14,26
11105,10173,0,0,1,1
11105,10280,1,2,1,4
11105,10282,0,0,1,1
11105,10301,1,1,4,6
11105,10302,0,0,4,4
11105,10303,1,1,2,4
11105,10304,2,3,3,8
11105,10305,2,3,10,15
11105,10306,5,3,14,22
11105,10307,1,0,5,6
11105,10308,3,4,5,12
11105,10309,1,3,5,9
11105,10310,2,0,1,3
11105,10312,1,6,10,17
11105,10314,2,4,23,29
11105,10451,1,12,4,17
11105,10452,11,35,24,70
11105,10453,5,23,19,47
11105,10454,5,14,14,33
11105,10455,8,11,6,25
11105,10456,11,23,18,52
11105,10457,17,25,24,66
11105,10458,10,30,15,55
11105,10459,6,10,11,27
11105,10460,3,20,18,41
11105,10461,12,17,18,47
11105,10462,9,18,32,59
11105,10463,15,10,16,41
11105,10464,1,1,2,4
11105,10465,8,15,25,48
11105,10466,5,17,16,38
11105,10467,16,31,26,73
11105,10468,5,23,13,41
11105,10469,8,27,26,61
11105,10470,1,3,9,13
11105,10471,0,4,2,6
11105,10472,9,16,19,44
11105,10473,4,18,13,35
11105,10474,1,2,6,9
11105,10475,2,6,5,13
11105,11001,3,2,6,11
11105,11004,1,10,3,14
11105,11005,2,0,0,2
11105,11101,22,37,34,93
11105,11102,50,86,59,195
11105,11103,50,80,83,213
11105,11104,6,12,25,43
11105,11105,250,336,252,838
11105,11106,22,75,48,145
11105,11109,1,0,2,3
11105,11201,9,5,17,31
11105,11203,4,19,11,34
11105,11204,3,5,5,13
11105,11205,9,9,8,26
11105,11206,16,17,35,68
11105,11207,12,38,34,84
11105,11208,24,56,38,118
11105,11209,6,12,15,33
11105,11210,3,12,11,26
11105,11211,18,25,42,85
11105,11212,13,22,14,49
11105,11213,9,18,19,46
11105,11214,3,10,10,23
11105,11215,7,10,14,31
11105,11216,8,16,15,39
11105,11217,5,5,8,18
11105,11218,4,13,5,22
11105,11219,8,10,10,28
11105,11220,12,14,7,33
11105,11221,15,23,31,69
11105,11222,12,11,29,52
11105,11223,7,9,7,23
11105,11224,1,3,6,10
11105,11225,2,11,7,20
11105,11226,10,21,17,48
11105,11228,4,3,9,16
11105,11229,4,1,17,22
11105,11230,3,15,10,28
11105,11231,6,6,16,28
11105,11232,3,2,3,8
11105,11233,7,28,24,59
11105,11234,23,23,25,71
11105,11235,4,5,11,20
11105,11236,8,39,26,73
11105,11237,6,19,23,48
11105,11238,7,8,18,33
11105,11239,2,6,2,10
11105,11354,20,37,38,95
11105,11355,32,45,33,110
11105,11356,13,15,24,52
11105,11357,23,45,76,144
11105,11358,16,40,43,99
11105,11359,1,0,0,1
11105,11360,9,11,8,28
11105,11361,9,16,28,53
11105,11362,9,12,16,37
11105,11363,2,5,1,8
11105,11364,12,24,21,57
11105,11365,8,17,29,54
11105,11366,4,3,6,13
11105,11367,16,12,15,43
11105,11368,45,106,58,209
11105,11369,20,50,57,127
11105,11370,52,85,66,203
11105,11371,0,0,1,1
11105,11372,12,68,41,121
11105,11373,42,81,55,178
11105,11374,12,23,26,61
11105,11375,12,25,41,78
11105,11377,44,78,59,181
11105,11378,20,41,27,88
11105,11379,12,28,41,81
11105,11385,30,53,77,160
11105,11411,3,11,12,26
11105,11412,6,24,14,44
11105,11413,8,17,20,45
11105,11414,8,3,18,29
11105,11415,3,11,9,23
11105,11416,9,16,18,43
11105,11417,9,20,13,42
11105,11418,12,18,30,60
11105,11419,8,31,34,73
11105,11420,6,19,24,49
11105,11421,13,26,22,61
11105,11422,6,9,10,25
11105,11423,6,17,15,38
11105,11426,1,9,13,23
11105,11427,2,5,10,17
11105,11428,14,12,9,35
11105,11429,8,17,12,37
11105,11430,0,0,1,1
11105,11432,8,35,16,59
11105,11433,6,16,13,35
11105,11434,9,21,14,44
11105,11435,8,35,27,70
11105,11436,4,9,11,24
11105,11451,0,1,0,1
11105,11691,5,17,7,29
11105,11692,1,6,5,12
11105,11693,1,4,2,7
11105,11694,2,4,3,9
11105,11697,1,0,1,2
11106,10001,5,9,9,23
11106,10002,18,22,23,63
11106,10003,5,5,12,22
11106,10004,0,4,4,8
11106,10005,0,2,3,5
11106,10006,2,0,1,3
11106,10007,0,0,3,3
11106,10009,18,10,18,46
11106,10010,7,5,13,25
11106,10011,6,3,25,34
11106,10012,1,4,8,13
11106,10013,5,8,15,28
11106,10014,4,5,7,16
11106,10016,5,9,18,32
11106,10017,6,1,5,12
11106,10018,1,10,3,14
11106,10019,4,10,17,31
11106,10021,9,5,14,28
11106,10022,9,9,14,32
11106,10023,10,9,17,36
11106,10024,7,12,21,40
11106,10025,16,33,35,84
11106,10026,9,11,30,50
11106,10027,12,16,27,55
11106,10028,4,6,8,18
11106,10029,31,38,20,89
11106,10030,5,9,10,24
11106,10031,19,19,28,66
11106,10032,8,18,19,45
11106,10033,4,14,12,30
11106,10034,8,16,23,47
11106,10035,12,27,19,58
11106,10036,3,3,4,10
11106,10037,2,13,4,19
11106,10038,5,3,5,13
11106,10039,8,11,11,30
11106,10040,7,15,13,35
11106,10044,1,5,8,14
11106,10065,0,4,10,14
11106,10069,0,3,0,3
11106,10075,2,5,11,18
11106,10128,8,22,21,51
11106,10280,0,0,2,2
11106,10282,0,0,1,1
11106,10301,5,6,10,21
11106,10302,2,0,7,9
11106,10303,2,7,7,16
11106,10304,2,8,5,15
11106,10305,4,6,11,21
11106,10306,2,13,19,34
11106,10307,1,1,2,4
11106,10308,0,2,6,8
11106,10309,2,9,12,23
11106,10310,1,3,2,6
11106,10312,3,11,15,29
11106,10314,6,14,25,45
11106,10451,12,27,16,55
11106,10452,21,49,34,104
11106,10453,11,54,34,99
11106,10454,15,15,13,43
11106,10455,11,21,23,55
11106,10456,22,52,34,108
11106,10457,19,39,26,84
11106,10458,15,36,27,78
11106,10459,6,35,29,70
11106,10460,16,23,15,54
11106,10461,10,19,23,52
11106,10462,11,26,26,63
11106,10463,8,9,23,40
11106,10464,0,0,3,3
11106,10465,5,14,32,51
11106,10466,11,15,17,43
11106,10467,8,26,22,56
11106,10468,10,23,19,52
11106,10469,7,17,26,50
11106,10470,1,4,4,9
11106,10471,2,6,7,15
11106,10472,20,38,21,79
11106,10473,9,28,22,59
11106,10474,3,13,9,25
11106,10475,5,17,15,37
11106,11001,1,2,2,5
11106,11004,1,12,11,24
11106,11005,1,2,1,4
11106,11040,0,0,2,2
11106,11101,24,71,48,143
11106,11102,70,111,65,246
11106,11103,67,110,75,252
11106,11104,8,28,29,65
11106,11105,49,91,54,194
11106,11106,164,237,156,557
11106,11109,1,6,8,15
11106,11201,10,9,31,50
11106,11203,45,54,29,128
11106,11204,6,19,17,42
11106,11205,4,12,22,38
11106,11206,23,29,37,89
11106,11207,23,71,45,139
11106,11208,24,64,42,130
11106,11209,8,7,18,33
11106,11210,26,28,20,74
11106,11211,11,22,45,78
11106,11212,25,64,36,125
11106,11213,20,34,22,76
11106,11214,9,27,22,58
11106,11215,13,15,45,73
11106,11216,17,18,31,66
11106,11217,7,9,16,32
11106,11218,11,17,12,40
11106,11219,9,11,23,43
11106,11220,14,18,20,52
11106,11221,10,33,43,86
11106,11222,10,21,34,65
11106,11223,15,40,32,87
11106,11224,9,25,9,43
11106,11225,15,28,23,66
11106,11226,53,77,39,169
11106,11228,11,10,12,33
11106,11229,6,29,16,51
11106,11230,20,27,21,68
11106,11231,5,13,18,36
11106,11232,4,8,9,21
11106,11233,20,31,38,89
11106,11234,31,55,42,128
11106,11235,17,34,12,63
11106,11236,36,69,56,161
11106,11237,12,19,14,45
11106,11238,15,21,28,64
11106,11239,1,11,5,17
11106,11354,38,31,23,92
11106,11355,44,39,32,115
11106,11356,12,20,18,50
11106,11357,16,39,48,103
11106,11358,14,21,32,67
11106,11359,0,0,1,1
11106,11360,3,8,12,23
11106,11361,12,12,19,43
11106,11362,6,9,19,34
11106,11363,4,5,5,14
11106,11364,4,14,28,46
11106,11365,17,22,26,65
11106,11366,3,13,8,24
11106,11367,16,40,28,84
11106,11368,45,118,53,216
11106,11369,35,42,36,113
11106,11370,19,45,39,103
11106,11371,0,1,0,1
11106,11372,48,78,40,166
11106,11373,79,109,58,246
11106,11374,26,82,34,142
11106,11375,34,67,51,152
11106,11377,56,120,65,241
11106,11378,17,38,48,103
11106,11379,11,40,38,89
11106,11385,41,63,85,189
11106,11411,9,16,16,41
11106,11412,11,12,18,41
11106,11413,15,19,32,66
11106,11414,6,1,20,27
11106,11415,3,15,18,36
11106,11416,14,18,13,45
11106,11417,12,14,22,48
11106,11418,14,28,18,60
11106,11419,14,35,29,78
11106,11420,10,24,24,58
11106,11421,13,28,33,74
11106,11422,6,28,20,54
11106,11423,9,28,12,49
11106,11426,2,8,11,21
11106,11427,6,13,8,27
11106,11428,9,9,11,29
11106,11429,5,23,8,36
11106,11430,0,1,0,1
11106,11432,11,25,32,68
11106,11433,5,15,11,31
11106,11434,11,23,14,48
11106,11435,10,40,21,71
11106,11436,5,19,7,31
11106,11691,10,23,17,50
11106,11692,1,2,9,12
11106,11693,1,4,3,8
11106,11694,6,6,9,21
11106,11697,0,1,1,2
11109,10001,2,0,1,3
11109,10002,2,2,1,5
11109,10003,0,1,1,2
11109,10009,2,1,4,7
11109,10010,0,0,1,1
11109,10011,0,0,1,1
11109,10012,0,1,2,3
11109,10013,0,0,1,1
11109,10014,3,0,0,3
11109,10016,0,1,0,1
11109,10017,0,0,2,2
11109,10021,0,0,4,4
11109,10022,0,2,0,2
11109,10023,1,2,2,5
11109,10024,0,0,1,1
11109,10025,1,1,2,4
11109,10026,0,3,1,4
11109,10027,2,0,2,4
11109,10028,1,0,1,2
11109,10029,1,0,4,5
11109,10031,2,1,4,7
11109,10032,0,2,1,3
11109,10033,0,1,2,3
11109,10034,2,0,0,2
11109,10035,0,0,1,1
11109,10036,0,3,1,4
11109,10037,0,2,1,3
11109,10038,2,0,1,3
11109,10039,0,0,2,2
11109,10040,0,0,1,1
11109,10128,0,1,1,2
11109,10302,0,1,1,2
11109,10304,0,1,0,1
11109,10306,0,1,0,1
11109,10308,0,0,1,1
11109,10309,0,0,1,1
11109,10310,0,0,1,1
11109,10312,0,2,1,3
11109,10314,0,0,2,2
11109,10451,1,1,3,5
11109,10452,1,1,2,4
11109,10453,1,5,1,7
11109,10454,0,3,2,5
11109,10455,3,2,1,6
11109,10456,3,4,4,11
11109,10457,1,7,0,8
11109,10458,0,4,2,6
11109,10459,0,2,0,2
11109,10460,0,4,1,5
11109,10461,0,1,2,3
11109,10462,4,2,4,10
11109,10463,0,2,1,3
11109,10464,0,0,1,1
11109,10465,0,0,2,2
11109,10466,1,2,0,3
11109,10467,1,0,5,6
11109,10468,0,5,2,7
11109,10469,0,4,1,5
11109,10470,1,1,1,3
11109,10472,1,1,3,5
11109,10473,1,0,0,1
11109,10474,1,0,0,1
11109,10475,0,1,1,2
11109,11040,1,0,0,1
11109,11101,8,9,5,22
11109,11102,2,1,3,6
11109,11103,1,6,3,10
11109,11104,2,4,2,8
11109,11105,0,3,2,5
11109,11106,2,2,3,7
11109,11109,2,1,3,6
11109,11201,0,0,6,6
11109,11203,0,1,1,2
11109,11204,0,3,3,6
11109,11205,0,1,0,1
11109,11206,4,6,2,12
11109,11207,4,4,3,11
11109,11208,1,7,1,9
11109,11209,0,0,3,3
11109,11210,0,0,3,3
11109,11211,0,4,3,7
11109,11212,1,2,7,10
11109,11213,0,4,1,5
11109,11214,1,0,2,3
11109,11215,1,0,0,1
11109,11216,0,1,4,5
11109,11217,0,1,1,2
11109,11218,1,0,0,1
11109,11219,1,1,1,3
11109,11220,2,3,0,5
11109,11221,4,3,8,15
11109,11222,0,0,6,6
11109,11223,1,0,4,5
11109,11224,0,1,0,1
11109,11225,0,1,2,3
11109,11226,1,3,4,8
11109,11228,1,0,2,3
11109,11229,0,0,2,2
11109,11230,1,0,1,2
11109,11231,0,1,5,6
11109,11232,0,1,0,1
11109,11233,2,7,3,12
11109,11234,3,2,9,14
11109,11235,1,1,1,3
11109,11236,0,3,2,5
11109,11237,0,3,2,5
11109,11238,3,0,6,9
11109,11239,0,2,1,3
11109,11354,0,2,3,5
11109,11355,4,2,6,12
11109,11356,2,2,1,5
11109,11357,0,1,3,4
11109,11358,2,3,4,9
11109,11359,0,1,0,1
11109,11360,1,0,0,1
11109,11361,2,1,0,3
11109,11362,1,1,1,3
11109,11364,0,2,2,4
11109,11365,0,3,2,5
11109,11367,1,2,3,6
11109,11368,3,11,2,16
11109,11369,6,4,1,11
11109,11370,2,1,4,7
11109,11372,2,5,10,17
11109,11373,2,12,0,14
11109,11374,1,0,0,1
11109,11375,0,4,2,6
11109,11377,4,9,7,20
11109,11378,2,3,2,7
11109,11379,3,4,5,12
11109,11385,6,8,11,25
11109,11411,0,3,1,4
11109,11412,3,0,2,5
11109,11413,1,3,2,6
11109,11414,0,1,2,3
11109,11415,0,0,1,1
11109,11416,1,0,2,3
11109,11417,1,1,3,5
11109,11418,1,1,3,5
11109,11419,0,4,3,7
11109,11420,1,1,4,6
11109,11421,2,2,4,8
11109,11422,2,1,0,3
11109,11423,1,2,0,3
11109,11426,0,0,2,2
11109,11428,0,0,1,1
11109,11429,0,0,2,2
11109,11432,0,3,0,3
11109,11433,2,3,3,8
11109,11434,2,6,2,10
11109,11435,2,0,1,3
11109,11436,1,1,3,5
11109,11691,0,0,1,1
11201,10001,28,28,128,184
11201,10002,121,145,406,672
11201,10003,67,50,281,398
11201,10004,3,13,39,55
11201,10005,8,6,40,54
11201,10006,1,2,20,23
11201,10007,7,6,27,40
11201,10009,80,105,360,545
11201,10010,31,31,146,208
11201,10011,49,49,271,369
11201,10012,30,22,165,217
11201,10013,36,32,124,192
11201,10014,27,23,151,201
11201,10016,29,50,205,284
11201,10017,16,18,68,102
11201,10018,8,12,40,60
11201,10019,36,51,193,280
11201,10021,34,24,132,190
11201,10022,24,25,128,177
11201,10023,58,50,212,320
11201,10024,50,39,207,296
11201,10025,108,73,374,555
11201,10026,28,69,259,356
11201,10027,63,98,325,486
11201,10028,31,32,155,218
11201,10029,100,125,370,595
11201,10030,34,38,191,263
11201,10031,61,74,245,380
11201,10032,63,90,178,331
11201,10033,57,78,178,313
11201,10034,38,48,119,205
11201,10035,54,61,192,307
11201,10036,31,33,105,169
11201,10037,23,29,124,176
11201,10038,26,27,118,171
11201,10039,31,42,159,232
11201,10040,43,64,126,233
11201,10044,10,14,43,67
11201,10065,16,22,93,131
11201,10069,2,4,24,30
11201,10075,20,16,91,127
11201,10119,0,0,1,1
11201,10128,33,46,263,342
11201,10162,0,0,4,4
11201,10173,0,0,1,1
11201,10280,5,10,62,77
11201,10282,3,1,14,18
11201,10301,68,84,405,557
11201,10302,32,35,227,294
11201,10303,55,66,371,492
11201,10304,70,123,380,573
11201,10305,49,79,455,583
11201,10306,66,62,632,760
11201,10307,18,16,144,178
11201,10308,16,20,288,324
11201,10309,33,36,314,383
11201,10310,44,59,243,346
11201,10312,33,56,611,700
11201,10314,117,143,971,1231
11201,10451,55,91,182,328
11201,10452,112,117,292,521
11201,10453,107,162,275,544
11201,10454,45,62,105,212
11201,10455,51,63,123,237
11201,10456,81,118,356,555
11201,10457,91,126,230,447
11201,10458,105,143,322,570
11201,10459,55,78,154,287
11201,10460,64,62,237,363
11201,10461,37,40,303,380
11201,10462,68,91,451,610
11201,10463,70,80,283,433
11201,10464,2,5,30,37
11201,10465,28,26,270,324
11201,10466,63,73,420,556
11201,10467,86,115,489,690
11201,10468,89,113,295,497
11201,10469,64,65,418,547
11201,10470,13,18,94,125
11201,10471,16,36,93,145
11201,10472,63,84,452,599
11201,10473,60,73,439,572
11201,10474,13,19,49,81
11201,10475,37,49,489,575
11201,11001,4,9,42,55
11201,11003,0,0,1,1
11201,11004,10,18,137,165
11201,11005,0,0,14,14
11201,11040,0,5,23,28
11201,11101,41,80,186,307
11201,11102,48,60,143,251
11201,11103,69,60,174,303
11201,11104,47,43,152,242
11201,11105,63,68,241,372
11201,11106,66,100,225,391
11201,11109,2,4,46,52
11201,11201,325,368,1180,1873
11201,11203,218,369,1200,1787
11201,11204,123,154,471,748
11201,11205,139,157,451,747
11201,11206,182,280,610,1072
11201,11207,210,388,1157,1755
11201,11208,225,350,1004,1579
11201,11209,177,251,781,1209
11201,11210,123,237,753,1113
11201,11211,152,166,515,833
11201,11212,237,432,962,1631
11201,11213,173,294,726,1193
11201,11214,147,191,819,1157
11201,11215,164,173,841,1178
11201,11216,197,263,800,1260
11201,11217,143,132,576,851
11201,11218,142,212,644,998
11201,11219,120,129,233,482
11201,11220,219,301,427,947
11201,11221,201,308,839,1348
11201,11222,76,65,361,502
11201,11223,108,187,678,973
11201,11224,120,132,527,779
11201,11225,188,301,774,1263
11201,11226,323,471,1207,2001
11201,11228,81,90,371,542
11201,11229,153,158,910,1221
11201,11230,141,173,659,973
11201,11231,124,164,455,743
11201,11232,68,98,195,361
11201,11233,237,288,1002,1527
11201,11234,199,293,1254,1746
11201,11235,101,148,948,1197
11201,11236,198,328,1350,1876
11201,11237,82,123,307,512
11201,11238,147,209,864,1220
11201,11239,37,52,196,285
11201,11354,27,34,215,276
11201,11355,48,47,280,375
11201,11356,15,19,91,125
11201,11357,20,26,157,203
11201,11358,17,27,147,191
11201,11360,12,10,81,103
11201,11361,11,19,132,162
11201,11362,7,16,89,112
11201,11363,3,6,41,50
11201,11364,18,16,151,185
11201,11365,34,35,224,293
11201,11366,13,8,66,87
11201,11367,31,49,229,309
11201,11368,116,165,389,670
11201,11369,69,73,241,383
11201,11370,36,46,160,242
11201,11371,0,2,1,3
11201,11372,72,113,315,500
11201,11373,105,165,323,593
11201,11374,56,59,322,437
11201,11375,53,73,448,574
11201,11377,130,151,402,683
11201,11378,60,59,264,383
11201,11379,45,54,326,425
11201,11385,168,224,844,1236
11201,11411,16,34,250,300
11201,11412,31,59,432,522
11201,11413,49,58,520,627
11201,11414,25,45,236,306
11201,11415,35,32,128,195
11201,11416,44,81,196,321
11201,11417,48,70,325,443
11201,11418,47,80,311,438
11201,11419,53,105,358,516
11201,11420,63,85,546,694
11201,11421,72,92,365,529
11201,11422,25,50,414,489
11201,11423,31,55,300,386
11201,11426,18,25,184,227
11201,11427,21,29,240,290
11201,11428,11,31,239,281
11201,11429,21,32,310,363
11201,11430,2,1,4,7
11201,11432,50,64,468,582
11201,11433,35,47,360,442
11201,11434,71,106,796,973
11201,11435,53,69,444,566
11201,11436,15,32,221,268
11201,11691,64,103,351,518
11201,11692,41,48,171,260
11201,11693,25,27,144,196
11201,11694,19,23,180,222
11201,11697,4,4,35,43
11203,10001,1,3,14,18
11203,10002,16,12,47,75
11203,10003,10,9,23,42
11203,10004,5,5,7,17
11203,10005,1,2,8,11
11203,10006,0,0,4,4
11203,10007,1,0,3,4
11203,10009,11,8,40,59
11203,10010,1,2,17,20
11203,10011,2,0,19,21
11203,10012,1,8,17,26
11203,10013,3,5,27,35
11203,10014,5,5,17,27
11203,10016,3,2,32,37
11203,10017,1,0,12,13
11203,10018,0,1,4,5
11203,10019,2,7,14,23
11203,10021,3,0,16,19
11203,10022,0,3,18,21
11203,10023,5,4,29,38
11203,10024,0,0,25,25
11203,10025,7,9,49,65
11203,10026,2,9,26,37
11203,10027,7,12,35,54
11203,10028,3,2,24,29
11203,10029,9,17,59,85
11203,10030,3,9,19,31
11203,10031,6,5,33,44
11203,10032,6,7,12,25
11203,10033,4,10,19,33
11203,10034,2,3,14,19
11203,10035,4,7,23,34
11203,10036,0,5,11,16
11203,10037,4,9,13,26
11203,10038,7,5,28,40
11203,10039,5,4,19,28
11203,10040,5,4,14,23
11203,10044,1,1,7,9
11203,10065,3,0,13,16
11203,10069,0,0,2,2
11203,10075,2,0,9,11
11203,10128,4,3,22,29
11203,10280,1,0,8,9
11203,10282,0,1,3,4
11203,10301,4,10,60,74
11203,10302,3,10,37,50
11203,10303,7,11,27,45
11203,10304,8,14,70,92
11203,10305,10,10,66,86
11203,10306,9,13,77,99
11203,10307,3,1,16,20
11203,10308,4,8,38,50
11203,10309,5,9,48,62
11203,10310,6,6,27,39
11203,10312,9,16,77,102
11203,10314,22,13,116,151
11203,10451,6,11,27,44
11203,10452,7,20,35,62
11203,10453,15,11,30,56
11203,10454,5,9,13,27
11203,10455,8,14,22,44
11203,10456,6,17,46,69
11203,10457,7,17,35,59
11203,10458,14,14,34,62
11203,10459,8,9,26,43
11203,10460,5,5,34,44
11203,10461,5,12,45,62
11203,10462,3,12,57,72
11203,10463,5,8,36,49
11203,10464,1,1,3,5
11203,10465,8,7,49,64
11203,10466,14,14,48,76
11203,10467,12,17,68,97
11203,10468,9,8,36,53
11203,10469,10,15,74,99
11203,10470,1,1,9,11
11203,10471,3,2,18,23
11203,10472,6,14,39,59
11203,10473,13,14,38,65
11203,10474,6,3,3,12
11203,10475,3,6,66,75
11203,11001,2,0,3,5
11203,11004,3,2,21,26
11203,11005,0,1,5,6
11203,11040,1,1,1,3
11203,11101,2,10,19,31
11203,11102,0,6,23,29
11203,11103,2,6,21,29
11203,11104,6,2,16,24
11203,11105,2,1,18,21
11203,11106,0,6,20,26
11203,11109,0,0,3,3
11203,11201,18,25,109,152
11203,11203,213,475,551,1239
11203,11204,28,52,94,174
11203,11205,18,17,62,97
11203,11206,36,64,112,212
11203,11207,45,126,199,370
11203,11208,52,140,224,416
11203,11209,33,47,141,221
11203,11210,63,143,280,486
11203,11211,25,35,87,147
11203,11212,92,255,268,615
11203,11213,83,152,194,429
11203,11214,57,51,110,218
11203,11215,25,30,116,171
11203,11216,31,51,121,203
11203,11217,11,21,87,119
11203,11218,42,66,163,271
11203,11219,65,40,73,178
11203,11220,55,51,101,207
11203,11221,44,76,136,256
11203,11222,13,13,43,69
11203,11223,38,58,139,235
11203,11224,16,23,72,111
11203,11225,89,137,225,451
11203,11226,154,255,369,778
11203,11228,27,24,72,123
11203,11229,47,55,194,296
11203,11230,45,71,184,300
11203,11231,7,15,63,85
11203,11232,10,19,32,61
11203,11233,57,98,209,364
11203,11234,98,165,472,735
11203,11235,25,54,160,239
11203,11236,133,277,474,884
11203,11237,11,26,36,73
11203,11238,22,44,137,203
11203,11239,5,22,46,73
11203,11354,2,4,27,33
11203,11355,15,12,39,66
11203,11356,2,3,10,15
11203,11357,2,3,20,25
11203,11358,6,10,17,33
11203,11360,6,2,9,17
11203,11361,3,2,9,14
11203,11362,4,3,11,18
11203,11363,1,0,5,6
11203,11364,3,5,31,39
11203,11365,6,8,46,60
11203,11366,3,6,10,19
11203,11367,3,10,35,48
11203,11368,16,17,63,96
11203,11369,3,5,25,33
11203,11370,8,5,23,36
11203,11372,6,5,30,41
11203,11373,12,12,60,84
11203,11374,6,8,45,59
11203,11375,9,20,98,127
11203,11377,11,16,55,82
11203,11378,12,16,65,93
11203,11379,12,23,73,108
11203,11385,41,53,142,236
11203,11411,6,13,40,59
11203,11412,4,20,73,97
11203,11413,13,19,106,138
11203,11414,7,11,20,38
11203,11415,2,4,18,24
11203,11416,8,10,19,37
11203,11417,8,9,33,50
11203,11418,6,12,31,49
11203,11419,5,18,57,80
11203,11420,14,34,70,118
11203,11421,6,15,24,45
11203,11422,16,18,75,109
11203,11423,3,11,47,61
11203,11426,3,4,35,42
11203,11427,8,8,39,55
11203,11428,9,7,29,45
11203,11429,9,13,52,74
11203,11432,13,10,81,104
11203,11433,4,23,55,82
11203,11434,14,27,108,149
11203,11435,9,20,68,97
11203,11436,6,15,26,47
11203,11691,18,34,64,116
11203,11692,15,17,42,74
11203,11693,5,9,29,43
11203,11694,12,13,57,82
11203,11697,0,4,23,27
11204,10001,0,1,1,2
11204,10002,20,18,6,44
11204,10003,6,2,11,19
11204,10004,1,0,0,1
11204,10006,1,0,0,1
11204,10007,4,1,0,5
11204,10009,9,8,6,23
11204,10010,0,0,4,4
11204,10011,2,1,6,9
11204,10012,4,0,3,7
11204,10013,6,3,5,14
11204,10014,5,4,5,14
11204,10016,2,5,5,12
11204,10017,0,1,2,3
11204,10018,1,0,2,3
11204,10019,3,5,6,14
11204,10021,1,1,4,6
11204,10022,2,2,10,14
11204,10023,1,3,11,15
11204,10024,2,5,6,13
11204,10025,6,4,8,18
11204,10026,6,8,6,20
11204,10027,10,9,5,24
11204,10028,1,1,2,4
11204,10029,10,16,9,35
11204,10030,5,7,5,17
11204,10031,10,16,5,31
11204,10032,9,17,2,28
11204,10033,8,14,5,27
11204,10034,3,13,4,20
11204,10035,6,4,2,12
11204,10036,1,3,5,9
11204,10037,3,2,2,7
11204,10038,3,1,1,5
11204,10039,3,5,2,10
11204,10040,7,18,2,27
11204,10044,0,0,2,2
11204,10065,1,0,3,4
11204,10069,0,1,0,1
11204,10075,0,2,1,3
11204,10128,2,2,5,9
11204,10162,0,0,2,2
11204,10280,2,0,0,2
11204,10282,1,0,1,2
11204,10301,19,19,19,57
11204,10302,4,6,9,19
11204,10303,11,17,13,41
11204,10304,15,22,18,55
11204,10305,22,34,20,76
11204,10306,39,40,48,127
11204,10307,4,11,6,21
11204,10308,14,13,22,49
11204,10309,17,21,34,72
11204,10310,10,11,12,33
11204,10312,29,29,56,114
11204,10314,61,49,55,165
11204,10451,21,16,6,43
11204,10452,24,34,11,69
11204,10453,25,36,8,69
11204,10454,5,13,1,19
11204,10455,6,14,3,23
11204,10456,34,29,4,67
11204,10457,17,27,2,46
11204,10458,21,38,6,65
11204,10459,8,9,1,18
11204,10460,14,15,12,41
11204,10461,4,5,8,17
11204,10462,10,13,7,30
11204,10463,16,11,8,35
11204,10464,0,1,1,2
11204,10465,2,5,7,14
11204,10466,2,12,6,20
11204,10467,16,30,16,62
11204,10468,16,21,6,43
11204,10469,6,6,5,17
11204,10470,1,6,2,9
11204,10471,3,6,7,16
11204,10472,7,13,11,31
11204,10473,8,21,5,34
11204,10474,1,7,1,9
11204,10475,1,2,4,7
11204,11001,0,1,1,2
11204,11004,5,3,3,11
11204,11101,4,3,9,16
11204,11102,2,1,5,8
11204,11103,3,3,7,13
11204,11104,2,0,3,5
11204,11105,3,3,7,13
11204,11106,6,5,5,16
11204,11109,1,4,1,6
11204,11201,13,12,21,46
11204,11203,53,117,60,230
11204,11204,802,689,246,1737
11204,11205,7,12,19,38
11204,11206,19,41,15,75
11204,11207,20,38,21,79
11204,11208,14,58,19,91
11204,11209,71,87,78,236
11204,11210,103,109,84,296
11204,11211,54,35,21,110
11204,11212,38,39,21,98
11204,11213,20,30,24,74
11204,11214,279,284,125,688
11204,11215,21,24,43,88
11204,11216,7,15,20,42
11204,11217,12,22,16,50
11204,11218,198,207,61,466
11204,11219,438,394,121,953
11204,11220,119,159,67,345
11204,11221,11,29,17,57
11204,11222,22,12,6,40
11204,11223,239,225,99,563
11204,11224,87,117,49,253
11204,11225,57,49,30,136
11204,11226,101,127,56,284
11204,11228,146,110,74,330
11204,11229,150,160,97,407
11204,11230,301,311,166,778
11204,11231,13,18,24,55
11204,11232,20,43,21,84
11204,11233,15,33,19,67
11204,11234,109,123,129,361
11204,11235,114,159,99,372
11204,11236,63,80,56,199
11204,11237,14,17,15,46
11204,11238,16,12,15,43
11204,11239,3,17,4,24
11204,11354,12,10,10,32
11204,11355,19,20,4,43
11204,11356,3,0,4,7
11204,11357,8,5,1,14
11204,11358,5,6,1,12
11204,11360,1,7,1,9
11204,11361,5,2,4,11
11204,11362,4,2,2,8
11204,11363,0,2,1,3
11204,11364,1,4,7,12
11204,11365,5,5,8,18
11204,11366,0,0,2,2
11204,11367,5,12,14,31
11204,11368,22,23,15,60
11204,11369,5,8,3,16
11204,11370,6,12,5,23
11204,11372,12,18,12,42
11204,11373,22,10,6,38
11204,11374,6,11,15,32
11204,11375,16,23,22,61
11204,11377,12,9,12,33
11204,11378,7,12,3,22
11204,11379,5,5,3,13
11204,11385,19,22,32,73
11204,11411,3,4,11,18
11204,11412,3,13,9,25
11204,11413,2,7,10,19
11204,11414,7,4,11,22
11204,11415,4,2,6,12
11204,11416,3,4,6,13
11204,11417,6,5,5,16
11204,11418,9,8,6,23
11204,11419,7,10,6,23
11204,11420,12,13,8,33
11204,11421,6,13,5,24
11204,11422,2,9,13,24
11204,11423,6,11,8,25
11204,11426,4,3,3,10
11204,11427,5,2,4,11
11204,11428,1,3,3,7
11204,11429,3,5,7,15
11204,11432,5,14,11,30
11204,11433,3,5,10,18
11204,11434,7,10,9,26
11204,11435,10,14,16,40
11204,11436,2,10,5,17
11204,11691,13,24,35,72
11204,11692,7,15,17,39
11204,11693,4,13,4,21
11204,11694,18,10,22,50
11204,11697,1,6,3,10
11205,10001,8,4,9,21
11205,10002,37,33,36,106
11205,10003,9,18,21,48
11205,10004,0,4,8,12
11205,10005,1,0,2,3
11205,10006,1,1,0,2
11205,10007,4,5,5,14
11205,10009,26,30,17,73
11205,10010,7,12,14,33
11205,10011,17,14,30,61
11205,10012,8,4,13,25
11205,10013,11,9,24,44
11205,10014,2,5,13,20
11205,10016,8,14,17,39
11205,10017,4,4,10,18
11205,10018,4,4,3,11
11205,10019,12,7,14,33
11205,10021,3,4,12,19
11205,10022,3,6,18,27
11205,10023,10,14,21,45
11205,10024,7,12,12,31
11205,10025,25,20,21,66
11205,10026,12,3,8,23
11205,10027,20,15,12,47
11205,10028,10,6,9,25
11205,10029,15,24,19,58
11205,10030,7,8,6,21
11205,10031,10,15,10,35
11205,10032,7,15,12,34
11205,10033,10,11,9,30
11205,10034,9,10,10,29
11205,10035,9,7,13,29
11205,10036,11,5,9,25
11205,10037,2,9,3,14
11205,10038,6,7,13,26
11205,10039,6,4,5,15
11205,10040,5,7,2,14
11205,10044,3,1,1,5
11205,10065,3,8,11,22
11205,10069,0,0,4,4
11205,10075,5,1,6,12
11205,10128,10,10,19,39
11205,10173,0,1,0,1
11205,10280,1,2,2,5
11205,10282,0,1,1,2
11205,10301,6,24,14,44
11205,10302,5,10,8,23
11205,10303,6,10,18,34
11205,10304,14,19,20,53
11205,10305,10,14,18,42
11205,10306,8,19,13,40
11205,10307,1,2,3,6
11205,10308,2,3,5,10
11205,10309,3,5,14,22
11205,10310,2,12,13,27
11205,10312,2,8,19,29
11205,10314,11,19,35,65
11205,10451,10,18,10,38
11205,10452,11,15,6,32
11205,10453,17,11,10,38
11205,10454,5,5,9,19
11205,10455,6,9,7,22
11205,10456,11,28,8,47
11205,10457,14,14,7,35
11205,10458,12,25,6,43
11205,10459,14,8,2,24
11205,10460,5,11,9,25
11205,10461,6,8,15,29
11205,10462,9,13,15,37
11205,10463,6,11,21,38
11205,10464,0,1,1,2
11205,10465,1,6,7,14
11205,10466,8,16,5,29
11205,10467,9,15,15,39
11205,10468,12,18,18,48
11205,10469,6,13,12,31
11205,10470,2,2,5,9
11205,10471,2,6,9,17
11205,10472,9,13,14,36
11205,10473,10,13,12,35
11205,10474,1,3,0,4
11205,10475,3,6,6,15
11205,11001,2,2,1,5
11205,11004,2,1,6,9
11205,11040,0,0,4,4
11205,11101,10,11,23,44
11205,11102,19,21,12,52
11205,11103,12,21,18,51
11205,11104,12,10,15,37
11205,11105,14,12,26,52
11205,11106,21,7,21,49
11205,11109,0,0,2,2
11205,11201,42,45,66,153
11205,11203,39,55,71,165
11205,11204,53,85,40,178
11205,11205,501,324,216,1041
11205,11206,310,251,142,703
11205,11207,68,87,49,204
11205,11208,55,112,59,226
11205,11209,29,42,32,103
11205,11210,32,30,53,115
11205,11211,428,332,172,932
11205,11212,61,88,44,193
11205,11213,65,66,61,192
11205,11214,27,43,51,121
11205,11215,49,31,95,175
11205,11216,78,56,62,196
11205,11217,48,52,40,140
11205,11218,64,54,46,164
11205,11219,107,159,83,349
11205,11220,63,70,40,173
11205,11221,103,95,90,288
11205,11222,38,44,67,149
11205,11223,28,63,25,116
11205,11224,11,27,30,68
11205,11225,54,80,41,175
11205,11226,67,82,65,214
11205,11228,24,25,33,82
11205,11229,23,33,61,117
11205,11230,39,78,73,190
11205,11231,32,32,37,101
11205,11232,17,23,15,55
11205,11233,42,82,60,184
11205,11234,35,56,74,165
11205,11235,21,41,38,100
11205,11236,34,69,70,173
11205,11237,39,66,33,138
11205,11238,117,75,113,305
11205,11239,3,6,8,17
11205,11354,6,7,16,29
11205,11355,11,18,14,43
11205,11356,2,3,7,12
11205,11357,6,8,8,22
11205,11358,5,7,19,31
11205,11359,1,0,1,2
11205,11360,5,6,5,16
11205,11361,5,8,8,21
11205,11362,0,2,4,6
11205,11363,0,0,1,1
11205,11364,4,3,9,16
11205,11365,4,10,16,30
11205,11366,1,3,4,8
11205,11367,6,7,11,24
11205,11368,18,46,16,80
11205,11369,7,13,20,40
11205,11370,8,5,13,26
11205,11371,0,1,0,1
11205,11372,20,22,19,61
11205,11373,29,37,33,99
11205,11374,13,14,15,42
11205,11375,18,20,31,69
11205,11377,41,26,35,102
11205,11378,16,23,47,86
11205,11379,12,20,27,59
11205,11385,67,109,82,258
11205,11411,4,1,4,9
11205,11412,5,13,7,25
11205,11413,4,13,11,28
11205,11414,6,12,15,33
11205,11415,3,13,12,28
11205,11416,18,15,21,54
11205,11417,7,25,14,46
11205,11418,21,15,24,60
11205,11419,16,20,24,60
11205,11420,15,16,10,41
11205,11421,16,27,23,66
11205,11422,6,4,6,16
11205,11423,6,13,8,27
11205,11426,5,3,6,14
11205,11427,3,6,9,18
11205,11428,1,2,5,8
11205,11429,2,3,10,15
11205,11430,0,0,1,1
11205,11432,11,11,13,35
11205,11433,5,17,11,33
11205,11434,12,19,26,57
11205,11435,12,15,6,33
11205,11436,5,8,7,20
11205,11691,14,31,21,66
11205,11692,8,6,10,24
11205,11693,2,5,7,14
11205,11694,8,6,10,24
11205,11697,3,2,2,7
11206,10001,8,10,17,35
11206,10002,38,80,73,191
11206,10003,10,16,38,64
11206,10004,6,8,7,21
11206,10005,1,3,6,10
11206,10006,1,0,0,1
11206,10007,3,3,6,12
11206,10009,29,38,57,124
11206,10010,2,9,25,36
11206,10011,9,17,41,67
11206,10012,8,5,11,24
11206,10013,6,21,16,43
11206,10014,8,5,16,29
11206,10016,11,20,33,64
11206,10017,3,8,12,23
11206,10018,1,11,10,22
11206,10019,4,16,20,40
11206,10021,8,9,20,37
11206,10022,6,8,15,29
11206,10023,6,16,26,48
11206,10024,10,13,16,39
11206,10025,12,24,41,77
11206,10026,16,25,25,66
11206,10027,20,31,28,79
11206,10028,4,6,19,29
11206,10029,22,40,46,108
11206,10030,11,19,19,49
11206,10031,12,30,28,70
11206,10032,13,33,20,66
11206,10033,23,26,19,68
11206,10034,14,19,9,42
11206,10035,9,22,26,57
11206,10036,14,13,9,36
11206,10037,5,11,9,25
11206,10038,6,14,18,38
11206,10039,10,16,16,42
11206,10040,14,22,11,47
11206,10044,3,5,5,13
11206,10065,5,6,11,22
11206,10069,1,3,1,5
11206,10075,5,2,15,22
11206,10128,9,16,37,62
11206,10162,0,0,1,1
11206,10280,1,3,4,8
11206,10301,7,10,30,47
11206,10302,4,2,13,19
11206,10303,3,11,22,36
11206,10304,5,13,30,48
11206,10305,8,14,21,43
11206,10306,4,10,21,35
11206,10307,1,3,10,14
11206,10308,3,2,22,27
11206,10309,2,6,28,36
11206,10310,8,9,18,35
11206,10312,11,7,35,53
11206,10314,9,26,62,97
11206,10451,28,32,24,84
11206,10452,56,62,35,153
11206,10453,67,75,25,167
11206,10454,11,21,14,46
11206,10455,15,26,18,59
11206,10456,61,72,32,165
11206,10457,57,65,22,144
11206,10458,40,70,32,142
11206,10459,27,33,22,82
11206,10460,25,50,24,99
11206,10461,12,17,34,63
11206,10462,38,24,42,104
11206,10463,22,35,28,85
11206,10464,0,3,1,4
11206,10465,5,7,23,35
11206,10466,21,25,43,89
11206,10467,42,80,41,163
11206,10468,39,72,25,136
11206,10469,24,29,35,88
11206,10470,5,8,8,21
11206,10471,5,5,7,17
11206,10472,30,31,31,92
11206,10473,21,29,40,90
11206,10474,3,9,4,16
11206,10475,14,17,28,59
11206,11001,2,0,2,4
11206,11004,2,8,11,21
11206,11005,1,0,0,1
11206,11040,1,2,1,4
11206,11101,28,30,20,78
11206,11102,14,18,46,78
11206,11103,19,29,51,99
11206,11104,9,11,23,43
11206,11105,15,20,31,66
11206,11106,22,27,30,79
11206,11109,1,1,4,6
11206,11201,20,43,76,139
11206,11203,103,237,149,489
11206,11204,39,89,42,170
11206,11205,159,100,79,338
11206,11206,518,583,255,1356
11206,11207,147,282,130,559
11206,11208,141,284,140,565
11206,11209,16,43,44,103
11206,11210,76,139,110,325
11206,11211,391,278,164,833
11206,11212,152,198,106,456
11206,11213,79,121,84,284
11206,11214,31,93,52,176
11206,11215,24,34,76,134
11206,11216,73,91,90,254
11206,11217,12,33,48,93
11206,11218,38,95,77,210
11206,11219,88,111,63,262
11206,11220,58,123,67,248
11206,11221,166,274,187,627
11206,11222,36,45,85,166
11206,11223,36,72,43,151
11206,11224,15,49,30,94
11206,11225,83,137,97,317
11206,11226,97,259,170,526
11206,11228,9,46,16,71
11206,11229,24,58,51,133
11206,11230,80,85,106,271
11206,11231,14,29,45,88
11206,11232,27,32,20,79
11206,11233,101,171,112,384
11206,11234,68,147,175,390
11206,11235,23,71,60,154
11206,11236,101,187,210,498
11206,11237,112,176,101,389
11206,11238,40,62,94,196
11206,11239,7,23,23,53
11206,11354,11,40,28,79
11206,11355,22,56,40,118
11206,11356,7,9,16,32
11206,11357,11,20,14,45
11206,11358,17,12,21,50
11206,11360,4,11,9,24
11206,11361,4,10,30,44
11206,11362,4,6,11,21
11206,11363,1,2,2,5
11206,11364,6,25,24,55
11206,11365,8,17,19,44
11206,11366,3,5,4,12
11206,11367,11,14,20,45
11206,11368,48,108,71,227
11206,11369,14,30,34,78
11206,11370,19,34,24,77
11206,11371,0,1,1,2
11206,11372,15,46,46,107
11206,11373,47,90,91,228
11206,11374,10,16,56,82
11206,11375,27,46,103,176
11206,11377,39,76,80,195
11206,11378,32,76,50,158
11206,11379,18,32,56,106
11206,11385,118,211,191,520
11206,11411,6,9,17,32
11206,11412,17,34,40,91
11206,11413,14,20,34,68
11206,11414,5,14,18,37
11206,11415,11,10,23,44
11206,11416,24,48,37,109
11206,11417,21,32,38,91
11206,11418,34,32,33,99
11206,11419,18,42,43,103
11206,11420,30,44,37,111
11206,11421,32,60,60,152
11206,11422,14,15,20,49
11206,11423,15,24,17,56
11206,11426,3,15,11,29
11206,11427,7,7,17,31
11206,11428,4,11,19,34
11206,11429,14,17,30,61
11206,11432,28,30,33,91
11206,11433,9,20,33,62
11206,11434,23,35,46,104
11206,11435,12,40,35,87
11206,11436,11,8,14,33
11206,11691,22,52,59,133
11206,11692,22,25,25,72
11206,11693,9,10,15,34
11206,11694,10,15,43,68
11206,11697,1,3,7,11
11207,10001,2,1,2,5
11207,10002,10,20,15,45
11207,10003,5,7,13,25
11207,10004,3,4,5,12
11207,10005,0,1,2,3
11207,10006,0,1,1,2
11207,10007,2,2,6,10
11207,10009,10,10,12,32
11207,10010,1,5,3,9
11207,10011,5,7,13,25
11207,10012,5,5,8,18
11207,10013,4,8,9,21
11207,10014,4,6,11,21
11207,10016,0,5,5,10
11207,10017,0,3,4,7
11207,10019,3,1,6,10
11207,10021,0,2,4,6
11207,10022,0,3,0,3
11207,10023,0,3,7,10
11207,10024,1,3,9,13
11207,10025,4,11,12,27
11207,10026,7,18,10,35
11207,10027,0,14,16,30
11207,10028,0,3,4,7
11207,10029,14,25,34,73
11207,10030,5,7,14,26
11207,10031,3,21,18,42
11207,10032,15,17,27,59
11207,10033,7,19,13,39
11207,10034,4,14,9,27
11207,10035,4,9,16,29
11207,10036,1,1,3,5
11207,10037,1,2,3,6
11207,10038,5,3,5,13
11207,10039,4,6,6,16
11207,10040,0,6,13,19
11207,10044,0,1,1,2
11207,10065,0,3,2,5
11207,10069,1,0,1,2
11207,10075,0,0,4,4
11207,10128,0,2,6,8
11207,10280,3,1,2,6
11207,10282,1,0,0,1
11207,10301,7,9,14,30
11207,10302,3,4,4,11
11207,10303,4,11,8,23
11207,10304,3,3,18,24
11207,10305,4,8,14,26
11207,10306,8,10,25,43
11207,10307,1,3,4,8
11207,10308,1,7,8,16
11207,10309,0,4,15,19
11207,10310,4,6,6,16
11207,10312,6,11,32,49
11207,10314,17,10,25,52
11207,10451,13,23,15,51
11207,10452,15,47,37,99
11207,10453,36,44,30,110
11207,10454,13,20,17,50
11207,10455,12,11,9,32
11207,10456,23,55,39,117
11207,10457,20,31,27,78
11207,10458,21,46,29,96
11207,10459,14,22,11,47
11207,10460,11,42,24,77
11207,10461,13,22,16,51
11207,10462,27,40,22,89
11207,10463,5,12,22,39
11207,10464,1,1,0,2
11207,10465,11,18,22,51
11207,10466,5,22,18,45
11207,10467,14,53,20,87
11207,10468,11,42,17,70
11207,10469,4,33,26,63
11207,10470,2,3,6,11
11207,10471,1,4,2,7
11207,10472,23,52,52,127
11207,10473,13,31,46,90
11207,10474,4,3,5,12
11207,10475,4,12,28,44
11207,11001,2,4,6,12
11207,11004,1,4,14,19
11207,11005,0,1,0,1
11207,11040,1,0,3,4
11207,11101,6,17,15,38
11207,11102,4,5,11,20
11207,11103,5,12,17,34
11207,11104,5,9,8,22
11207,11105,8,13,8,29
11207,11106,1,9,14,24
11207,11109,0,1,1,2
11207,11201,17,29,35,81
11207,11203,63,168,119,350
11207,11204,22,36,45,103
11207,11205,20,43,25,88
11207,11206,61,117,61,239
11207,11207,255,508,191,954
11207,11208,159,391,140,690
11207,11209,13,21,33,67
11207,11210,43,115,75,233
11207,11211,37,54,39,130
11207,11212,97,222,103,422
11207,11213,50,108,59,217
11207,11214,28,42,53,123
11207,11215,12,22,32,66
11207,11216,22,59,56,137
11207,11217,12,22,28,62
11207,11218,33,56,41,130
11207,11219,31,33,33,97
11207,11220,46,46,36,128
11207,11221,39,126,81,246
11207,11222,5,17,22,44
11207,11223,21,51,80,152
11207,11224,15,30,33,78
11207,11225,19,72,71,162
11207,11226,69,184,126,379
11207,11228,9,15,21,45
11207,11229,34,45,77,156
11207,11230,43,74,90,207
11207,11231,18,20,21,59
11207,11232,9,8,13,30
11207,11233,66,141,70,277
11207,11234,49,94,142,285
11207,11235,25,47,70,142
11207,11236,81,254,232,567
11207,11237,29,69,30,128
11207,11238,13,51,55,119
11207,11239,17,38,32,87
11207,11354,5,7,16,28
11207,11355,20,13,15,48
11207,11356,2,3,10,15
11207,11357,4,9,13,26
11207,11358,4,6,11,21
11207,11360,1,0,5,6
11207,11361,0,1,9,10
11207,11362,1,3,7,11
11207,11363,1,0,1,2
11207,11364,2,0,9,11
11207,11365,7,19,13,39
11207,11366,5,7,13,25
11207,11367,11,29,31,71
11207,11368,20,44,39,103
11207,11369,11,17,15,43
11207,11370,5,14,14,33
11207,11371,1,0,0,1
11207,11372,13,21,19,53
11207,11373,21,49,29,99
11207,11374,7,22,42,71
11207,11375,13,29,42,84
11207,11377,22,40,41,103
11207,11378,10,20,34,64
11207,11379,13,17,39,69
11207,11385,60,88,98,246
11207,11411,11,22,45,78
11207,11412,32,41,43,116
11207,11413,11,33,60,104
11207,11414,12,20,51,83
11207,11415,6,9,16,31
11207,11416,34,43,33,110
11207,11417,21,31,31,83
11207,11418,23,31,37,91
11207,11419,28,62,52,142
11207,11420,26,52,58,136
11207,11421,36,53,49,138
11207,11422,21,38,36,95
11207,11423,22,24,22,68
11207,11426,5,10,14,29
11207,11427,5,6,26,37
11207,11428,12,16,18,46
11207,11429,15,21,40,76
11207,11430,1,1,0,2
11207,11432,22,32,30,84
11207,11433,16,47,40,103
11207,11434,35,57,76,168
11207,11435,20,41,32,93
11207,11436,8,22,25,55
11207,11451,1,0,0,1
11207,11691,25,49,44,118
11207,11692,5,13,20,38
11207,11693,10,10,18,38
11207,11694,3,16,18,37
11207,11697,1,1,6,8
11208,10001,4,0,3,7
11208,10002,4,16,24,44
11208,10003,2,6,23,31
11208,10004,1,4,4,9
11208,10005,0,0,2,2
11208,10006,0,0,1,1
11208,10007,3,2,0,5
11208,10009,3,3,25,31
11208,10010,1,1,4,6
11208,10011,2,4,10,16
11208,10012,3,6,7,16
11208,10013,5,4,4,13
11208,10014,3,5,7,15
11208,10016,0,1,14,15
11208,10017,0,1,1,2
11208,10018,1,0,2,3
11208,10019,2,2,5,9
11208,10021,0,0,4,4
11208,10022,0,2,6,8
11208,10023,5,1,10,16
11208,10024,0,2,7,9
11208,10025,5,6,10,21
11208,10026,2,10,14,26
11208,10027,1,7,13,21
11208,10028,2,0,6,8
11208,10029,11,15,16,42
11208,10030,4,6,12,22
11208,10031,4,14,9,27
11208,10032,1,22,14,37
11208,10033,5,15,10,30
11208,10034,5,7,6,18
11208,10035,6,6,11,23
11208,10036,1,2,2,5
11208,10037,4,3,5,12
11208,10038,4,7,11,22
11208,10039,3,5,6,14
11208,10040,5,8,13,26
11208,10044,1,1,2,4
11208,10065,3,0,3,6
11208,10075,0,1,6,7
11208,10128,1,0,9,10
11208,10280,0,1,7,8
11208,10301,4,4,11,19
11208,10302,1,2,4,7
11208,10303,2,4,16,22
11208,10304,5,7,18,30
11208,10305,3,5,25,33
11208,10306,6,7,28,41
11208,10307,2,4,7,13
11208,10308,2,8,20,30
11208,10309,2,4,26,32
11208,10310,3,3,12,18
11208,10312,2,7,44,53
11208,10314,8,10,28,46
11208,10451,3,10,11,24
11208,10452,12,12,11,35
11208,10453,10,17,16,43
11208,10454,5,8,6,19
11208,10455,5,11,4,20
11208,10456,12,13,15,40
11208,10457,11,21,15,47
11208,10458,9,18,16,43
11208,10459,10,10,4,24
11208,10460,6,14,12,32
11208,10461,2,10,21,33
11208,10462,4,15,19,38
11208,10463,2,5,16,23
11208,10464,0,1,2,3
11208,10465,2,9,17,28
11208,10466,8,15,10,33
11208,10467,11,18,24,53
11208,10468,11,14,13,38
11208,10469,7,17,21,45
11208,10470,1,3,4,8
11208,10471,0,5,4,9
11208,10472,7,14,18,39
11208,10473,2,9,12,23
11208,10474,1,2,7,10
11208,10475,2,2,21,25
11208,11001,1,0,8,9
11208,11004,4,6,6,16
11208,11005,0,1,0,1
11208,11040,0,2,4,6
11208,11101,8,11,20,39
11208,11102,7,10,17,34
11208,11103,4,13,22,39
11208,11104,6,14,9,29
11208,11105,9,10,20,39
11208,11106,4,9,13,26
11208,11109,0,1,4,5
11208,11201,19,14,46,79
11208,11203,60,96,110,266
11208,11204,15,15,25,55
11208,11205,10,28,24,62
11208,11206,43,71,54,168
11208,11207,162,298,157,617
11208,11208,478,644,200,1322
11208,11209,7,8,23,38
11208,11210,22,62,79,163
11208,11211,20,36,43,99
11208,11212,80,194,106,380
11208,11213,35,81,69,185
11208,11214,8,20,40,68
11208,11215,20,30,49,99
11208,11216,26,45,41,112
11208,11217,12,12,25,49
11208,11218,17,18,39,74
11208,11219,15,16,23,54
11208,11220,27,38,31,96
11208,11221,38,96,60,194
11208,11222,7,11,18,36
11208,11223,17,21,49,87
11208,11224,14,22,16,52
11208,11225,24,60,47,131
11208,11226,54,117,92,263
11208,11228,6,5,15,26
11208,11229,13,35,77,125
11208,11230,26,29,67,122
11208,11231,2,17,17,36
11208,11232,6,8,12,26
11208,11233,43,101,85,229
11208,11234,40,104,141,285
11208,11235,14,22,59,95
11208,11236,82,182,175,439
11208,11237,14,43,20,77
11208,11238,16,23,37,76
11208,11239,18,19,23,60
11208,11354,9,17,24,50
11208,11355,11,17,26,54
11208,11356,4,9,7,20
11208,11357,9,14,32,55
11208,11358,4,3,20,27
11208,11359,1,1,0,2
11208,11360,3,4,10,17
11208,11361,3,2,13,18
11208,11362,2,4,13,19
11208,11363,0,0,3,3
11208,11364,6,2,17,25
11208,11365,13,15,26,54
11208,11366,6,2,15,23
11208,11367,9,20,20,49
11208,11368,29,48,49,126
11208,11369,11,28,25,64
11208,11370,7,14,17,38
11208,11371,1,0,0,1
11208,11372,13,23,29,65
11208,11373,26,32,44,102
11208,11374,10,20,31,61
11208,11375,19,22,50,91
11208,11377,15,27,47,89
11208,11378,21,28,31,80
11208,11379,11,10,59,80
11208,11385,48,90,121,259
11208,11411,11,20,47,78
11208,11412,18,37,57,112
11208,11413,29,43,74,146
11208,11414,15,28,49,92
11208,11415,10,7,25,42
11208,11416,61,97,38,196
11208,11417,56,83,42,181
11208,11418,22,37,34,93
11208,11419,41,76,45,162
11208,11420,45,79,55,179
11208,11421,34,77,84,195
11208,11422,14,21,50,85
11208,11423,20,24,34,78
11208,11426,4,6,13,23
11208,11427,11,14,18,43
11208,11428,8,28,19,55
11208,11429,15,22,31,68
11208,11430,0,3,1,4
11208,11432,20,41,50,111
11208,11433,21,48,39,108
11208,11434,33,56,71,160
11208,11435,18,41,43,102
11208,11436,12,38,28,78
11208,11691,33,43,49,125
11208,11692,12,20,20,52
11208,11693,6,8,21,35
11208,11694,7,9,38,54
11208,11697,1,6,2,9
11209,10001,2,2,4,8
11209,10002,22,31,17,70
11209,10003,2,10,10,22
11209,10004,2,3,6,11
11209,10005,1,8,2,11
11209,10007,1,1,2,4
11209,10009,5,12,11,28
11209,10010,2,2,4,8
11209,10011,8,6,6,20
11209,10012,5,4,9,18
11209,10013,6,1,8,15
11209,10014,3,9,15,27
11209,10016,2,4,8,14
11209,10017,1,0,0,1
11209,10018,0,0,1,1
11209,10019,7,2,6,15
11209,10021,2,3,12,17
11209,10022,1,1,8,10
11209,10023,2,5,8,15
11209,10024,4,1,8,13
11209,10025,7,6,12,25
11209,10026,1,6,7,14
11209,10027,10,17,9,36
11209,10028,2,1,10,13
11209,10029,11,16,16,43
11209,10030,9,6,3,18
11209,10031,1,5,7,13
11209,10032,4,12,6,22
11209,10033,5,7,8,20
11209,10034,7,7,0,14
11209,10035,5,4,5,14
11209,10036,2,4,4,10
11209,10037,3,0,1,4
11209,10038,4,6,12,22
11209,10039,0,4,3,7
11209,10040,2,8,6,16
11209,10044,0,1,4,5
11209,10065,1,2,5,8
11209,10069,0,1,0,1
11209,10075,0,0,2,2
11209,10128,3,2,11,16
11209,10162,0,0,1,1
11209,10280,1,5,1,7
11209,10282,0,1,0,1
11209,10301,28,44,66,138
11209,10302,7,20,20,47
11209,10303,18,27,25,70
11209,10304,39,60,65,164
11209,10305,71,80,87,238
11209,10306,60,84,110,254
11209,10307,14,12,21,47
11209,10308,21,29,47,97
11209,10309,21,30,45,96
11209,10310,24,31,26,81
11209,10312,33,66,122,221
11209,10314,83,121,151,355
11209,10451,5,6,2,13
11209,10452,12,11,8,31
11209,10453,13,14,10,37
11209,10454,2,6,0,8
11209,10455,5,6,3,14
11209,10456,10,16,7,33
11209,10457,10,9,6,25
11209,10458,10,15,5,30
11209,10459,4,5,8,17
11209,10460,5,7,3,15
11209,10461,7,7,10,24
11209,10462,9,5,9,23
11209,10463,6,9,3,18
11209,10464,0,0,1,1
11209,10465,2,2,6,10
11209,10466,6,6,8,20
11209,10467,11,17,13,41
11209,10468,6,15,7,28
11209,10469,8,5,6,19
11209,10470,3,3,2,8
11209,10471,3,3,2,8
11209,10472,9,9,10,28
11209,10473,4,7,4,15
11209,10474,1,0,2,3
11209,10475,2,3,5,10
11209,11001,0,1,0,1
11209,11004,5,4,2,11
11209,11005,1,1,0,2
11209,11101,4,8,3,15
11209,11102,4,7,10,21
11209,11103,6,6,12,24
11209,11104,4,6,7,17
11209,11105,7,5,20,32
11209,11106,4,8,10,22
11209,11109,0,2,1,3
11209,11201,14,24,33,71
11209,11203,44,75,38,157
11209,11204,107,116,59,282
11209,11205,22,19,21,62
11209,11206,18,23,23,64
11209,11207,10,41,26,77
11209,11208,25,39,28,92
11209,11209,765,805,607,2177
11209,11210,35,38,39,112
11209,11211,2,15,23,40
11209,11212,18,39,19,76
11209,11213,29,48,37,114
11209,11214,168,215,110,493
11209,11215,41,54,74,169
11209,11216,26,21,23,70
11209,11217,15,25,25,65
11209,11218,54,68,56,178
11209,11219,107,120,55,282
11209,11220,234,284,113,631
11209,11221,15,27,13,55
11209,11222,4,2,11,17
11209,11223,87,85,71,243
11209,11224,49,62,47,158
11209,11225,32,44,34,110
11209,11226,91,96,62,249
11209,11228,180,234,185,599
11209,11229,74,90,90,254
11209,11230,66,90,58,214
11209,11231,24,29,28,81
11209,11232,44,69,23,136
11209,11233,25,23,24,72
11209,11234,77,88,118,283
11209,11235,67,86,79,232
11209,11236,62,72,48,182
11209,11237,4,11,6,21
11209,11238,17,17,37,71
11209,11239,2,8,5,15
11209,11354,5,8,5,18
11209,11355,11,12,17,40
11209,11356,3,3,0,6
11209,11357,3,4,9,16
11209,11358,6,5,5,16
11209,11360,1,4,9,14
11209,11361,5,2,4,11
11209,11362,1,2,7,10
11209,11363,0,0,1,1
11209,11364,3,3,10,16
11209,11365,1,8,11,20
11209,11366,1,2,2,5
11209,11367,7,3,4,14
11209,11368,10,24,12,46
11209,11369,4,0,4,8
11209,11370,5,10,5,20
11209,11372,7,7,8,22
11209,11373,20,27,16,63
11209,11374,3,7,7,17
11209,11375,16,9,11,36
11209,11377,13,22,23,58
11209,11378,8,8,17,33
11209,11379,7,5,13,25
11209,11385,18,17,28,63
11209,11411,0,3,4,7
11209,11412,1,13,6,20
11209,11413,9,9,10,28
11209,11414,8,13,8,29
11209,11415,4,6,7,17
11209,11416,0,4,6,10
11209,11417,8,10,7,25
11209,11418,10,11,10,31
11209,11419,7,10,14,31
11209,11420,9,10,7,26
11209,11421,9,12,9,30
11209,11422,3,4,7,14
11209,11423,8,8,6,22
11209,11426,5,2,7,14
11209,11427,3,6,7,16
11209,11428,5,4,5,14
11209,11429,4,11,5,20
11209,11430,0,0,1,1
11209,11432,6,23,9,38
11209,11433,11,9,2,22
11209,11434,11,13,4,28
11209,11435,7,23,6,36
11209,11436,4,3,4,11
11209,11691,16,20,18,54
11209,11692,3,6,3,12
11209,11693,3,5,4,12
11209,11694,10,9,15,34
11209,11697,5,1,5,11
11210,10001,2,1,3,6
11210,10002,1,14,9,24
11210,10003,3,7,12,22
11210,10004,0,1,1,2
11210,10005,0,1,0,1
11210,10006,1,0,0,1
11210,10009,6,8,6,20
11210,10010,3,1,5,9
11210,10011,4,3,8,15
11210,10012,0,1,8,9
11210,10013,2,2,2,6
11210,10014,1,3,3,7
11210,10016,1,1,6,8
11210,10017,2,1,4,7
11210,10019,2,3,4,9
11210,10021,1,4,1,6
11210,10022,3,0,5,8
11210,10023,2,1,11,14
11210,10024,6,4,11,21
11210,10025,6,11,12,29
11210,10026,6,6,5,17
11210,10027,11,7,8,26
11210,10028,2,1,7,10
11210,10029,9,18,17,44
11210,10030,6,5,4,15
11210,10031,13,17,11,41
11210,10032,9,10,6,25
11210,10033,4,9,9,22
11210,10034,8,7,8,23
11210,10035,5,3,6,14
11210,10036,1,3,1,5
11210,10037,4,5,2,11
11210,10038,1,2,2,5
11210,10039,3,2,3,8
11210,10040,7,15,6,28
11210,10044,0,2,4,6
11210,10065,2,1,2,5
11210,10069,0,1,1,2
11210,10075,0,1,2,3
11210,10128,0,5,3,8
11210,10280,1,2,2,5
11210,10282,0,0,1,1
11210,10301,17,16,14,47
11210,10302,5,4,13,22
11210,10303,9,5,7,21
11210,10304,16,12,29,57
11210,10305,6,8,18,32
11210,10306,16,21,44,81
11210,10307,3,6,13,22
11210,10308,5,4,17,26
11210,10309,7,9,23,39
11210,10310,5,6,17,28
11210,10312,11,12,38,61
11210,10314,18,29,45,92
11210,10451,8,16,6,30
11210,10452,10,19,9,38
11210,10453,5,19,3,27
11210,10454,4,3,6,13
11210,10455,10,4,6,20
11210,10456,16,19,14,49
11210,10457,17,16,9,42
11210,10458,14,23,10,47
11210,10459,7,13,6,26
11210,10460,14,16,4,34
11210,10461,6,8,16,30
11210,10462,10,10,9,29
11210,10463,7,7,15,29
11210,10464,0,1,1,2
11210,10465,6,5,13,24
11210,10466,10,18,9,37
11210,10467,16,27,11,54
11210,10468,15,10,12,37
11210,10469,7,10,12,29
11210,10470,2,5,4,11
11210,10471,6,3,1,10
11210,10472,7,6,12,25
11210,10473,6,9,8,23
11210,10474,1,4,2,7
11210,10475,1,2,10,13
11210,11001,1,1,0,2
11210,11004,3,4,5,12
11210,11040,2,0,0,2
11210,11101,3,4,4,11
11210,11102,4,2,1,7
11210,11103,1,3,8,12
11210,11104,2,7,12,21
11210,11105,0,5,6,11
11210,11106,7,4,6,17
11210,11109,1,0,0,1
11210,11201,12,20,16,48
11210,11203,111,126,86,323
11210,11204,68,90,63,221
11210,11205,12,18,15,45
11210,11206,24,33,27,84
11210,11207,69,73,56,198
11210,11208,56,95,40,191
11210,11209,43,36,69,148
11210,11210,339,428,282,1049
11210,11211,16,13,24,53
11210,11212,73,99,72,244
11210,11213,32,74,43,149
11210,11214,67,98,74,239
11210,11215,25,39,56,120
11210,11216,26,52,35,113
11210,11217,15,19,14,48
11210,11218,48,92,90,230
11210,11219,48,93,54,195
11210,11220,54,75,42,171
11210,11221,22,50,35,107
11210,11222,7,8,11,26
11210,11223,85,105,75,265
11210,11224,51,96,56,203
11210,11225,53,76,52,181
11210,11226,155,232,90,477
11210,11228,16,60,29,105
11210,11229,104,157,157,418
11210,11230,193,262,181,636
11210,11231,11,13,17,41
11210,11232,11,16,12,39
11210,11233,42,67,59,168
11210,11234,150,254,262,666
11210,11235,80,134,99,313
11210,11236,104,172,126,402
11210,11237,9,21,12,42
11210,11238,22,20,45,87
11210,11239,7,19,13,39
11210,11354,4,7,4,15
11210,11355,8,12,10,30
11210,11356,3,4,1,8
11210,11357,4,4,3,11
11210,11358,4,1,6,11
11210,11360,2,3,4,9
11210,11361,1,7,7,15
11210,11362,2,3,6,11
11210,11363,2,3,1,6
11210,11364,7,4,6,17
11210,11365,12,7,11,30
11210,11366,3,1,8,12
11210,11367,12,5,20,37
11210,11368,18,11,15,44
11210,11369,7,6,10,23
11210,11370,4,6,9,19
11210,11372,11,5,8,24
11210,11373,8,14,11,33
11210,11374,5,9,11,25
11210,11375,11,12,17,40
11210,11377,11,13,12,36
11210,11378,4,8,8,20
11210,11379,4,4,6,14
11210,11385,12,23,28,63
11210,11411,4,5,4,13
11210,11412,7,12,14,33
11210,11413,8,8,14,30
11210,11414,1,3,10,14
11210,11415,5,5,6,16
11210,11416,6,8,15,29
11210,11417,7,5,12,24
11210,11418,11,8,17,36
11210,11419,10,8,16,34
11210,11420,14,15,21,50
11210,11421,8,10,14,32
11210,11422,6,8,12,26
11210,11423,6,12,14,32
11210,11426,2,3,0,5
11210,11427,5,0,8,13
11210,11428,6,6,8,20
11210,11429,8,9,11,28
11210,11432,18,14,19,51
11210,11433,7,9,8,24
11210,11434,14,17,18,49
11210,11435,13,10,21,44
11210,11436,5,3,4,12
11210,11691,28,51,54,133
11210,11692,9,19,11,39
11210,11693,8,3,9,20
11210,11694,16,14,23,53
11210,11697,1,0,12,13
11211,10001,24,20,46,90
11211,10002,159,164,86,409
11211,10003,48,34,91,173
11211,10004,6,9,19,34
11211,10005,2,4,6,12
11211,10006,5,2,6,13
11211,10007,4,1,6,11
11211,10009,50,71,106,227
11211,10010,16,18,33,67
11211,10011,20,44,57,121
11211,10012,18,18,27,63
11211,10013,26,28,35,89
11211,10014,14,31,52,97
11211,10016,19,31,57,107
11211,10017,14,14,19,47
11211,10018,20,5,10,35
11211,10019,23,47,47,117
11211,10021,13,7,32,52
11211,10022,11,26,36,73
11211,10023,26,22,43,91
11211,10024,19,33,54,106
11211,10025,52,53,68,173
11211,10026,22,38,19,79
11211,10027,41,42,45,128
11211,10028,12,21,43,76
11211,10029,51,106,64,221
11211,10030,22,27,19,68
11211,10031,41,83,30,154
11211,10032,42,48,35,125
11211,10033,43,56,42,141
11211,10034,33,39,16,88
11211,10035,27,40,36,103
11211,10036,21,22,32,75
11211,10037,14,18,11,43
11211,10038,19,28,21,68
11211,10039,18,27,19,64
11211,10040,37,45,16,98
11211,10044,8,5,15,28
11211,10065,14,20,34,68
11211,10069,2,3,2,7
11211,10075,8,14,25,47
11211,10119,0,0,2,2
11211,10128,26,32,63,121
11211,10162,1,1,3,5
11211,10280,3,2,11,16
11211,10282,3,1,1,5
11211,10301,21,32,45,98
11211,10302,12,14,16,42
11211,10303,21,28,21,70
11211,10304,33,40,46,119
11211,10305,19,34,42,95
11211,10306,26,39,78,143
11211,10307,5,1,19,25
11211,10308,7,12,38,57
11211,10309,5,23,30,58
11211,10310,12,28,22,62
11211,10312,16,20,51,87
11211,10314,53,80,74,207
11211,10451,55,71,15,141
11211,10452,73,125,45,243
11211,10453,90,149,28,267
11211,10454,35,59,14,108
11211,10455,23,46,7,76
11211,10456,76,119,33,228
11211,10457,74,107,29,210
11211,10458,71,113,40,224
11211,10459,43,69,18,130
11211,10460,39,49,28,116
11211,10461,24,29,30,83
11211,10462,49,60,49,158
11211,10463,38,61,46,145
11211,10464,3,5,0,8
11211,10465,16,29,24,69
11211,10466,40,59,36,135
11211,10467,63,103,48,214
11211,10468,52,92,40,184
11211,10469,24,52,44,120
11211,10470,14,13,13,40
11211,10471,15,18,14,47
11211,10472,47,62,32,141
11211,10473,31,55,23,109
11211,10474,6,8,4,18
11211,10475,16,36,16,68
11211,11001,2,4,2,8
11211,11004,10,18,5,33
11211,11005,0,3,3,6
11211,11040,1,2,1,4
11211,11101,37,49,46,132
11211,11102,26,55,59,140
11211,11103,54,54,74,182
11211,11104,30,43,48,121
11211,11105,38,51,60,149
11211,11106,48,49,70,167
11211,11109,3,6,7,16
11211,11201,53,77,135,265
11211,11203,139,270,125,534
11211,11204,193,208,146,547
11211,11205,483,391,223,1097
11211,11206,1187,1026,417,2630
11211,11207,226,439,186,851
11211,11208,188,398,144,730
11211,11209,68,97,86,251
11211,11210,143,224,143,510
11211,11211,2156,1896,1023,5075
11211,11212,168,292,142,602
11211,11213,152,233,145,530
11211,11214,145,207,95,447
11211,11215,84,75,161,320
11211,11216,116,208,159,483
11211,11217,51,56,88,195
11211,11218,136,184,118,438
11211,11219,376,385,170,931
11211,11220,189,286,119,594
11211,11221,234,446,292,972
11211,11222,180,304,361,845
11211,11223,102,175,67,344
11211,11224,63,93,44,200
11211,11225,102,184,127,413
11211,11226,225,446,174,845
11211,11228,67,69,47,183
11211,11229,99,130,95,324
11211,11230,161,246,172,579
11211,11231,46,66,78,190
11211,11232,48,65,40,153
11211,11233,151,270,164,585
11211,11234,115,232,224,571
11211,11235,81,136,88,305
11211,11236,190,317,155,662
11211,11237,222,329,212,763
11211,11238,76,111,168,355
11211,11239,9,24,18,51
11211,11354,35,52,24,111
11211,11355,60,80,57,197
11211,11356,13,36,21,70
11211,11357,20,37,30,87
11211,11358,24,29,31,84
11211,11360,11,22,12,45
11211,11361,13,26,30,69
11211,11362,7,11,12,30
11211,11363,0,5,7,12
11211,11364,11,17,33,61
11211,11365,24,46,36,106
11211,11366,11,13,13,37
11211,11367,38,36,49,123
11211,11368,129,220,100,449
11211,11369,31,64,42,137
11211,11370,32,36,35,103
11211,11371,2,3,2,7
11211,11372,61,68,58,187
11211,11373,153,180,80,413
11211,11374,44,104,77,225
11211,11375,86,109,126,321
11211,11377,100,169,119,388
11211,11378,71,105,90,266
11211,11379,48,107,112,267
11211,11385,270,473,299,1042
11211,11411,7,26,28,61
11211,11412,16,34,38,88
11211,11413,24,41,40,105
11211,11414,16,36,48,100
11211,11415,29,29,37,95
11211,11416,28,66,33,127
11211,11417,22,55,29,106
11211,11418,45,70,49,164
11211,11419,36,73,37,146
11211,11420,21,65,34,120
11211,11421,58,112,58,228
11211,11422,18,31,31,80
11211,11423,19,40,20,79
11211,11426,11,11,14,36
11211,11427,7,19,24,50
11211,11428,16,10,21,47
11211,11429,17,32,19,68
11211,11432,58,72,63,193
11211,11433,21,45,34,100
11211,11434,53,60,44,157
11211,11435,36,59,53,148
11211,11436,12,15,16,43
11211,11691,78,106,53,237
11211,11692,26,39,15,80
11211,11693,21,23,13,57
11211,11694,17,26,40,83
11211,11697,7,2,13,22
11212,10001,1,4,5,10
11212,10002,7,11,17,35
11212,10003,1,7,9,17
11212,10004,0,1,2,3
11212,10005,0,0,4,4
11212,10006,0,1,2,3
11212,10007,0,2,4,6
11212,10009,4,4,19,27
11212,10010,0,0,6,6
11212,10011,2,7,9,18
11212,10012,2,3,5,10
11212,10013,1,4,10,15
11212,10014,5,7,4,16
11212,10016,1,0,8,9
11212,10017,0,0,1,1
11212,10018,0,0,1,1
11212,10019,1,1,4,6
11212,10021,0,2,9,11
11212,10022,0,0,5,5
11212,10023,0,1,15,16
11212,10024,0,4,6,10
11212,10025,3,4,16,23
11212,10026,2,6,9,17
11212,10027,6,8,14,28
11212,10028,0,0,2,2
11212,10029,5,8,20,33
11212,10030,2,5,4,11
11212,10031,4,6,9,19
11212,10032,1,7,8,16
11212,10033,3,13,7,23
11212,10034,3,5,4,12
11212,10035,0,4,7,11
11212,10036,0,2,3,5
11212,10037,2,5,5,12
11212,10038,4,3,8,15
11212,10039,3,5,7,15
11212,10040,1,6,5,12
11212,10065,1,1,7,9
11212,10069,0,0,1,1
11212,10075,1,0,3,4
11212,10103,0,0,1,1
11212,10128,2,1,19,22
11212,10280,1,0,2,3
11212,10282,1,0,1,2
11212,10301,0,4,15,19
11212,10302,0,8,8,16
11212,10303,2,2,8,12
11212,10304,3,10,25,38
11212,10305,5,7,28,40
11212,10306,3,9,35,47
11212,10307,1,0,5,6
11212,10308,0,4,13,17
11212,10309,2,5,13,20
11212,10310,0,3,14,17
11212,10312,2,5,38,45
11212,10314,4,10,52,66
11212,10451,4,12,9,25
11212,10452,6,24,10,40
11212,10453,11,15,9,35
11212,10454,4,5,9,18
11212,10455,2,12,6,20
11212,10456,10,13,19,42
11212,10457,2,17,10,29
11212,10458,7,15,8,30
11212,10459,2,4,5,11
11212,10460,3,10,5,18
11212,10461,2,7,12,21
11212,10462,14,11,19,44
11212,10463,5,4,18,27
11212,10464,0,0,4,4
11212,10465,3,3,14,20
11212,10466,6,8,16,30
11212,10467,5,19,11,35
11212,10468,3,14,14,31
11212,10469,3,10,14,27
11212,10470,2,2,4,8
11212,10471,0,1,8,9
11212,10472,5,16,10,31
11212,10473,1,13,15,29
11212,10474,4,3,1,8
11212,10475,2,11,15,28
11212,11001,0,0,6,6
11212,11003,0,0,1,1
11212,11004,2,4,14,20
11212,11005,0,0,1,1
11212,11040,0,0,5,5
11212,11101,7,2,13,22
11212,11102,5,1,10,16
11212,11103,0,3,8,11
11212,11104,2,9,13,24
11212,11105,4,1,8,13
11212,11106,3,5,16,24
11212,11109,1,2,3,6
11212,11201,15,13,48,76
11212,11203,49,120,261,430
11212,11204,12,14,20,46
11212,11205,10,19,36,65
11212,11206,22,42,29,93
11212,11207,65,141,173,379
11212,11208,64,121,138,323
11212,11209,5,7,41,53
11212,11210,22,74,149,245
11212,11211,12,23,43,78
11212,11212,161,346,340,847
11212,11213,34,81,79,194
11212,11214,24,26,40,90
11212,11215,10,15,50,75
11212,11216,24,47,66,137
11212,11217,8,5,48,61
11212,11218,21,27,71,119
11212,11219,16,21,30,67
11212,11220,54,46,30,130
11212,11221,25,47,86,158
11212,11222,8,8,17,33
11212,11223,8,25,48,81
11212,11224,6,18,24,48
11212,11225,26,57,108,191
11212,11226,34,77,189,300
11212,11228,10,6,18,34
11212,11229,22,41,89,152
11212,11230,20,40,93,153
11212,11231,2,10,25,37
11212,11232,8,10,19,37
11212,11233,50,83,130,263
11212,11234,30,117,299,446
11212,11235,15,22,58,95
11212,11236,39,184,467,690
11212,11237,11,24,28,63
11212,11238,14,17,57,88
11212,11239,5,18,43,66
11212,11354,4,10,12,26
11212,11355,17,18,18,53
11212,11356,3,4,7,14
11212,11357,4,9,11,24
11212,11358,5,5,15,25
11212,11360,1,1,3,5
11212,11361,6,6,20,32
11212,11362,4,7,7,18
11212,11363,1,3,3,7
11212,11364,3,13,15,31
11212,11365,3,10,18,31
11212,11366,3,4,6,13
11212,11367,4,10,16,30
11212,11368,8,24,30,62
11212,11369,3,2,15,20
11212,11370,3,5,12,20
11212,11372,7,17,11,35
11212,11373,18,30,22,70
11212,11374,4,13,34,51
11212,11375,4,25,70,99
11212,11377,10,19,27,56
11212,11378,4,12,27,43
11212,11379,7,18,36,61
11212,11385,15,48,73,136
11212,11411,5,13,34,52
11212,11412,5,16,39,60
11212,11413,11,22,53,86
11212,11414,0,8,57,65
11212,11415,7,12,20,39
11212,11416,21,23,16,60
11212,11417,7,21,28,56
11212,11418,7,22,34,63
11212,11419,20,29,50,99
11212,11420,7,16,40,63
11212,11421,9,22,34,65
11212,11422,3,16,53,72
11212,11423,4,13,19,36
11212,11426,1,8,11,20
11212,11427,1,7,22,30
11212,11428,5,7,14,26
11212,11429,8,17,34,59
11212,11432,6,18,26,50
11212,11433,9,16,29,54
11212,11434,9,30,60,99
11212,11435,11,20,34,65
11212,11436,3,9,21,33
11212,11691,22,32,40,94
11212,11692,11,17,19,47
11212,11693,5,5,10,20
11212,11694,4,10,24,38
11212,11697,0,1,5,6
11213,10001,0,5,6,11
11213,10002,11,19,22,52
11213,10003,5,6,11,22
11213,10004,2,1,3,6
11213,10005,0,0,2,2
11213,10006,1,1,1,3
11213,10007,0,0,3,3
11213,10009,0,4,10,14
11213,10010,1,0,4,5
11213,10011,1,3,6,10
11213,10012,1,4,6,11
11213,10013,1,4,2,7
11213,10014,1,7,5,13
11213,10016,0,1,7,8
11213,10017,0,0,1,1
11213,10019,1,3,0,4
11213,10021,0,2,5,7
11213,10022,1,0,3,4
11213,10023,2,4,5,11
11213,10024,1,4,6,11
11213,10025,1,8,10,19
11213,10026,2,4,9,15
11213,10027,2,9,6,17
11213,10028,2,0,0,2
11213,10029,5,9,13,27
11213,10030,1,6,5,12
11213,10031,0,12,14,26
11213,10032,2,3,5,10
11213,10033,1,6,4,11
11213,10034,2,7,7,16
11213,10035,0,7,7,14
11213,10036,1,2,3,6
11213,10037,0,3,8,11
11213,10038,1,2,6,9
11213,10039,1,4,7,12
11213,10040,2,4,3,9
11213,10044,0,1,0,1
11213,10065,0,0,1,1
11213,10075,0,0,2,2
11213,10128,2,0,6,8
11213,10280,0,3,2,5
11213,10282,0,0,3,3
11213,10301,3,7,7,17
11213,10302,2,3,4,9
11213,10303,2,1,11,14
11213,10304,2,6,13,21
11213,10305,8,3,12,23
11213,10306,8,5,20,33
11213,10307,0,0,8,8
11213,10308,1,5,13,19
11213,10309,2,4,15,21
11213,10310,1,2,7,10
11213,10312,4,7,20,31
11213,10314,11,9,36,56
11213,10451,2,4,4,10
11213,10452,4,6,5,15
11213,10453,3,9,10,22
11213,10454,0,5,6,11
11213,10455,1,3,2,6
11213,10456,4,5,8,17
11213,10457,7,5,8,20
11213,10458,3,10,7,20
11213,10459,2,1,5,8
11213,10460,1,7,7,15
11213,10461,0,3,9,12
11213,10462,2,2,17,21
11213,10463,3,7,17,27
11213,10465,1,3,10,14
11213,10466,4,4,15,23
11213,10467,5,3,7,15
11213,10468,5,14,18,37
11213,10469,0,6,15,21
11213,10470,2,1,3,6
11213,10471,3,3,8,14
11213,10472,7,12,19,38
11213,10473,6,3,12,21
11213,10474,0,0,1,1
11213,10475,2,4,8,14
11213,11001,1,2,1,4
11213,11004,1,3,7,11
11213,11005,0,0,1,1
11213,11040,1,0,0,1
11213,11101,1,6,14,21
11213,11102,0,3,1,4
11213,11103,1,2,4,7
11213,11104,6,7,23,36
11213,11105,0,0,6,6
11213,11106,0,0,5,5
11213,11109,0,0,1,1
11213,11201,9,19,46,74
11213,11203,75,101,158,334
11213,11204,10,15,28,53
11213,11205,9,14,31,54
11213,11206,19,52,43,114
11213,11207,55,90,80,225
11213,11208,45,98,81,224
11213,11209,8,18,26,52
11213,11210,24,52,87,163
11213,11211,18,16,28,62
11213,11212,57,121,93,271
11213,11213,406,420,236,1062
11213,11214,13,13,21,47
11213,11215,10,13,47,70
11213,11216,24,71,71,166
11213,11217,3,14,26,43
11213,11218,23,25,59,107
11213,11219,19,36,14,69
11213,11220,17,19,24,60
11213,11221,26,61,69,156
11213,11222,4,7,29,40
11213,11223,14,19,19,52
11213,11224,3,8,22,33
11213,11225,123,153,128,404
11213,11226,39,101,98,238
11213,11228,6,6,10,22
11213,11229,9,32,28,69
11213,11230,20,59,55,134
11213,11231,13,16,17,46
11213,11232,8,6,16,30
11213,11233,28,86,95,209
11213,11234,50,94,119,263
11213,11235,12,19,29,60
11213,11236,43,83,178,304
11213,11237,20,20,24,64
11213,11238,11,27,127,165
11213,11239,5,6,11,22
11213,11354,3,10,13,26
11213,11355,6,12,9,27
11213,11356,2,3,2,7
11213,11357,3,3,4,10
11213,11358,2,4,7,13
11213,11360,0,2,2,4
11213,11361,0,5,10,15
11213,11362,3,1,5,9
11213,11363,0,1,2,3
11213,11364,4,8,11,23
11213,11365,5,7,10,22
11213,11366,0,3,8,11
11213,11367,1,5,8,14
11213,11368,5,10,12,27
11213,11369,2,4,7,13
11213,11370,4,3,7,14
11213,11372,1,5,9,15
11213,11373,7,15,16,38
11213,11374,4,7,9,20
11213,11375,5,2,25,32
11213,11377,9,21,23,53
11213,11378,12,20,18,50
11213,11379,4,13,21,38
11213,11385,12,36,38,86
11213,11411,0,6,8,14
11213,11412,3,11,11,25
11213,11413,3,6,29,38
11213,11414,0,7,12,19
11213,11415,5,4,6,15
11213,11416,0,8,10,18
11213,11417,4,4,15,23
11213,11418,6,14,11,31
11213,11419,5,9,20,34
11213,11420,6,9,35,50
11213,11421,6,8,11,25
11213,11422,0,10,24,34
11213,11423,6,6,19,31
11213,11426,2,2,10,14
11213,11427,1,5,9,15
11213,11428,0,6,9,15
11213,11429,1,7,21,29
11213,11432,3,12,17,32
11213,11433,4,7,16,27
11213,11434,11,14,30,55
11213,11435,4,8,22,34
11213,11436,0,1,7,8
11213,11691,10,19,17,46
11213,11692,2,8,12,22
11213,11693,1,6,10,17
11213,11694,4,7,15,26
11213,11697,0,3,7,10
11214,10001,4,7,4,15
11214,10002,31,20,10,61
11214,10003,4,12,9,25
11214,10004,1,2,0,3
11214,10005,2,0,1,3
11214,10006,0,0,2,2
11214,10007,3,2,2,7
11214,10009,12,12,8,32
11214,10010,1,1,7,9
11214,10011,3,5,10,18
11214,10012,3,1,11,15
11214,10013,2,9,4,15
11214,10014,1,3,6,10
11214,10016,4,0,17,21
11214,10017,1,1,1,3
11214,10018,1,0,1,2
11214,10019,2,2,7,11
11214,10021,2,1,7,10
11214,10022,0,2,6,8
11214,10023,2,4,6,12
11214,10024,1,4,3,8
11214,10025,4,9,23,36
11214,10026,3,5,7,15
11214,10027,16,15,7,38
11214,10028,3,0,2,5
11214,10029,11,26,13,50
11214,10030,5,3,7,15
11214,10031,5,12,8,25
11214,10032,5,9,6,20
11214,10033,7,11,9,27
11214,10034,2,9,7,18
11214,10035,2,8,3,13
11214,10036,1,1,1,3
11214,10037,2,9,3,14
11214,10038,5,0,7,12
11214,10039,1,7,3,11
11214,10040,6,9,3,18
11214,10044,0,2,3,5
11214,10065,1,2,3,6
11214,10069,0,0,2,2
11214,10075,0,0,2,2
11214,10128,4,2,11,17
11214,10162,0,0,2,2
11214,10280,2,0,0,2
11214,10282,0,0,1,1
11214,10301,21,33,61,115
11214,10302,15,14,17,46
11214,10303,25,30,21,76
11214,10304,53,40,52,145
11214,10305,54,63,62,179
11214,10306,67,67,95,229
11214,10307,8,15,18,41
11214,10308,8,30,47,85
11214,10309,17,31,53,101
11214,10310,12,16,25,53
11214,10312,34,55,102,191
11214,10314,64,111,140,315
11214,10451,6,5,5,16
11214,10452,12,21,14,47
11214,10453,11,19,9,39
11214,10454,2,10,2,14
11214,10455,3,10,2,15
11214,10456,10,23,9,42
11214,10457,13,17,5,35
11214,10458,6,13,6,25
11214,10459,6,11,4,21
11214,10460,10,12,5,27
11214,10461,9,5,9,23
11214,10462,12,9,8,29
11214,10463,4,17,9,30
11214,10464,1,1,1,3
11214,10465,5,7,11,23
11214,10466,10,14,11,35
11214,10467,12,19,17,48
11214,10468,11,17,10,38
11214,10469,7,17,15,39
11214,10470,6,5,5,16
11214,10471,2,1,3,6
11214,10472,10,12,8,30
11214,10473,12,10,9,31
11214,10475,4,5,15,24
11214,11001,1,1,2,4
11214,11003,0,0,1,1
11214,11004,3,2,2,7
11214,11005,0,1,0,1
11214,11040,1,2,3,6
11214,11101,6,7,5,18
11214,11102,3,5,8,16
11214,11103,7,7,5,19
11214,11104,2,6,8,16
11214,11105,2,7,6,15
11214,11106,5,5,14,24
11214,11109,0,0,2,2
11214,11201,11,6,17,34
11214,11203,50,128,69,247
11214,11204,249,250,111,610
11214,11205,5,9,19,33
11214,11206,26,29,23,78
11214,11207,24,66,34,124
11214,11208,31,57,43,131
11214,11209,72,90,115,277
11214,11210,64,113,76,253
11214,11211,23,18,18,59
11214,11212,43,76,43,162
11214,11213,15,38,31,84
11214,11214,792,801,300,1893
11214,11215,35,33,53,121
11214,11216,16,28,17,61
11214,11217,11,10,20,41
11214,11218,37,85,60,182
11214,11219,140,105,40,285
11214,11220,160,135,56,351
11214,11221,14,25,18,57
11214,11222,11,8,11,30
11214,11223,219,246,122,587
11214,11224,111,161,99,371
11214,11225,23,47,29,99
11214,11226,71,153,74,298
11214,11228,140,142,121,403
11214,11229,141,176,143,460
11214,11230,111,160,125,396
11214,11231,12,27,36,75
11214,11232,32,20,21,73
11214,11233,24,41,35,100
11214,11234,110,176,163,449
11214,11235,169,213,158,540
11214,11236,89,162,115,366
11214,11237,9,15,8,32
11214,11238,10,22,27,59
11214,11239,3,4,8,15
11214,11354,17,12,4,33
11214,11355,17,26,13,56
11214,11356,5,6,4,15
11214,11357,5,9,4,18
11214,11358,6,8,4,18
11214,11360,5,6,4,15
11214,11361,5,7,4,16
11214,11362,3,3,4,10
11214,11363,1,3,2,6
11214,11364,5,11,15,31
11214,11365,8,12,9,29
11214,11366,2,1,3,6
11214,11367,10,6,15,31
11214,11368,25,15,18,58
11214,11369,7,12,7,26
11214,11370,12,8,6,26
11214,11372,6,22,12,40
11214,11373,21,11,11,43
11214,11374,10,9,15,34
11214,11375,13,19,31,63
11214,11377,18,28,16,62
11214,11378,10,10,11,31
11214,11379,4,5,12,21
11214,11385,5,28,49,82
11214,11411,2,8,2,12
11214,11412,5,13,10,28
11214,11413,9,13,14,36
11214,11414,6,11,6,23
11214,11415,6,5,6,17
11214,11416,5,1,6,12
11214,11417,5,10,23,38
11214,11418,14,13,10,37
11214,11419,12,18,10,40
11214,11420,6,17,18,41
11214,11421,8,10,12,30
11214,11422,3,12,8,23
11214,11423,11,14,9,34
11214,11426,3,6,2,11
11214,11427,7,7,10,24
11214,11428,9,6,5,20
11214,11429,1,10,10,21
11214,11432,18,19,11,48
11214,11433,9,11,8,28
11214,11434,11,14,22,47
11214,11435,12,21,14,47
11214,11436,3,1,4,8
11214,11691,26,47,20,93
11214,11692,12,11,10,33
11214,11693,3,14,10,27
11214,11694,11,18,21,50
11214,11697,1,3,5,9
11215,10001,10,8,15,33
11215,10002,44,59,45,148
11215,10003,22,30,48,100
11215,10004,5,2,8,15
11215,10005,2,1,5,8
11215,10006,0,0,4,4
11215,10007,5,2,8,15
11215,10009,40,36,41,117
11215,10010,6,8,23,37
11215,10011,22,21,23,66
11215,10012,13,10,21,44
11215,10013,3,10,15,28
11215,10014,15,11,12,38
11215,10016,6,14,33,53
11215,10017,6,5,12,23
11215,10018,2,5,9,16
11215,10019,15,14,21,50
11215,10021,6,5,17,28
11215,10022,3,9,22,34
11215,10023,6,14,13,33
11215,10024,13,2,18,33
11215,10025,27,22,24,73
11215,10026,17,11,15,43
11215,10027,11,24,18,53
11215,10028,7,3,19,29
11215,10029,16,21,22,59
11215,10030,10,11,6,27
11215,10031,17,19,13,49
11215,10032,10,21,15,46
11215,10033,11,21,13,45
11215,10034,8,15,9,32
11215,10035,10,11,8,29
11215,10036,4,13,14,31
11215,10037,7,3,3,13
11215,10038,6,19,21,46
11215,10039,11,9,13,33
11215,10040,10,18,12,40
11215,10044,0,1,3,4
11215,10065,2,3,12,17
11215,10069,1,0,2,3
11215,10075,3,3,12,18
11215,10128,10,9,33,52
11215,10162,1,1,1,3
11215,10280,3,0,2,5
11215,10282,0,1,1,2
11215,10301,24,33,53,110
11215,10302,6,4,17,27
11215,10303,20,26,42,88
11215,10304,29,43,75,147
11215,10305,34,49,85,168
11215,10306,31,46,86,163
11215,10307,1,6,18,25
11215,10308,10,15,39,64
11215,10309,9,16,35,60
11215,10310,11,22,52,85
11215,10312,27,30,87,144
11215,10314,51,64,133,248
11215,10451,8,19,6,33
11215,10452,24,41,22,87
11215,10453,15,30,11,56
11215,10454,5,8,5,18
11215,10455,5,16,6,27
11215,10456,21,27,22,70
11215,10457,8,30,14,52
11215,10458,15,36,13,64
11215,10459,13,12,8,33
11215,10460,9,15,14,38
11215,10461,8,18,17,43
11215,10462,11,26,9,46
11215,10463,8,20,26,54
11215,10464,0,0,1,1
11215,10465,1,10,12,23
11215,10466,7,27,18,52
11215,10467,8,31,15,54
11215,10468,8,31,13,52
11215,10469,4,16,15,35
11215,10470,2,4,3,9
11215,10471,1,8,7,16
11215,10472,10,15,13,38
11215,10473,9,17,13,39
11215,10474,0,3,5,8
11215,10475,2,9,18,29
11215,11001,0,1,1,2
11215,11004,4,7,5,16
11215,11005,1,2,0,3
11215,11040,0,0,1,1
11215,11101,12,12,25,49
11215,11102,10,7,23,40
11215,11103,8,12,16,36
11215,11104,21,19,28,68
11215,11105,11,16,15,42
11215,11106,12,13,15,40
11215,11109,2,1,4,7
11215,11201,59,58,99,216
11215,11203,63,170,189,422
11215,11204,96,183,130,409
11215,11205,32,60,70,162
11215,11206,80,100,63,243
11215,11207,95,137,107,339
11215,11208,84,147,89,320
11215,11209,104,200,286,590
11215,11210,86,122,145,353
11215,11211,47,80,100,227
11215,11212,87,127,114,328
11215,11213,67,133,135,335
11215,11214,111,180,171,462
11215,11215,356,482,742,1580
11215,11216,68,94,120,282
11215,11217,61,100,146,307
11215,11218,197,244,284,725
11215,11219,95,146,79,320
11215,11220,200,318,191,709
11215,11221,92,108,84,284
11215,11222,31,59,55,145
11215,11223,66,135,123,324
11215,11224,53,103,87,243
11215,11225,84,149,143,376
11215,11226,149,256,258,663
11215,11228,49,99,141,289
11215,11229,88,128,175,391
11215,11230,96,174,203,473
11215,11231,72,81,79,232
11215,11232,99,172,108,379
11215,11233,60,150,119,329
11215,11234,106,151,276,533
11215,11235,84,126,167,377
11215,11236,96,179,223,498
11215,11237,31,65,29,125
11215,11238,60,87,155,302
11215,11239,14,13,31,58
11215,11354,16,12,22,50
11215,11355,9,31,31,71
11215,11356,6,6,8,20
11215,11357,3,9,14,26
11215,11358,6,18,11,35
11215,11360,6,2,6,14
11215,11361,5,9,9,23
11215,11362,4,8,4,16
11215,11363,1,1,1,3
11215,11364,6,8,15,29
11215,11365,7,11,15,33
11215,11366,2,6,10,18
11215,11367,10,8,18,36
11215,11368,34,58,29,121
11215,11369,16,17,11,44
11215,11370,9,17,10,36
11215,11372,20,38,19,77
11215,11373,17,68,42,127
11215,11374,12,11,26,49
11215,11375,21,8,37,66
11215,11377,59,82,93,234
11215,11378,28,26,43,97
11215,11379,16,35,39,90
11215,11385,67,102,87,256
11215,11411,4,9,12,25
11215,11412,9,21,13,43
11215,11413,9,24,22,55
11215,11414,6,11,13,30
11215,11415,9,14,8,31
11215,11416,4,17,16,37
11215,11417,7,11,18,36
11215,11418,11,18,20,49
11215,11419,18,28,32,78
11215,11420,9,37,36,82
11215,11421,9,30,14,53
11215,11422,5,17,24,46
11215,11423,8,10,14,32
11215,11426,2,9,11,22
11215,11427,2,9,9,20
11215,11428,4,12,10,26
11215,11429,4,14,15,33
11215,11430,0,0,1,1
11215,11432,14,21,32,67
11215,11433,15,16,21,52
11215,11434,14,29,32,75
11215,11435,9,16,25,50
11215,11436,4,4,11,19
11215,11691,29,26,46,101
11215,11692,7,19,13,39
11215,11693,3,8,13,24
11215,11694,12,29,51,92
11215,11697,2,5,17,24
11216,10001,1,2,4,7
11216,10002,23,15,10,48
11216,10003,3,5,12,20
11216,10004,2,2,3,7
11216,10006,0,0,1,1
11216,10007,0,1,2,3
11216,10009,3,10,20,33
11216,10010,1,1,5,7
11216,10011,7,2,10,19
11216,10012,2,2,7,11
11216,10013,2,5,5,12
11216,10014,1,4,7,12
11216,10016,2,2,3,7
11216,10017,2,1,2,5
11216,10018,0,2,4,6
11216,10019,1,4,5,10
11216,10021,1,2,3,6
11216,10022,1,2,2,5
11216,10023,0,2,6,8
11216,10024,3,2,6,11
11216,10025,6,3,18,27
11216,10026,4,13,4,21
11216,10027,10,10,9,29
11216,10028,0,1,3,4
11216,10029,5,4,7,16
11216,10030,6,5,2,13
11216,10031,6,8,8,22
11216,10032,4,8,9,21
11216,10033,4,4,7,15
11216,10034,1,3,3,7
11216,10035,2,7,6,15
11216,10036,0,1,7,8
11216,10037,3,1,2,6
11216,10038,4,2,3,9
11216,10039,1,8,3,12
11216,10040,1,6,8,15
11216,10044,1,3,2,6
11216,10065,1,2,0,3
11216,10075,0,0,1,1
11216,10128,0,0,5,5
11216,10280,1,0,3,4
11216,10282,0,0,1,1
11216,10301,2,2,6,10
11216,10302,1,4,5,10
11216,10303,5,4,7,16
11216,10304,4,5,7,16
11216,10305,3,1,2,6
11216,10306,2,4,5,11
11216,10308,0,2,5,7
11216,10309,1,0,7,8
11216,10310,0,8,1,9
11216,10312,3,2,10,15
11216,10314,4,5,5,14
11216,10451,3,9,4,16
11216,10452,4,14,5,23
11216,10453,6,16,7,29
11216,10454,1,4,1,6
11216,10455,3,5,5,13
11216,10456,9,15,12,36
11216,10457,6,10,5,21
11216,10458,6,11,8,25
11216,10459,3,10,7,20
11216,10460,4,8,5,17
11216,10461,2,3,2,7
11216,10462,6,9,12,27
11216,10463,2,6,4,12
11216,10464,1,0,0,1
11216,10465,1,2,5,8
11216,10466,7,11,7,25
11216,10467,7,14,5,26
11216,10468,3,10,8,21
11216,10469,6,14,4,24
11216,10470,1,3,2,6
11216,10471,2,1,2,5
11216,10472,7,9,12,28
11216,10473,3,7,7,17
11216,10474,0,4,0,4
11216,10475,2,4,0,6
11216,11001,0,0,1,1
11216,11004,1,5,0,6
11216,11005,0,0,2,2
11216,11101,3,7,10,20
11216,11102,1,5,4,10
11216,11103,7,3,7,17
11216,11104,2,5,5,12
11216,11105,2,7,12,21
11216,11106,3,6,12,21
11216,11109,1,0,2,3
11216,11201,12,21,38,71
11216,11203,38,74,40,152
11216,11204,12,12,10,34
11216,11205,26,38,25,89
11216,11206,45,44,31,120
11216,11207,68,56,46,170
11216,11208,59,76,35,170
11216,11209,19,26,20,65
11216,11210,35,35,35,105
11216,11211,20,19,33,72
11216,11212,37,96,46,179
11216,11213,57,78,55,190
11216,11214,14,13,12,39
11216,11215,18,14,37,69
11216,11216,115,196,119,430
11216,11217,11,9,30,50
11216,11218,21,26,30,77
11216,11219,17,24,13,54
11216,11220,50,41,15,106
11216,11221,60,87,88,235
11216,11222,20,15,11,46
11216,11223,8,9,18,35
11216,11224,6,1,5,12
11216,11225,31,62,45,138
11216,11226,36,93,43,172
11216,11228,9,12,12,33
11216,11229,11,12,16,39
11216,11230,16,28,19,63
11216,11231,8,7,13,28
11216,11232,11,12,11,34
11216,11233,42,71,89,202
11216,11234,29,61,38,128
11216,11235,10,3,13,26
11216,11236,40,71,46,157
11216,11237,18,22,15,55
11216,11238,32,44,77,153
11216,11239,3,8,11,22
11216,11354,4,4,2,10
11216,11355,12,3,6,21
11216,11356,1,1,1,3
11216,11357,3,2,0,5
11216,11358,3,3,5,11
11216,11360,1,0,2,3
11216,11361,3,3,3,9
11216,11362,2,1,1,4
11216,11363,2,1,2,5
11216,11364,2,2,6,10
11216,11365,1,1,6,8
11216,11366,0,1,2,3
11216,11367,3,2,5,10
11216,11368,7,12,7,26
11216,11369,3,4,2,9
11216,11370,5,4,0,9
11216,11372,6,12,6,24
11216,11373,10,14,10,34
11216,11374,3,0,5,8
11216,11375,5,4,11,20
11216,11377,16,33,24,73
11216,11378,7,13,16,36
11216,11379,7,10,14,31
11216,11385,23,47,35,105
11216,11411,1,3,3,7
11216,11412,5,7,7,19
11216,11413,4,5,14,23
11216,11414,2,4,9,15
11216,11415,1,4,7,12
11216,11416,4,9,7,20
11216,11417,4,9,6,19
11216,11418,3,17,10,30
11216,11419,8,17,5,30
11216,11420,11,11,15,37
11216,11421,8,14,6,28
11216,11422,4,5,8,17
11216,11423,6,1,5,12
11216,11426,1,1,1,3
11216,11427,1,2,6,9
11216,11428,2,6,3,11
11216,11429,5,8,1,14
11216,11430,0,0,1,1
11216,11432,9,9,9,27
11216,11433,4,4,7,15
11216,11434,15,15,20,50
11216,11435,7,14,9,30
11216,11436,4,2,4,10
11216,11691,9,20,13,42
11216,11692,11,9,6,26
11216,11693,2,1,1,4
11216,11694,4,6,5,15
11216,11697,1,3,1,5
11217,10001,9,7,14,30
11217,10002,43,40,67,150
11217,10003,16,21,37,74
11217,10004,6,3,7,16
11217,10005,1,1,6,8
11217,10006,3,0,2,5
11217,10007,2,1,6,9
11217,10009,43,17,43,103
11217,10010,4,8,25,37
11217,10011,18,25,37,80
11217,10012,10,3,18,31
11217,10013,15,9,22,46
11217,10014,9,11,26,46
11217,10016,7,14,38,59
11217,10017,0,1,12,13
11217,10018,5,2,6,13
11217,10019,16,11,24,51
11217,10021,9,14,20,43
11217,10022,6,5,14,25
11217,10023,10,15,24,49
11217,10024,16,8,24,48
11217,10025,30,29,55,114
11217,10026,17,19,22,58
11217,10027,24,21,35,80
11217,10028,3,6,27,36
11217,10029,25,29,40,94
11217,10030,11,10,11,32
11217,10031,9,19,16,44
11217,10032,19,10,14,43
11217,10033,18,23,18,59
11217,10034,6,12,10,28
11217,10035,14,14,11,39
11217,10036,14,11,27,52
11217,10037,2,4,9,15
11217,10038,14,5,22,41
11217,10039,9,13,13,35
11217,10040,13,10,14,37
11217,10044,2,3,7,12
11217,10065,1,3,15,19
11217,10069,1,0,6,7
11217,10075,6,4,9,19
11217,10128,6,9,40,55
11217,10162,0,1,1,2
11217,10280,0,3,12,15
11217,10282,0,0,3,3
11217,10301,20,20,53,93
11217,10302,11,18,19,48
11217,10303,17,24,46,87
11217,10304,21,35,41,97
11217,10305,26,26,58,110
11217,10306,12,28,84,124
11217,10307,4,11,15,30
11217,10308,6,7,29,42
11217,10309,9,14,54,77
11217,10310,6,17,54,77
11217,10312,18,30,84,132
11217,10314,45,53,143,241
11217,10451,8,22,12,42
11217,10452,22,34,25,81
11217,10453,17,34,31,82
11217,10454,2,7,14,23
11217,10455,8,12,6,26
11217,10456,28,36,30,94
11217,10457,23,29,22,74
11217,10458,20,31,20,71
11217,10459,13,10,10,33
11217,10460,24,18,16,58
11217,10461,8,10,36,54
11217,10462,23,15,42,80
11217,10463,13,19,29,61
11217,10464,1,1,5,7
11217,10465,8,10,21,39
11217,10466,18,9,35,62
11217,10467,23,42,49,114
11217,10468,15,26,36,77
11217,10469,21,19,35,75
11217,10470,3,3,14,20
11217,10471,3,12,10,25
11217,10472,14,23,23,60
11217,10473,9,15,24,48
11217,10474,2,4,5,11
11217,10475,4,16,28,48
11217,11001,0,2,0,2
11217,11004,4,2,8,14
11217,11005,0,1,2,3
11217,11040,1,0,3,4
11217,11101,19,20,31,70
11217,11102,8,16,28,52
11217,11103,27,19,36,82
11217,11104,20,9,20,49
11217,11105,22,25,34,81
11217,11106,24,18,39,81
11217,11109,3,1,7,11
11217,11201,62,62,137,261
11217,11203,126,149,166,441
11217,11204,41,59,58,158
11217,11205,90,71,90,251
11217,11206,107,105,83,295
11217,11207,124,142,126,392
11217,11208,101,142,123,366
11217,11209,72,81,174,327
11217,11210,62,91,154,307
11217,11211,48,61,88,197
11217,11212,184,129,95,408
11217,11213,147,140,104,391
11217,11214,64,80,93,237
11217,11215,112,126,226,464
11217,11216,147,145,147,439
11217,11217,151,194,247,592
11217,11218,104,84,145,333
11217,11219,46,63,51,160
11217,11220,81,132,97,310
11217,11221,117,129,126,372
11217,11222,30,41,79,150
11217,11223,53,69,89,211
11217,11224,46,50,58,154
11217,11225,126,153,143,422
11217,11226,219,231,214,664
11217,11228,32,37,71,140
11217,11229,69,73,129,271
11217,11230,63,87,124,274
11217,11231,45,41,69,155
11217,11232,49,51,50,150
11217,11233,145,130,124,399
11217,11234,103,106,211,420
11217,11235,47,64,105,216
11217,11236,134,147,191,472
11217,11237,42,44,47,133
11217,11238,134,118,176,428
11217,11239,14,35,27,76
11217,11354,13,14,28,55
11217,11355,16,21,31,68
11217,11356,5,2,16,23
11217,11357,7,12,22,41
11217,11358,6,6,18,30
11217,11360,6,0,15,21
11217,11361,5,4,24,33
11217,11362,2,2,11,15
11217,11363,1,0,3,4
11217,11364,4,4,26,34
11217,11365,9,9,25,43
11217,11366,3,1,7,11
11217,11367,0,22,19,41
11217,11368,37,44,49,130
11217,11369,12,17,31,60
11217,11370,11,24,27,62
11217,11371,0,1,0,1
11217,11372,22,24,36,82
11217,11373,30,55,36,121
11217,11374,14,19,47,80
11217,11375,20,23,89,132
11217,11377,54,39,86,179
11217,11378,22,27,50,99
11217,11379,18,30,59,107
11217,11385,64,95,128,287
11217,11411,11,11,20,42
11217,11412,16,17,23,56
11217,11413,11,14,33,58
11217,11414,7,8,37,52
11217,11415,9,8,14,31
11217,11416,16,21,12,49
11217,11417,14,27,36,77
11217,11418,11,28,39,78
11217,11419,25,25,28,78
11217,11420,33,25,52,110
11217,11421,20,27,45,92
11217,11422,13,10,42,65
11217,11423,13,13,22,48
11217,11426,3,3,17,23
11217,11427,5,6,17,28
11217,11428,10,4,11,25
11217,11429,7,11,23,41
11217,11430,0,1,0,1
11217,11432,27,20,32,79
11217,11433,15,18,19,52
11217,11434,16,26,58,100
11217,11435,12,17,30,59
11217,11436,5,9,6,20
11217,11691,34,43,51,128
11217,11692,14,17,21,52
11217,11693,6,6,20,32
11217,11694,11,10,26,47
11217,11697,2,6,9,17
11218,10001,6,5,2,13
11218,10002,25,45,18,88
11218,10003,16,10,14,40
11218,10004,3,3,8,14
11218,10005,0,1,4,5
11218,10007,1,0,2,3
11218,10009,25,26,9,60
11218,10010,1,2,2,5
11218,10011,8,13,11,32
11218,10012,2,10,3,15
11218,10013,10,13,10,33
11218,10014,6,6,5,17
11218,10016,3,4,3,10
11218,10017,0,2,3,5
11218,10018,1,1,1,3
11218,10019,3,10,4,17
11218,10021,0,7,3,10
11218,10022,3,2,5,10
11218,10023,9,11,6,26
11218,10024,2,10,8,20
11218,10025,15,20,11,46
11218,10026,33,33,1,67
11218,10027,40,26,12,78
11218,10028,2,7,4,13
11218,10029,38,49,9,96
11218,10030,9,20,5,34
11218,10031,35,29,7,71
11218,10032,32,43,13,88
11218,10033,18,23,13,54
11218,10034,17,34,10,61
11218,10035,19,16,3,38
11218,10036,0,0,4,4
11218,10037,8,14,5,27
11218,10038,8,3,8,19
11218,10039,23,16,5,44
11218,10040,15,15,6,36
11218,10044,2,1,1,4
11218,10065,1,0,6,7
11218,10069,1,0,1,2
11218,10075,0,3,3,6
11218,10128,3,7,10,20
11218,10280,1,1,2,4
11218,10282,0,1,1,2
11218,10301,10,29,22,61
11218,10302,7,13,5,25
11218,10303,15,24,8,47
11218,10304,21,35,17,73
11218,10305,28,42,30,100
11218,10306,17,52,24,93
11218,10307,3,10,10,23
11218,10308,5,15,12,32
11218,10309,7,16,12,35
11218,10310,5,12,15,32
11218,10312,11,30,24,65
11218,10314,25,74,53,152
11218,10451,30,40,4,74
11218,10452,62,88,7,157
11218,10453,66,82,18,166
11218,10454,20,26,5,51
11218,10455,21,39,4,64
11218,10456,78,84,7,169
11218,10457,63,91,10,164
11218,10458,64,64,12,140
11218,10459,24,42,9,75
11218,10460,36,50,7,93
11218,10461,16,17,7,40
11218,10462,32,42,17,91
11218,10463,27,26,13,66
11218,10464,1,4,1,6
11218,10465,12,13,10,35
11218,10466,44,55,11,110
11218,10467,55,63,13,131
11218,10468,43,56,11,110
11218,10469,30,38,12,80
11218,10470,7,14,3,24
11218,10471,9,6,7,22
11218,10472,38,39,10,87
11218,10473,26,24,18,68
11218,10474,3,15,1,19
11218,10475,14,13,13,40
11218,11001,2,2,6,10
11218,11004,2,6,0,8
11218,11101,7,10,6,23
11218,11102,7,7,8,22
11218,11103,3,6,4,13
11218,11104,4,6,5,15
11218,11105,7,5,1,13
11218,11106,3,10,9,22
11218,11109,1,1,3,5
11218,11201,28,40,26,94
11218,11203,173,237,62,472
11218,11204,323,450,243,1016
11218,11205,32,53,30,115
11218,11206,67,75,38,180
11218,11207,77,114,35,226
11218,11208,86,100,29,215
11218,11209,48,90,66,204
11218,11210,203,339,155,697
11218,11211,63,79,43,185
11218,11212,90,155,38,283
11218,11213,121,162,121,404
11218,11214,123,221,90,434
11218,11215,35,49,66,150
11218,11216,52,46,39,137
11218,11217,20,27,19,66
11218,11218,655,833,327,1815
11218,11219,688,728,294,1710
11218,11220,143,204,74,421
11218,11221,50,83,33,166
11218,11222,24,43,14,81
11218,11223,128,181,100,409
11218,11224,66,113,69,248
11218,11225,94,124,68,286
11218,11226,258,453,119,830
11218,11228,38,83,39,160
11218,11229,134,205,155,494
11218,11230,379,539,333,1251
11218,11231,22,27,23,72
11218,11232,42,69,17,128
11218,11233,50,103,40,193
11218,11234,130,227,182,539
11218,11235,111,181,96,388
11218,11236,138,269,64,471
11218,11237,21,37,9,67
11218,11238,31,44,25,100
11218,11239,12,21,2,35
11218,11354,16,13,9,38
11218,11355,12,16,8,36
11218,11356,9,7,2,18
11218,11357,4,9,3,16
11218,11358,3,3,3,9
11218,11360,3,7,3,13
11218,11361,3,3,1,7
11218,11362,0,1,3,4
11218,11363,0,1,0,1
11218,11364,2,6,2,10
11218,11365,24,23,10,57
11218,11366,3,13,3,19
11218,11367,22,25,14,61
11218,11368,25,43,11,79
11218,11369,2,15,6,23
11218,11370,12,21,6,39
11218,11372,18,20,8,46
11218,11373,32,31,17,80
11218,11374,8,21,18,47
11218,11375,17,34,21,72
11218,11377,21,29,21,71
11218,11378,6,20,10,36
11218,11379,6,10,12,28
11218,11385,27,46,35,108
11218,11411,6,17,6,29
11218,11412,16,23,8,47
11218,11413,11,22,8,41
11218,11414,7,12,8,27
11218,11415,8,7,9,24
11218,11416,12,16,5,33
11218,11417,8,20,11,39
11218,11418,16,14,6,36
11218,11419,19,27,17,63
11218,11420,12,31,16,59
11218,11421,12,24,8,44
11218,11422,7,11,8,26
11218,11423,12,23,10,45
11218,11426,5,8,6,19
11218,11427,12,8,9,29
11218,11428,13,8,5,26
11218,11429,13,14,11,38
11218,11432,28,41,21,90
11218,11433,14,16,9,39
11218,11434,24,30,21,75
11218,11435,17,36,18,71
11218,11436,7,9,5,21
11218,11691,36,52,48,136
11218,11692,12,21,7,40
11218,11693,8,9,6,23
11218,11694,7,20,20,47
11218,11697,3,2,6,11
11219,10001,7,11,13,31
11219,10002,68,87,32,187
11219,10003,27,28,27,82
11219,10004,3,5,9,17
11219,10005,0,3,8,11
11219,10006,0,2,2,4
11219,10007,3,1,14,18
11219,10009,22,35,42,99
11219,10010,3,4,21,28
11219,10011,11,18,21,50
11219,10012,12,22,10,44
11219,10013,15,28,18,61
11219,10014,8,9,37,54
11219,10016,6,5,29,40
11219,10017,0,3,8,11
11219,10018,2,4,2,8
11219,10019,8,10,26,44
11219,10021,3,6,21,30
11219,10022,1,7,12,20
11219,10023,7,11,21,39
11219,10024,13,14,22,49
11219,10025,31,41,38,110
11219,10026,29,24,14,67
11219,10027,36,38,27,101
11219,10028,4,7,20,31
11219,10029,50,77,31,158
11219,10030,27,24,15,66
11219,10031,42,48,17,107
11219,10032,44,57,14,115
11219,10033,43,53,16,112
11219,10034,26,34,14,74
11219,10035,21,21,12,54
11219,10036,4,12,12,28
11219,10037,8,15,11,34
11219,10038,12,15,10,37
11219,10039,11,21,6,38
11219,10040,41,38,17,96
11219,10044,2,1,8,11
11219,10065,5,6,12,23
11219,10069,1,1,0,2
11219,10075,1,3,11,15
11219,10128,7,9,23,39
11219,10162,0,1,1,2
11219,10280,5,4,18,27
11219,10282,0,1,5,6
11219,10301,39,49,120,208
11219,10302,21,24,36,81
11219,10303,31,50,71,152
11219,10304,86,99,86,271
11219,10305,74,124,164,362
11219,10306,67,89,165,321
11219,10307,15,17,49,81
11219,10308,27,18,75,120
11219,10309,34,49,93,176
11219,10310,25,26,65,116
11219,10312,53,64,193,310
11219,10314,135,166,356,657
11219,10451,65,76,11,152
11219,10452,100,141,13,254
11219,10453,105,134,24,263
11219,10454,41,46,10,97
11219,10455,33,38,8,79
11219,10456,110,135,19,264
11219,10457,82,128,13,223
11219,10458,101,111,34,246
11219,10459,45,53,13,111
11219,10460,58,81,14,153
11219,10461,26,31,17,74
11219,10462,44,58,35,137
11219,10463,51,68,34,153
11219,10464,3,2,1,6
11219,10465,13,27,16,56
11219,10466,81,40,35,156
11219,10467,71,101,34,206
11219,10468,59,126,33,218
11219,10469,39,49,27,115
11219,10470,19,10,7,36
11219,10471,18,12,14,44
11219,10472,58,57,21,136
11219,10473,46,49,13,108
11219,10474,13,12,4,29
11219,10475,20,29,27,76
11219,11001,0,3,5,8
11219,11004,15,18,8,41
11219,11005,3,1,0,4
11219,11040,2,2,0,4
11219,11101,5,11,13,29
11219,11102,8,10,12,30
11219,11103,7,12,18,37
11219,11104,2,15,15,32
11219,11105,7,12,22,41
11219,11106,11,19,14,44
11219,11109,1,1,0,2
11219,11201,51,72,111,234
11219,11203,235,386,289,910
11219,11204,754,821,432,2007
11219,11205,71,105,63,239
11219,11206,133,147,57,337
11219,11207,101,187,79,367
11219,11208,100,219,69,388
11219,11209,138,211,411,760
11219,11210,284,381,340,1005
11219,11211,182,167,68,417
11219,11212,136,268,116,520
11219,11213,156,253,141,550
11219,11214,395,529,343,1267
11219,11215,61,77,219,357
11219,11216,69,101,76,246
11219,11217,23,64,116,203
11219,11218,608,543,314,1465
11219,11219,2322,2069,991,5382
11219,11220,379,620,327,1326
11219,11221,83,109,60,252
11219,11222,54,72,32,158
11219,11223,229,380,232,841
11219,11224,138,239,166,543
11219,11225,148,219,154,521
11219,11226,307,530,274,1111
11219,11228,255,333,269,857
11219,11229,273,425,353,1051
11219,11230,487,610,485,1582
11219,11231,32,71,58,161
11219,11232,74,107,69,250
11219,11233,77,143,78,298
11219,11234,214,360,529,1103
11219,11235,235,431,326,992
11219,11236,209,398,346,953
11219,11237,35,62,28,125
11219,11238,33,77,100,210
11219,11239,14,44,17,75
11219,11354,76,77,23,176
11219,11355,97,129,18,244
11219,11356,19,32,10,61
11219,11357,40,26,15,81
11219,11358,36,49,16,101
11219,11360,14,17,10,41
11219,11361,7,16,13,36
11219,11362,8,11,16,35
11219,11363,4,4,4,12
11219,11364,16,25,28,69
11219,11365,34,41,31,106
11219,11366,9,8,11,28
11219,11367,34,38,43,115
11219,11368,69,104,31,204
11219,11369,15,41,13,69
11219,11370,27,34,15,76
11219,11372,31,53,17,101
11219,11373,65,107,30,202
11219,11374,20,31,26,77
11219,11375,36,50,71,157
11219,11377,29,61,30,120
11219,11378,25,25,27,77
11219,11379,14,22,31,67
11219,11385,42,81,56,179
11219,11411,14,24,13,51
11219,11412,21,38,27,86
11219,11413,38,53,29,120
11219,11414,11,24,19,54
11219,11415,14,17,21,52
11219,11416,8,26,19,53
11219,11417,18,25,26,69
11219,11418,24,28,36,88
11219,11419,30,56,29,115
11219,11420,19,52,29,100
11219,11421,25,35,26,86
11219,11422,22,34,40,96
11219,11423,29,36,21,86
11219,11426,12,18,13,43
11219,11427,17,14,17,48
11219,11428,12,15,11,38
11219,11429,16,31,41,88
11219,11430,1,0,0,1
11219,11432,47,58,48,153
11219,11433,26,27,23,76
11219,11434,55,44,47,146
11219,11435,35,56,39,130
11219,11436,5,19,13,37
11219,11691,57,86,80,223
11219,11692,18,35,18,71
11219,11693,12,12,20,44
11219,11694,28,30,62,120
11219,11697,1,6,9,16
11220,10001,5,8,7,20
11220,10002,105,102,78,285
11220,10003,17,9,32,58
11220,10004,3,10,9,22
11220,10005,3,0,10,13
11220,10006,0,0,2,2
11220,10007,1,2,4,7
11220,10009,24,43,64,131
11220,10010,6,8,32,46
11220,10011,9,11,19,39
11220,10012,12,20,22,54
11220,10013,14,31,25,70
11220,10014,10,8,17,35
11220,10016,3,9,54,66
11220,10017,4,1,24,29
11220,10018,1,1,1,3
11220,10019,8,9,18,35
11220,10021,1,3,21,25
11220,10022,3,4,32,39
11220,10023,4,10,34,48
11220,10024,1,4,23,28
11220,10025,9,18,38,65
11220,10026,6,12,25,43
11220,10027,10,18,27,55
11220,10028,1,2,21,24
11220,10029,23,28,32,83
11220,10030,3,14,15,32
11220,10031,12,26,14,52
11220,10032,19,29,26,74
11220,10033,22,14,32,68
11220,10034,11,17,15,43
11220,10035,9,19,14,42
11220,10036,3,5,12,20
11220,10037,4,9,5,18
11220,10038,16,24,31,71
11220,10039,6,11,8,25
11220,10040,6,21,16,43
11220,10044,1,2,7,10
11220,10065,2,1,13,16
11220,10069,0,0,1,1
11220,10075,1,1,9,11
11220,10128,6,4,22,32
11220,10162,0,0,1,1
11220,10280,0,3,14,17
11220,10282,1,0,2,3
11220,10301,29,50,82,161
11220,10302,13,25,55,93
11220,10303,21,38,56,115
11220,10304,69,77,116,262
11220,10305,86,118,146,350
11220,10306,72,84,183,339
11220,10307,5,8,24,37
11220,10308,21,20,63,104
11220,10309,15,37,74,126
11220,10310,13,28,73,114
11220,10312,30,52,151,233
11220,10314,100,161,244,505
11220,10451,10,27,10,47
11220,10452,24,51,34,109
11220,10453,23,40,26,89
11220,10454,11,21,16,48
11220,10455,8,19,17,44
11220,10456,22,42,30,94
11220,10457,23,39,19,81
11220,10458,26,32,15,73
11220,10459,11,20,17,48
11220,10460,20,17,20,57
11220,10461,5,16,22,43
11220,10462,14,23,31,68
11220,10463,12,22,30,64
11220,10464,1,0,2,3
11220,10465,5,10,20,35
11220,10466,8,18,25,51
11220,10467,23,37,39,99
11220,10468,31,38,25,94
11220,10469,11,16,32,59
11220,10470,2,3,10,15
11220,10471,3,5,7,15
11220,10472,20,20,23,63
11220,10473,13,27,20,60
11220,10474,4,8,2,14
11220,10475,6,10,18,34
11220,11001,0,3,2,5
11220,11004,2,4,6,12
11220,11005,2,0,2,4
11220,11040,1,0,2,3
11220,11101,1,11,19,31
11220,11102,5,8,29,42
11220,11103,4,15,15,34
11220,11104,1,13,19,33
11220,11105,3,13,23,39
11220,11106,6,6,23,35
11220,11109,0,1,1,2
11220,11201,26,44,74,144
11220,11203,53,107,156,316
11220,11204,347,346,196,889
11220,11205,37,59,42,138
11220,11206,70,88,76,234
11220,11207,57,119,89,265
11220,11208,55,95,52,202
11220,11209,176,261,440,877
11220,11210,71,133,155,359
11220,11211,64,68,69,201
11220,11212,82,117,84,283
11220,11213,66,112,111,289
11220,11214,361,415,299,1075
11220,11215,40,80,156,276
11220,11216,32,46,83,161
11220,11217,20,46,67,133
11220,11218,95,127,182,404
11220,11219,417,413,160,990
11220,11220,1322,1276,459,3057
11220,11221,40,91,74,205
11220,11222,18,26,32,76
11220,11223,215,260,187,662
11220,11224,65,108,109,282
11220,11225,46,61,102,209
11220,11226,80,207,180,467
11220,11228,258,285,222,765
11220,11229,154,166,210,530
11220,11230,124,164,190,478
11220,11231,21,46,53,120
11220,11232,115,169,86,370
11220,11233,40,89,80,209
11220,11234,103,157,288,548
11220,11235,93,141,196,430
11220,11236,79,164,182,425
11220,11237,20,39,36,95
11220,11238,27,42,84,153
11220,11239,6,22,13,41
11220,11354,29,26,35,90
11220,11355,66,46,41,153
11220,11356,9,14,12,35
11220,11357,19,13,17,49
11220,11358,14,19,19,52
11220,11360,7,7,9,23
11220,11361,11,10,22,43
11220,11362,8,5,15,28
11220,11363,5,0,8,13
11220,11364,16,21,23,60
11220,11365,11,11,26,48
11220,11366,3,6,6,15
11220,11367,17,19,29,65
11220,11368,22,30,43,95
11220,11369,3,9,17,29
11220,11370,6,15,15,36
11220,11372,11,31,31,73
11220,11373,33,34,43,110
11220,11374,5,12,41,58
11220,11375,9,22,77,108
11220,11377,15,34,56,105
11220,11378,13,9,39,61
11220,11379,4,18,31,53
11220,11385,32,40,74,146
11220,11411,3,13,15,31
11220,11412,5,15,18,38
11220,11413,7,18,25,50
11220,11414,4,9,15,28
11220,11415,3,8,7,18
11220,11416,5,13,13,31
11220,11417,2,14,21,37
11220,11418,9,23,19,51
11220,11419,10,31,25,66
11220,11420,8,20,25,53
11220,11421,6,36,20,62
11220,11422,4,13,28,45
11220,11423,4,15,23,42
11220,11426,3,4,7,14
11220,11427,3,8,18,29
11220,11428,3,9,15,27
11220,11429,3,5,30,38
11220,11432,7,24,52,83
11220,11433,3,12,28,43
11220,11434,9,23,41,73
11220,11435,13,20,32,65
11220,11436,0,3,13,16
11220,11691,30,42,44,116
11220,11692,8,12,26,46
11220,11693,7,10,8,25
11220,11694,11,13,25,49
11220,11697,6,2,8,16
11221,10001,4,2,8,14
11221,10002,13,22,25,60
11221,10003,3,10,14,27
11221,10004,1,2,2,5
11221,10005,0,0,3,3
11221,10006,1,0,1,2
11221,10007,1,2,2,5
11221,10009,9,5,17,31
11221,10010,3,8,6,17
11221,10011,3,2,15,20
11221,10012,2,1,5,8
11221,10013,3,4,3,10
11221,10014,3,6,4,13
11221,10016,6,4,16,26
11221,10017,4,1,6,11
11221,10018,1,0,3,4
11221,10019,5,3,14,22
11221,10021,1,4,14,19
11221,10022,2,2,10,14
11221,10023,1,2,5,8
11221,10024,1,2,11,14
11221,10025,0,4,12,16
11221,10026,1,2,11,14
11221,10027,2,10,10,22
11221,10028,2,1,8,11
11221,10029,8,11,18,37
11221,10030,6,5,8,19
11221,10031,4,9,11,24
11221,10032,3,9,12,24
11221,10033,4,2,10,16
11221,10034,1,5,6,12
11221,10035,3,3,7,13
11221,10036,4,1,17,22
11221,10037,6,3,6,15
11221,10038,0,2,7,9
11221,10039,4,2,5,11
11221,10040,1,3,8,12
11221,10044,0,1,2,3
11221,10065,0,2,3,5
11221,10075,0,1,5,6
11221,10128,2,7,13,22
11221,10280,0,2,3,5
11221,10282,0,1,1,2
11221,10301,3,9,12,24
11221,10302,1,2,11,14
11221,10303,0,5,11,16
11221,10304,2,5,23,30
11221,10305,1,3,16,20
11221,10306,0,6,32,38
11221,10307,0,4,8,12
11221,10308,0,2,18,20
11221,10309,0,5,10,15
11221,10310,1,1,10,12
11221,10312,6,10,29,45
11221,10314,5,7,24,36
11221,10451,3,9,8,20
11221,10452,5,11,5,21
11221,10453,12,18,19,49
11221,10454,4,11,4,19
11221,10455,2,3,4,9
11221,10456,11,11,13,35
11221,10457,5,11,5,21
11221,10458,12,10,8,30
11221,10459,5,9,9,23
11221,10460,7,15,6,28
11221,10461,1,5,14,20
11221,10462,6,15,25,46
11221,10463,7,9,14,30
11221,10464,0,0,6,6
11221,10465,2,3,17,22
11221,10466,6,21,11,38
11221,10467,12,21,19,52
11221,10468,9,17,16,42
11221,10469,9,13,15,37
11221,10470,6,4,3,13
11221,10471,0,3,7,10
11221,10472,7,10,17,34
11221,10473,4,13,10,27
11221,10474,1,4,2,7
11221,10475,4,13,17,34
11221,11001,0,1,3,4
11221,11004,1,0,12,13
11221,11005,0,1,2,3
11221,11040,1,0,2,3
11221,11101,6,6,17,29
11221,11102,4,11,12,27
11221,11103,6,13,18,37
11221,11104,7,5,22,34
11221,11105,4,10,19,33
11221,11106,3,2,24,29
11221,11109,0,1,1,2
11221,11201,8,14,25,47
11221,11203,59,98,90,247
11221,11204,4,17,23,44
11221,11205,12,27,36,75
11221,11206,71,127,49,247
11221,11207,67,104,76,247
11221,11208,42,102,65,209
11221,11209,11,3,27,41
11221,11210,40,73,42,155
11221,11211,21,28,45,94
11221,11212,42,119,68,229
11221,11213,20,52,39,111
11221,11214,3,11,18,32
11221,11215,8,13,41,62
11221,11216,36,66,74,176
11221,11217,14,15,24,53
11221,11218,15,21,39,75
11221,11219,17,19,18,54
11221,11220,15,26,27,68
11221,11221,115,278,94,487
11221,11222,7,7,24,38
11221,11223,7,10,19,36
11221,11224,7,5,15,27
11221,11225,31,42,42,115
11221,11226,35,102,67,204
11221,11228,2,11,14,27
11221,11229,6,9,28,43
11221,11230,19,50,38,107
11221,11231,10,15,21,46
11221,11232,8,6,16,30
11221,11233,39,107,73,219
11221,11234,27,70,103,200
11221,11235,6,12,25,43
11221,11236,56,87,81,224
11221,11237,27,63,28,118
11221,11238,10,26,51,87
11221,11239,3,9,19,31
11221,11354,6,3,19,28
11221,11355,15,9,15,39
11221,11356,2,4,8,14
11221,11357,2,4,5,11
11221,11358,3,5,6,14
11221,11360,3,3,10,16
11221,11361,1,4,7,12
11221,11362,1,3,9,13
11221,11363,1,1,3,5
11221,11364,1,13,8,22
11221,11365,4,5,12,21
11221,11366,1,3,4,8
11221,11367,4,6,20,30
11221,11368,16,29,29,74
11221,11369,7,17,16,40
11221,11370,1,6,8,15
11221,11371,0,0,1,1
11221,11372,4,9,28,41
11221,11373,12,18,32,62
11221,11374,5,14,17,36
11221,11375,6,13,42,61
11221,11377,19,24,40,83
11221,11378,10,14,25,49
11221,11379,8,16,31,55
11221,11385,39,98,73,210
11221,11411,4,5,19,28
11221,11412,4,11,13,28
11221,11413,6,11,22,39
11221,11414,9,15,20,44
11221,11415,1,4,21,26
11221,11416,9,18,13,40
11221,11417,10,21,11,42
11221,11418,12,10,25,47
11221,11419,12,22,22,56
11221,11420,13,16,35,64
11221,11421,11,25,29,65
11221,11422,5,11,11,27
11221,11423,3,4,6,13
11221,11426,2,2,9,13
11221,11427,3,4,5,12
11221,11428,2,9,14,25
11221,11429,4,6,11,21
11221,11432,4,6,16,26
11221,11433,3,10,14,27
11221,11434,8,20,33,61
11221,11435,7,10,14,31
11221,11436,2,5,8,15
11221,11691,32,26,29,87
11221,11692,17,26,15,58
11221,11693,7,6,4,17
11221,11694,5,13,20,38
11221,11697,1,3,5,9
11222,10001,13,5,7,25
11222,10002,23,44,52,119
11222,10003,17,12,32,61
11222,10004,0,3,2,5
11222,10005,1,0,1,2
11222,10006,0,0,2,2
11222,10007,3,3,4,10
11222,10009,15,36,44,95
11222,10010,5,6,29,40
11222,10011,8,13,32,53
11222,10012,6,7,17,30
11222,10013,8,9,23,40
11222,10014,4,12,21,37
11222,10016,12,5,23,40
11222,10017,10,4,12,26
11222,10018,6,4,6,16
11222,10019,9,10,25,44
11222,10021,4,4,18,26
11222,10022,14,9,19,42
11222,10023,3,8,26,37
11222,10024,4,8,19,31
11222,10025,18,17,26,61
11222,10026,6,11,18,35
11222,10027,16,13,25,54
11222,10028,2,4,27,33
11222,10029,20,20,32,72
11222,10030,7,7,15,29
11222,10031,13,14,9,36
11222,10032,3,10,19,32
11222,10033,8,11,17,36
11222,10034,6,10,9,25
11222,10035,7,11,18,36
11222,10036,12,15,8,35
11222,10037,7,6,13,26
11222,10038,4,4,9,17
11222,10039,3,16,12,31
11222,10040,2,9,12,23
11222,10044,2,6,4,12
11222,10065,6,5,10,21
11222,10069,2,1,3,6
11222,10075,2,3,8,13
11222,10128,12,8,26,46
11222,10162,0,0,2,2
11222,10280,3,4,0,7
11222,10301,7,9,25,41
11222,10302,0,3,15,18
11222,10303,2,3,13,18
11222,10304,1,8,14,23
11222,10305,4,2,28,34
11222,10306,7,14,42,63
11222,10307,2,2,6,10
11222,10308,3,3,18,24
11222,10309,7,6,19,32
11222,10310,0,4,11,15
11222,10312,11,7,38,56
11222,10314,15,31,56,102
11222,10451,6,22,13,41
11222,10452,14,30,19,63
11222,10453,10,15,11,36
11222,10454,6,11,15,32
11222,10455,6,13,15,34
11222,10456,11,21,23,55
11222,10457,3,13,10,26
11222,10458,14,20,26,60
11222,10459,12,19,11,42
11222,10460,5,9,11,25
11222,10461,3,8,15,26
11222,10462,12,14,24,50
11222,10463,10,5,12,27
11222,10464,1,0,2,3
11222,10465,3,7,13,23
11222,10466,3,8,10,21
11222,10467,8,13,25,46
11222,10468,8,16,18,42
11222,10469,5,14,24,43
11222,10470,0,2,7,9
11222,10471,3,2,7,12
11222,10472,8,14,16,38
11222,10473,9,8,19,36
11222,10474,3,6,7,16
11222,10475,6,4,8,18
11222,11001,0,1,1,2
11222,11003,1,0,0,1
11222,11004,5,3,5,13
11222,11005,0,0,2,2
11222,11040,0,1,2,3
11222,11101,24,25,34,83
11222,11102,22,25,41,88
11222,11103,14,23,55,92
11222,11104,13,21,36,70
11222,11105,22,38,52,112
11222,11106,22,19,45,86
11222,11109,0,5,9,14
11222,11201,23,21,50,94
11222,11203,25,49,66,140
11222,11204,16,30,36,82
11222,11205,29,24,60,113
11222,11206,97,136,142,375
11222,11207,40,70,74,184
11222,11208,31,65,71,167
11222,11209,12,27,52,91
11222,11210,13,26,30,69
11222,11211,132,143,198,473
11222,11212,33,50,48,131
11222,11213,28,46,57,131
11222,11214,20,31,39,90
11222,11215,23,30,97,150
11222,11216,43,36,85,164
11222,11217,14,15,47,76
11222,11218,16,22,38,76
11222,11219,24,26,41,91
11222,11220,47,58,52,157
11222,11221,67,115,112,294
11222,11222,267,397,431,1095
11222,11223,14,26,30,70
11222,11224,7,17,19,43
11222,11225,34,41,61,136
11222,11226,22,47,65,134
11222,11228,7,18,30,55
11222,11229,15,19,36,70
11222,11230,22,40,42,104
11222,11231,16,27,40,83
11222,11232,14,19,17,50
11222,11233,44,58,63,165
11222,11234,30,53,84,167
11222,11235,14,19,39,72
11222,11236,29,51,69,149
11222,11237,34,120,94,248
11222,11238,14,36,80,130
11222,11239,1,5,12,18
11222,11354,27,21,23,71
11222,11355,35,30,39,104
11222,11356,9,16,24,49
11222,11357,14,20,42,76
11222,11358,17,22,39,78
11222,11360,2,2,16,20
11222,11361,6,14,27,47
11222,11362,3,8,15,26
11222,11363,1,6,7,14
11222,11364,8,22,25,55
11222,11365,14,19,24,57
11222,11366,3,6,2,11
11222,11367,10,24,18,52
11222,11368,47,69,62,178
11222,11369,21,28,43,92
11222,11370,19,6,25,50
11222,11371,0,1,1,2
11222,11372,19,55,60,134
11222,11373,54,95,81,230
11222,11374,13,31,35,79
11222,11375,23,44,74,141
11222,11377,53,60,98,211
11222,11378,54,70,141,265
11222,11379,27,60,123,210
11222,11385,99,251,298,648
11222,11411,1,5,6,12
11222,11412,8,9,11,28
11222,11413,5,12,20,37
11222,11414,8,9,29,46
11222,11415,9,7,18,34
11222,11416,14,16,25,55
11222,11417,4,7,30,41
11222,11418,17,24,33,74
11222,11419,10,26,46,82
11222,11420,8,8,29,45
11222,11421,13,36,55,104
11222,11422,6,1,11,18
11222,11423,3,11,23,37
11222,11426,0,6,6,12
11222,11427,5,6,17,28
11222,11428,3,5,9,17
11222,11429,5,4,11,20
11222,11430,0,0,1,1
11222,11432,14,23,39,76
11222,11433,8,13,25,46
11222,11434,6,10,29,45
11222,11435,3,19,28,50
11222,11436,3,4,9,16
11222,11691,9,12,19,40
11222,11692,4,8,6,18
11222,11693,3,4,5,12
11222,11694,7,7,13,27
11222,11697,0,3,6,9
11223,10001,4,2,3,9
11223,10002,20,13,14,47
11223,10003,6,8,8,22
11223,10005,0,2,2,4
11223,10006,0,1,1,2
11223,10009,7,12,9,28
11223,10010,2,5,2,9
11223,10011,1,5,4,10
11223,10012,1,2,4,7
11223,10013,5,2,2,9
11223,10014,1,3,4,8
11223,10016,1,3,6,10
11223,10017,0,2,0,2
11223,10019,8,5,11,24
11223,10021,3,3,5,11
11223,10022,0,2,2,4
11223,10023,2,3,11,16
11223,10024,2,5,10,17
11223,10025,7,9,8,24
11223,10026,4,9,9,22
11223,10027,6,8,17,31
11223,10028,3,2,5,10
11223,10029,14,19,6,39
11223,10030,3,5,9,17
11223,10031,6,22,10,38
11223,10032,6,17,12,35
11223,10033,9,22,1,32
11223,10034,5,20,4,29
11223,10035,7,9,7,23
11223,10036,0,3,10,13
11223,10037,4,1,2,7
11223,10038,5,1,4,10
11223,10039,0,3,6,9
11223,10040,6,14,6,26
11223,10044,0,0,1,1
11223,10065,0,0,6,6
11223,10069,1,0,0,1
11223,10075,0,1,3,4
11223,10128,6,2,10,18
11223,10280,0,0,2,2
11223,10301,17,30,32,79
11223,10302,8,11,11,30
11223,10303,2,17,21,40
11223,10304,17,33,20,70
11223,10305,20,51,43,114
11223,10306,32,54,74,160
11223,10307,13,10,19,42
11223,10308,15,20,42,77
11223,10309,15,24,47,86
11223,10310,12,13,17,42
11223,10312,29,51,75,155
11223,10314,55,98,114,267
11223,10451,7,10,8,25
11223,10452,21,23,3,47
11223,10453,22,31,15,68
11223,10454,2,5,5,12
11223,10455,0,5,5,10
11223,10456,19,36,19,74
11223,10457,16,24,16,56
11223,10458,20,31,15,66
11223,10459,4,13,3,20
11223,10460,7,8,5,20
11223,10461,4,17,16,37
11223,10462,15,19,19,53
11223,10463,15,14,18,47
11223,10464,2,1,1,4
11223,10465,8,9,10,27
11223,10466,8,9,11,28
11223,10467,13,21,15,49
11223,10468,10,24,12,46
11223,10469,8,9,9,26
11223,10470,0,6,4,10
11223,10471,2,6,3,11
11223,10472,12,5,15,32
11223,10473,7,13,14,34
11223,10474,4,1,1,6
11223,10475,3,10,11,24
11223,11001,1,1,0,2
11223,11004,2,7,0,9
11223,11005,0,2,0,2
11223,11040,0,0,2,2
11223,11101,2,1,5,8
11223,11102,5,6,7,18
11223,11103,1,6,7,14
11223,11104,1,5,6,12
11223,11105,2,6,10,18
11223,11106,4,9,9,22
11223,11109,1,0,1,2
11223,11201,11,10,27,48
11223,11203,61,98,75,234
11223,11204,185,296,139,620
11223,11205,11,11,12,34
11223,11206,16,20,16,52
11223,11207,29,61,24,114
11223,11208,41,68,43,152
11223,11209,67,114,95,276
11223,11210,102,158,107,367
11223,11211,10,18,18,46
11223,11212,36,74,40,150
11223,11213,21,35,23,79
11223,11214,286,321,176,783
11223,11215,26,33,44,103
11223,11216,17,24,20,61
11223,11217,6,10,22,38
11223,11218,125,217,92,434
11223,11219,114,153,59,326
11223,11220,83,144,56,283
11223,11221,17,34,20,71
11223,11222,3,12,9,24
11223,11223,734,816,441,1991
11223,11224,104,202,108,414
11223,11225,27,42,32,101
11223,11226,62,113,91,266
11223,11228,38,89,64,191
11223,11229,320,490,297,1107
11223,11230,345,476,241,1062
11223,11231,12,17,20,49
11223,11232,23,31,17,71
11223,11233,19,39,27,85
11223,11234,157,174,235,566
11223,11235,330,475,253,1058
11223,11236,77,114,84,275
11223,11237,3,17,19,39
11223,11238,12,23,19,54
11223,11239,9,6,6,21
11223,11354,18,11,11,40
11223,11355,24,7,16,47
11223,11356,2,3,8,13
11223,11357,6,5,9,20
11223,11358,3,4,7,14
11223,11360,2,2,6,10
11223,11361,4,4,9,17
11223,11362,1,1,7,9
11223,11363,1,0,7,8
11223,11364,3,12,10,25
11223,11365,11,18,18,47
11223,11366,4,6,4,14
11223,11367,15,20,12,47
11223,11368,21,30,16,67
11223,11369,3,4,9,16
11223,11370,5,11,7,23
11223,11372,7,9,15,31
11223,11373,19,23,16,58
11223,11374,25,42,19,86
11223,11375,36,59,47,142
11223,11377,8,19,22,49
11223,11378,5,13,16,34
11223,11379,5,11,13,29
11223,11385,20,41,31,92
11223,11411,0,4,4,8
11223,11412,7,3,14,24
11223,11413,2,10,4,16
11223,11414,4,7,4,15
11223,11415,3,10,2,15
11223,11416,7,7,14,28
11223,11417,12,10,11,33
11223,11418,6,18,11,35
11223,11419,11,17,18,46
11223,11420,8,21,20,49
11223,11421,13,6,9,28
11223,11422,3,9,18,30
11223,11423,7,8,10,25
11223,11426,2,6,5,13
11223,11427,3,4,9,16
11223,11428,2,6,7,15
11223,11429,2,10,9,21
11223,11430,0,0,1,1
11223,11432,5,25,18,48
11223,11433,4,6,8,18
11223,11434,12,16,28,56
11223,11435,11,16,25,52
11223,11436,3,5,3,11
11223,11691,21,48,44,113
11223,11692,8,14,12,34
11223,11693,6,20,9,35
11223,11694,8,27,50,85
11223,11697,4,8,24,36
11224,10001,0,2,5,7
11224,10002,6,2,7,15
11224,10003,0,4,9,13
11224,10004,0,1,0,1
11224,10005,0,0,1,1
11224,10007,0,0,2,2
11224,10009,6,4,8,18
11224,10010,1,0,2,3
11224,10011,2,0,7,9
11224,10012,0,0,1,1
11224,10013,0,0,3,3
11224,10014,0,0,2,2
11224,10016,2,1,1,4
11224,10017,0,0,2,2
11224,10018,0,0,2,2
11224,10019,1,0,5,6
11224,10021,0,1,4,5
11224,10022,0,0,3,3
11224,10023,1,0,3,4
11224,10024,1,0,4,5
11224,10025,0,10,9,19
11224,10026,5,4,6,15
11224,10027,6,7,7,20
11224,10028,0,1,2,3
11224,10029,5,6,2,13
11224,10030,1,2,2,5
11224,10031,3,9,3,15
11224,10032,1,8,5,14
11224,10033,1,9,1,11
11224,10034,1,3,1,5
11224,10035,1,2,2,5
11224,10037,5,2,3,10
11224,10038,0,0,4,4
11224,10039,1,3,3,7
11224,10040,2,6,5,13
11224,10044,0,0,1,1
11224,10065,0,0,1,1
11224,10128,1,0,9,10
11224,10280,0,1,0,1
11224,10282,0,0,2,2
11224,10301,14,12,30,56
11224,10302,5,8,10,23
11224,10303,13,21,14,48
11224,10304,10,11,34,55
11224,10305,8,20,32,60
11224,10306,15,25,48,88
11224,10307,4,1,10,15
11224,10308,11,10,24,45
11224,10309,4,12,20,36
11224,10310,10,9,23,42
11224,10312,14,15,42,71
11224,10314,24,28,74,126
11224,10451,3,8,3,14
11224,10452,6,13,8,27
11224,10453,7,8,5,20
11224,10454,1,10,2,13
11224,10455,2,9,1,12
11224,10456,4,16,5,25
11224,10457,2,11,3,16
11224,10458,3,7,0,10
11224,10459,6,17,3,26
11224,10460,7,7,5,19
11224,10461,1,4,3,8
11224,10462,2,13,7,22
11224,10463,7,13,11,31
11224,10464,0,2,0,2
11224,10465,1,8,5,14
11224,10466,4,3,2,9
11224,10467,5,7,7,19
11224,10468,2,10,9,21
11224,10469,4,4,8,16
11224,10470,0,2,2,4
11224,10471,1,1,2,4
11224,10472,2,11,6,19
11224,10473,3,6,3,12
11224,10474,0,4,0,4
11224,10475,0,8,5,13
11224,11001,0,1,3,4
11224,11004,2,2,4,8
11224,11101,5,1,3,9
11224,11102,1,2,9,12
11224,11103,3,0,9,12
11224,11104,3,2,2,7
11224,11105,1,0,3,4
11224,11106,3,3,2,8
11224,11109,1,0,1,2
11224,11201,6,3,15,24
11224,11203,33,86,57,176
11224,11204,36,46,49,131
11224,11205,4,7,5,16
11224,11206,14,13,23,50
11224,11207,17,40,33,90
11224,11208,22,38,20,80
11224,11209,19,18,47,84
11224,11210,27,75,64,166
11224,11211,2,12,15,29
11224,11212,17,45,40,102
11224,11213,14,32,21,67
11224,11214,72,120,64,256
11224,11215,14,9,43,66
11224,11216,15,8,13,36
11224,11217,3,12,15,30
11224,11218,24,28,50,102
11224,11219,12,26,26,64
11224,11220,35,53,33,121
11224,11221,8,22,3,33
11224,11222,2,2,5,9
11224,11223,80,95,70,245
11224,11224,293,359,190,842
11224,11225,10,28,30,68
11224,11226,43,83,89,215
11224,11228,23,26,26,75
11224,11229,61,88,73,222
11224,11230,37,81,95,213
11224,11231,5,15,16,36
11224,11232,9,12,17,38
11224,11233,12,26,22,60
11224,11234,52,98,109,259
11224,11235,124,162,153,439
11224,11236,44,115,83,242
11224,11237,4,9,7,20
11224,11238,19,9,17,45
11224,11239,2,2,7,11
11224,11354,2,2,5,9
11224,11355,2,2,5,9
11224,11356,0,0,1,1
11224,11357,2,1,3,6
11224,11358,2,2,1,5
11224,11360,2,2,5,9
11224,11361,0,3,1,4
11224,11362,2,1,3,6
11224,11364,0,5,4,9
11224,11365,3,4,4,11
11224,11366,1,1,5,7
11224,11367,2,5,9,16
11224,11368,4,9,8,21
11224,11369,2,3,3,8
11224,11370,3,4,2,9
11224,11372,3,2,4,9
11224,11373,2,10,6,18
11224,11374,2,8,6,16
11224,11375,5,6,7,18
11224,11377,6,5,11,22
11224,11378,1,2,4,7
11224,11379,1,4,8,13
11224,11385,6,8,24,38
11224,11411,0,7,6,13
11224,11412,4,14,11,29
11224,11413,0,7,15,22
11224,11414,1,4,7,12
11224,11415,3,1,6,10
11224,11416,0,4,1,5
11224,11417,3,10,6,19
11224,11418,3,5,16,24
11224,11419,2,6,8,16
11224,11420,5,11,10,26
11224,11421,1,4,6,11
11224,11422,1,6,11,18
11224,11423,3,9,6,18
11224,11426,0,1,5,6
11224,11427,2,5,3,10
11224,11428,0,5,3,8
11224,11429,1,1,6,8
11224,11432,4,10,7,21
11224,11433,3,5,11,19
11224,11434,5,14,18,37
11224,11435,5,7,12,24
11224,11436,1,5,7,13
11224,11691,7,16,19,42
11224,11692,3,7,12,22
11224,11693,4,9,8,21
11224,11694,7,13,26,46
11224,11697,2,1,7,10
11225,10001,2,0,4,6
11225,10002,13,13,18,44
11225,10003,4,0,16,20
11225,10004,0,5,2,7
11225,10005,1,0,1,2
11225,10007,0,2,0,2
11225,10009,10,1,15,26
11225,10010,2,3,3,8
11225,10011,4,2,3,9
11225,10012,3,5,6,14
11225,10013,0,2,7,9
11225,10014,4,5,5,14
11225,10016,1,1,4,6
11225,10017,0,0,2,2
11225,10018,1,0,0,1
11225,10019,1,4,4,9
11225,10021,1,1,4,6
11225,10022,2,2,3,7
11225,10023,1,2,9,12
11225,10024,1,1,6,8
11225,10025,6,6,12,24
11225,10026,6,2,4,12
11225,10027,3,8,7,18
11225,10028,1,0,5,6
11225,10029,8,15,13,36
11225,10030,3,7,7,17
11225,10031,7,2,12,21
11225,10032,7,6,12,25
11225,10033,5,5,7,17
11225,10034,4,6,6,16
11225,10035,2,7,9,18
11225,10036,0,2,4,6
11225,10037,1,2,4,7
11225,10038,2,1,5,8
11225,10039,1,3,3,7
11225,10040,7,5,9,21
11225,10044,0,2,3,5
11225,10065,1,1,2,4
11225,10075,0,1,3,4
11225,10128,1,1,5,7
11225,10280,0,0,3,3
11225,10282,0,0,1,1
11225,10301,1,5,17,23
11225,10302,5,2,3,10
11225,10303,1,5,10,16
11225,10304,5,5,12,22
11225,10305,2,6,14,22
11225,10306,1,5,25,31
11225,10307,0,1,6,7
11225,10308,3,3,18,24
11225,10309,1,3,17,21
11225,10310,1,5,6,12
11225,10312,2,8,27,37
11225,10314,9,9,13,31
11225,10451,4,8,6,18
11225,10452,5,10,3,18
11225,10453,0,13,8,21
11225,10454,2,2,5,9
11225,10455,3,0,6,9
11225,10456,7,7,10,24
11225,10457,5,13,2,20
11225,10458,4,9,11,24
11225,10459,3,5,7,15
11225,10460,2,6,4,12
11225,10461,1,4,8,13
11225,10462,5,16,11,32
11225,10463,3,6,14,23
11225,10465,1,1,8,10
11225,10466,2,7,13,22
11225,10467,3,9,8,20
11225,10468,6,7,11,24
11225,10469,5,3,5,13
11225,10471,1,2,2,5
11225,10472,1,12,11,24
11225,10473,4,8,8,20
11225,10474,1,2,1,4
11225,10475,1,2,6,9
11225,11001,0,1,0,1
11225,11004,0,1,2,3
11225,11005,0,0,1,1
11225,11101,3,5,4,12
11225,11102,2,7,3,12
11225,11103,4,2,8,14
11225,11104,3,3,7,13
11225,11105,1,6,7,14
11225,11106,3,3,6,12
11225,11109,0,0,1,1
11225,11201,12,22,21,55
11225,11203,56,103,74,233
11225,11204,19,19,27,65
11225,11205,20,20,27,67
11225,11206,24,25,29,78
11225,11207,31,69,38,138
11225,11208,33,48,33,114
11225,11209,14,34,43,91
11225,11210,34,58,44,136
11225,11211,9,22,24,55
11225,11212,43,86,47,176
11225,11213,142,179,78,399
11225,11214,17,27,30,74
11225,11215,9,19,75,103
11225,11216,35,43,52,130
11225,11217,22,15,27,64
11225,11218,22,44,53,119
11225,11219,28,26,20,74
11225,11220,33,34,24,91
11225,11221,22,25,43,90
11225,11222,9,12,20,41
11225,11223,23,17,25,65
11225,11224,4,8,12,24
11225,11225,188,256,99,543
11225,11226,75,147,90,312
11225,11228,15,10,24,49
11225,11229,20,35,39,94
11225,11230,21,31,42,94
11225,11231,3,13,12,28
11225,11232,8,10,14,32
11225,11233,27,29,46,102
11225,11234,38,61,81,180
11225,11235,17,21,32,70
11225,11236,60,54,51,165
11225,11237,16,16,13,45
11225,11238,16,57,68,141
11225,11239,1,3,7,11
11225,11354,2,5,3,10
11225,11355,5,5,5,15
11225,11356,0,2,2,4
11225,11357,2,0,4,6
11225,11358,1,4,6,11
11225,11360,3,1,4,8
11225,11361,3,1,7,11
11225,11362,0,0,3,3
11225,11363,0,1,2,3
11225,11364,4,6,8,18
11225,11365,3,7,8,18
11225,11366,0,3,3,6
11225,11367,5,4,5,14
11225,11368,6,10,13,29
11225,11369,0,2,4,6
11225,11370,2,3,6,11
11225,11372,5,5,5,15
11225,11373,10,11,13,34
11225,11374,3,4,9,16
11225,11375,4,4,10,18
11225,11377,17,20,13,50
11225,11378,6,15,23,44
11225,11379,3,13,14,30
11225,11385,21,27,43,91
11225,11411,0,4,5,9
11225,11412,3,5,4,12
11225,11413,0,7,7,14
11225,11414,2,4,9,15
11225,11415,1,1,7,9
11225,11416,1,3,6,10
11225,11417,1,7,7,15
11225,11418,5,8,7,20
11225,11419,7,7,6,20
11225,11420,3,8,12,23
11225,11421,6,10,8,24
11225,11422,0,2,12,14
11225,11423,3,7,5,15
11225,11426,1,8,6,15
11225,11427,3,6,2,11
11225,11428,0,0,5,5
11225,11429,0,5,6,11
11225,11430,0,0,1,1
11225,11432,8,10,11,29
11225,11433,2,6,9,17
11225,11434,7,9,20,36
11225,11435,5,4,8,17
11225,11436,1,7,3,11
11225,11691,14,17,13,44
11225,11692,7,5,8,20
11225,11693,2,1,6,9
11225,11694,4,2,22,28
11225,11697,2,2,5,9
11226,10001,0,3,1,4
11226,10002,16,21,4,41
11226,10003,5,6,12,23
11226,10004,1,5,0,6
11226,10005,1,1,0,2
11226,10007,1,3,1,5
11226,10009,5,6,11,22
11226,10010,0,1,5,6
11226,10011,2,2,7,11
11226,10012,1,4,9,14
11226,10013,9,4,8,21
11226,10014,5,4,8,17
11226,10016,2,3,6,11
11226,10017,2,0,1,3
11226,10019,3,0,3,6
11226,10021,1,2,4,7
11226,10022,1,0,4,5
11226,10023,1,0,2,3
11226,10024,4,0,9,13
11226,10025,2,5,13,20
11226,10026,7,5,8,20
11226,10027,11,9,14,34
11226,10028,2,1,6,9
11226,10029,8,13,12,33
11226,10030,3,3,4,10
11226,10031,4,10,4,18
11226,10032,4,12,6,22
11226,10033,3,3,2,8
11226,10034,4,3,8,15
11226,10035,4,4,6,14
11226,10036,1,0,0,1
11226,10037,2,3,0,5
11226,10038,2,3,2,7
11226,10039,1,0,5,6
11226,10040,3,4,5,12
11226,10044,1,0,3,4
11226,10075,0,0,4,4
11226,10128,4,1,10,15
11226,10280,0,2,1,3
11226,10282,2,1,1,4
11226,10301,6,6,16,28
11226,10302,3,5,7,15
11226,10303,4,10,8,22
11226,10304,12,12,9,33
11226,10305,11,10,11,32
11226,10306,6,18,23,47
11226,10307,2,3,3,8
11226,10308,5,2,6,13
11226,10309,3,8,14,25
11226,10310,3,10,5,18
11226,10312,10,9,22,41
11226,10314,19,20,36,75
11226,10451,5,5,2,12
11226,10452,11,18,11,40
11226,10453,10,15,8,33
11226,10454,4,9,2,15
11226,10455,6,6,3,15
11226,10456,13,18,6,37
11226,10457,9,8,6,23
11226,10458,16,14,13,43
11226,10459,1,13,6,20
11226,10460,5,10,5,20
11226,10461,2,8,5,15
11226,10462,9,12,14,35
11226,10463,7,8,12,27
11226,10464,0,1,0,1
11226,10465,5,3,10,18
11226,10466,9,12,8,29
11226,10467,11,13,9,33
11226,10468,12,6,0,18
11226,10469,7,6,4,17
11226,10470,2,1,2,5
11226,10471,1,1,3,5
11226,10472,4,7,6,17
11226,10473,5,10,5,20
11226,10474,1,3,0,4
11226,10475,1,3,10,14
11226,11001,1,1,1,3
11226,11004,6,4,1,11
11226,11005,0,1,0,1
11226,11040,0,2,0,2
11226,11101,1,6,3,10
11226,11102,1,4,2,7
11226,11103,4,5,9,18
11226,11104,1,4,2,7
11226,11105,3,1,4,8
11226,11106,2,5,3,10
11226,11201,18,19,22,59
11226,11203,134,180,102,416
11226,11204,50,42,36,128
11226,11205,15,33,19,67
11226,11206,25,39,27,91
11226,11207,50,101,51,202
11226,11208,80,80,49,209
11226,11209,26,38,45,109
11226,11210,82,147,65,294
11226,11211,11,26,25,62
11226,11212,78,124,50,252
11226,11213,46,64,43,153
11226,11214,37,51,49,137
11226,11215,10,37,41,88
11226,11216,36,43,39,118
11226,11217,18,23,18,59
11226,11218,76,121,47,244
11226,11219,45,51,26,122
11226,11220,59,53,28,140
11226,11221,36,66,45,147
11226,11222,7,13,13,33
11226,11223,42,43,43,128
11226,11224,31,47,27,105
11226,11225,92,84,47,223
11226,11226,372,601,176,1149
11226,11228,27,36,34,97
11226,11229,45,62,50,157
11226,11230,72,100,51,223
11226,11231,9,16,9,34
11226,11232,13,6,20,39
11226,11233,28,63,56,147
11226,11234,77,109,100,286
11226,11235,39,39,43,121
11226,11236,132,168,112,412
11226,11237,21,24,17,62
11226,11238,18,29,30,77
11226,11239,5,12,16,33
11226,11354,13,7,5,25
11226,11355,12,11,8,31
11226,11356,1,2,3,6
11226,11357,4,2,5,11
11226,11358,6,4,2,12
11226,11360,3,5,0,8
11226,11361,5,5,5,15
11226,11362,1,2,4,7
11226,11363,2,1,0,3
11226,11364,5,3,9,17
11226,11365,5,6,10,21
11226,11366,0,2,2,4
11226,11367,4,11,10,25
11226,11368,14,19,8,41
11226,11369,3,1,11,15
11226,11370,5,5,4,14
11226,11372,6,8,3,17
11226,11373,11,22,8,41
11226,11374,3,3,8,14
11226,11375,5,9,15,29
11226,11377,10,16,12,38
11226,11378,10,15,15,40
11226,11379,8,12,18,38
11226,11385,19,41,42,102
11226,11411,8,8,11,27
11226,11412,7,18,9,34
11226,11413,9,13,12,34
11226,11414,8,4,9,21
11226,11415,3,2,3,8
11226,11416,7,8,4,19
11226,11417,9,9,7,25
11226,11418,5,13,8,26
11226,11419,12,20,11,43
11226,11420,18,23,9,50
11226,11421,16,13,15,44
11226,11422,11,7,10,28
11226,11423,4,13,3,20
11226,11426,4,3,5,12
11226,11427,4,7,4,15
11226,11428,4,4,2,10
11226,11429,3,12,10,25
11226,11432,11,19,8,38
11226,11433,3,12,7,22
11226,11434,11,17,16,44
11226,11435,3,12,7,22
11226,11436,1,7,4,12
11226,11691,18,28,17,63
11226,11692,4,7,5,16
11226,11693,9,4,9,22
11226,11694,6,12,18,36
11226,11697,1,1,7,9
11228,10001,1,1,2,4
11228,10002,6,7,5,18
11228,10003,1,0,5,6
11228,10004,1,1,3,5
11228,10005,0,2,0,2
11228,10006,0,0,1,1
11228,10007,0,1,1,2
11228,10009,0,4,4,8
11228,10010,0,3,3,6
11228,10011,2,0,5,7
11228,10012,4,3,5,12
11228,10013,2,4,9,15
11228,10014,4,1,6,11
11228,10016,0,1,1,2
11228,10017,0,0,1,1
11228,10019,0,0,2,2
11228,10021,2,1,1,4
11228,10022,1,0,4,5
11228,10023,1,2,3,6
11228,10024,0,1,4,5
11228,10025,1,2,4,7
11228,10026,2,2,3,7
11228,10027,4,3,4,11
11228,10028,0,2,5,7
11228,10029,1,3,3,7
11228,10030,1,3,3,7
11228,10031,0,3,4,7
11228,10032,1,5,3,9
11228,10033,0,2,1,3
11228,10034,1,3,2,6
11228,10035,2,1,2,5
11228,10036,1,0,1,2
11228,10038,2,2,1,5
11228,10039,1,0,0,1
11228,10040,1,1,1,3
11228,10044,0,0,2,2
11228,10065,0,1,2,3
11228,10075,0,0,1,1
11228,10128,2,2,0,4
11228,10162,0,0,1,1
11228,10301,14,20,25,59
11228,10302,5,7,9,21
11228,10303,6,17,3,26
11228,10304,15,32,15,62
11228,10305,22,24,27,73
11228,10306,19,30,37,86
11228,10307,2,7,8,17
11228,10308,8,13,13,34
11228,10309,14,9,16,39
11228,10310,9,9,7,25
11228,10312,29,20,30,79
11228,10314,39,26,73,138
11228,10451,3,4,3,10
11228,10452,1,7,7,15
11228,10453,4,3,4,11
11228,10454,3,2,4,9
11228,10455,3,2,2,7
11228,10456,9,9,3,21
11228,10457,9,7,1,17
11228,10458,3,6,6,15
11228,10459,6,6,1,13
11228,10460,4,5,3,12
11228,10461,1,1,7,9
11228,10462,4,6,9,19
11228,10463,1,7,2,10
11228,10464,0,1,0,1
11228,10465,2,3,3,8
11228,10466,3,5,4,12
11228,10467,6,10,4,20
11228,10468,3,8,4,15
11228,10469,5,8,5,18
11228,10470,1,1,2,4
11228,10471,1,0,1,2
11228,10472,0,4,7,11
11228,10473,3,4,5,12
11228,10474,0,1,0,1
11228,10475,2,2,4,8
11228,11004,2,1,3,6
11228,11005,0,1,0,1
11228,11040,1,1,0,2
11228,11101,2,2,4,8
11228,11102,3,1,1,5
11228,11103,2,5,1,8
11228,11104,0,2,2,4
11228,11105,4,2,4,10
11228,11106,4,2,3,9
11228,11109,0,0,1,1
11228,11201,8,7,17,32
11228,11203,20,34,26,80
11228,11204,64,62,31,157
11228,11205,8,10,8,26
11228,11206,1,20,14,35
11228,11207,7,10,13,30
11228,11208,5,13,6,24
11228,11209,64,94,86,244
11228,11210,17,35,17,69
11228,11211,11,8,5,24
11228,11212,10,24,13,47
11228,11213,9,26,16,51
11228,11214,82,95,56,233
11228,11215,12,16,27,55
11228,11216,6,10,11,27
11228,11217,2,2,6,10
11228,11218,15,27,20,62
11228,11219,63,59,23,145
11228,11220,61,58,32,151
11228,11221,2,12,7,21
11228,11222,4,2,1,7
11228,11223,43,55,27,125
11228,11224,31,18,28,77
11228,11225,11,18,12,41
11228,11226,20,50,31,101
11228,11228,223,239,167,629
11228,11229,25,28,34,87
11228,11230,25,48,26,99
11228,11231,6,9,8,23
11228,11232,14,15,10,39
11228,11233,4,11,8,23
11228,11234,33,58,51,142
11228,11235,29,45,34,108
11228,11236,17,46,40,103
11228,11237,0,3,2,5
11228,11238,6,11,11,28
11228,11239,0,3,1,4
11228,11354,1,3,3,7
11228,11355,5,5,3,13
11228,11356,0,1,2,3
11228,11357,0,2,1,3
11228,11358,3,1,5,9
11228,11361,0,2,2,4
11228,11362,1,1,4,6
11228,11363,0,1,0,1
11228,11364,3,0,4,7
11228,11365,4,3,6,13
11228,11366,0,2,0,2
11228,11367,1,8,4,13
11228,11368,5,11,5,21
11228,11369,2,2,2,6
11228,11370,2,0,2,4
11228,11372,5,4,6,15
11228,11373,6,4,3,13
11228,11374,2,1,7,10
11228,11375,5,7,9,21
11228,11377,8,8,6,22
11228,11378,1,1,6,8
11228,11379,2,1,3,6
11228,11385,4,7,11,22
11228,11411,2,2,1,5
11228,11412,1,5,2,8
11228,11413,4,7,2,13
11228,11414,0,0,1,1
11228,11415,4,2,7,13
11228,11416,2,3,2,7
11228,11417,3,0,4,7
11228,11418,4,1,0,5
11228,11419,7,4,5,16
11228,11420,4,1,7,12
11228,11421,4,6,7,17
11228,11422,1,4,5,10
11228,11423,4,2,1,7
11228,11426,2,1,5,8
11228,11427,0,1,3,4
11228,11428,2,2,3,7
11228,11429,0,4,2,6
11228,11432,5,4,4,13
11228,11433,3,5,2,10
11228,11434,1,6,8,15
11228,11435,2,1,4,7
11228,11436,0,3,0,3
11228,11691,2,9,5,16
11228,11692,3,2,3,8
11228,11693,4,1,5,10
11228,11694,4,5,16,25
11228,11697,2,3,5,10
11229,10001,3,1,2,6
11229,10002,30,23,12,65
11229,10003,8,7,7,22
11229,10004,1,0,1,2
11229,10005,1,1,3,5
11229,10006,1,1,0,2
11229,10007,1,0,2,3
11229,10009,16,10,9,35
11229,10010,8,6,5,19
11229,10011,5,7,7,19
11229,10012,4,2,2,8
11229,10013,10,7,4,21
11229,10014,6,5,10,21
11229,10016,4,5,6,15
11229,10017,2,0,2,4
11229,10018,0,0,1,1
11229,10019,5,8,5,18
11229,10021,2,2,4,8
11229,10022,4,1,6,11
11229,10023,5,12,7,24
11229,10024,1,1,7,9
11229,10025,5,8,18,31
11229,10026,5,11,2,18
11229,10027,8,15,8,31
11229,10028,3,3,9,15
11229,10029,18,17,2,37
11229,10030,3,8,3,14
11229,10031,19,25,6,50
11229,10032,11,23,5,39
11229,10033,19,11,1,31
11229,10034,10,13,4,27
11229,10035,7,11,4,22
11229,10036,2,1,3,6
11229,10037,2,4,4,10
11229,10038,6,2,9,17
11229,10039,6,3,3,12
11229,10040,6,24,5,35
11229,10044,1,1,2,4
11229,10065,3,1,7,11
11229,10075,0,2,8,10
11229,10128,3,4,6,13
11229,10162,0,0,1,1
11229,10280,1,1,2,4
11229,10282,1,1,1,3
11229,10301,5,19,20,44
11229,10302,7,10,10,27
11229,10303,9,9,6,24
11229,10304,17,26,18,61
11229,10305,33,33,23,89
11229,10306,25,60,44,129
11229,10307,5,16,13,34
11229,10308,12,19,27,58
11229,10309,12,23,28,63
11229,10310,4,7,8,19
11229,10312,21,55,59,135
11229,10314,50,92,59,201
11229,10451,5,24,3,32
11229,10452,23,32,5,60
11229,10453,18,25,10,53
11229,10454,7,17,2,26
11229,10455,10,11,4,25
11229,10456,23,33,3,59
11229,10457,25,20,12,57
11229,10458,23,33,8,64
11229,10459,10,14,3,27
11229,10460,11,14,5,30
11229,10461,3,7,2,12
11229,10462,14,24,11,49
11229,10463,17,25,11,53
11229,10464,0,1,1,2
11229,10465,4,2,8,14
11229,10466,9,5,15,29
11229,10467,35,31,13,79
11229,10468,17,25,6,48
11229,10469,9,17,14,40
11229,10470,0,2,4,6
11229,10471,3,4,9,16
11229,10472,9,15,8,32
11229,10473,13,13,5,31
11229,10474,6,2,2,10
11229,10475,2,9,14,25
11229,11001,2,4,1,7
11229,11004,3,5,4,12
11229,11040,1,1,2,4
11229,11101,4,5,3,12
11229,11102,3,3,1,7
11229,11103,6,6,8,20
11229,11104,7,6,3,16
11229,11105,8,9,9,26
11229,11106,6,10,9,25
11229,11109,0,0,2,2
11229,11201,8,15,26,49
11229,11203,72,134,69,275
11229,11204,268,254,88,610
11229,11205,8,12,11,31
11229,11206,22,30,18,70
11229,11207,49,73,18,140
11229,11208,60,70,26,156
11229,11209,72,79,84,235
11229,11210,151,164,78,393
11229,11211,23,24,14,61
11229,11212,55,97,24,176
11229,11213,24,46,19,89
11229,11214,249,412,133,794
11229,11215,26,24,43,93
11229,11216,17,21,14,52
11229,11217,11,7,16,34
11229,11218,104,127,71,302
11229,11219,120,139,40,299
11229,11220,175,165,40,380
11229,11221,16,36,14,66
11229,11222,5,5,6,16
11229,11223,352,437,157,946
11229,11224,193,294,88,575
11229,11225,67,56,45,168
11229,11226,127,179,65,371
11229,11228,82,64,53,199
11229,11229,899,912,364,2175
11229,11230,343,434,139,916
11229,11231,12,10,6,28
11229,11232,45,35,15,95
11229,11233,30,42,16,88
11229,11234,274,303,220,797
11229,11235,485,686,310,1481
11229,11236,81,144,121,346
11229,11237,24,37,8,69
11229,11238,20,24,15,59
11229,11239,6,9,8,23
11229,11354,11,18,3,32
11229,11355,29,21,6,56
11229,11356,5,9,1,15
11229,11357,8,14,16,38
11229,11358,9,9,8,26
11229,11360,3,6,7,16
11229,11361,5,6,4,15
11229,11362,2,5,8,15
11229,11363,0,2,1,3
11229,11364,12,7,6,25
11229,11365,8,13,16,37
11229,11366,5,4,4,13
11229,11367,11,16,15,42
11229,11368,21,20,16,57
11229,11369,8,8,5,21
11229,11370,6,11,7,24
11229,11372,7,19,5,31
11229,11373,36,27,9,72
11229,11374,15,14,20,49
11229,11375,29,31,25,85
11229,11377,16,24,20,60
11229,11378,14,21,8,43
11229,11379,10,18,12,40
11229,11385,31,45,16,92
11229,11411,1,10,2,13
11229,11412,7,13,6,26
11229,11413,7,17,16,40
11229,11414,6,15,17,38
11229,11415,8,5,8,21
11229,11416,13,12,7,32
11229,11417,10,13,14,37
11229,11418,14,23,14,51
11229,11419,13,20,11,44
11229,11420,14,23,8,45
11229,11421,16,17,14,47
11229,11422,11,7,11,29
11229,11423,10,9,4,23
11229,11426,6,8,2,16
11229,11427,3,4,12,19
11229,11428,1,4,5,10
11229,11429,6,6,6,18
11229,11432,19,22,21,62
11229,11433,8,12,8,28
11229,11434,19,13,10,42
11229,11435,21,25,23,69
11229,11436,8,9,6,23
11229,11691,30,38,41,109
11229,11692,13,23,10,46
11229,11693,9,14,19,42
11229,11694,14,36,67,117
11229,11697,9,6,12,27
11230,10001,3,7,4,14
11230,10002,40,40,19,99
11230,10003,11,19,6,36
11230,10004,1,1,0,2
11230,10005,0,3,1,4
11230,10006,0,1,1,2
11230,10007,0,0,1,1
11230,10009,16,27,12,55
11230,10010,4,6,4,14
11230,10011,7,15,7,29
11230,10012,5,4,9,18
11230,10013,6,3,15,24
11230,10014,0,5,7,12
11230,10016,5,9,14,28
11230,10017,1,2,6,9
11230,10018,2,0,0,2
11230,10019,14,16,7,37
11230,10021,4,9,10,23
11230,10022,5,3,3,11
11230,10023,6,12,16,34
11230,10024,6,14,10,30
11230,10025,21,21,16,58
11230,10026,25,39,11,75
11230,10027,35,67,15,117
11230,10028,2,5,7,14
11230,10029,33,86,20,139
11230,10030,19,32,10,61
11230,10031,49,97,17,163
11230,10032,56,96,14,166
11230,10033,62,85,17,164
11230,10034,45,65,15,125
11230,10035,18,41,4,63
11230,10036,7,11,3,21
11230,10037,10,24,9,43
11230,10038,3,7,4,14
11230,10039,17,14,8,39
11230,10040,47,60,4,111
11230,10044,4,1,0,5
11230,10065,1,2,6,9
11230,10069,0,1,1,2
11230,10075,0,5,9,14
11230,10119,1,0,0,1
11230,10128,2,6,12,20
11230,10162,0,1,0,1
11230,10280,0,7,3,10
11230,10282,0,0,1,1
11230,10301,46,57,22,125
11230,10302,26,23,9,58
11230,10303,35,58,13,106
11230,10304,59,74,30,163
11230,10305,39,68,48,155
11230,10306,29,40,60,129
11230,10307,6,8,11,25
11230,10308,9,18,29,56
11230,10309,19,12,33,64
11230,10310,35,42,12,89
11230,10312,27,43,58,128
11230,10314,65,109,81,255
11230,10451,77,88,12,177
11230,10452,158,172,31,361
11230,10453,148,208,21,377
11230,10454,38,56,9,103
11230,10455,39,76,7,122
11230,10456,137,183,24,344
11230,10457,113,160,24,297
11230,10458,105,144,35,284
11230,10459,60,89,6,155
11230,10460,70,103,13,186
11230,10461,23,37,14,74
11230,10462,42,80,15,137
11230,10463,42,70,19,131
11230,10464,0,1,1,2
11230,10465,17,23,18,58
11230,10466,42,54,17,113
11230,10467,96,149,39,284
11230,10468,82,131,16,229
11230,10469,40,49,15,104
11230,10470,8,12,7,27
11230,10471,13,28,8,49
11230,10472,61,70,17,148
11230,10473,50,41,27,118
11230,10474,11,16,3,30
11230,10475,10,37,16,63
11230,11001,1,1,3,5
11230,11004,5,8,7,20
11230,11005,1,0,0,1
11230,11040,1,2,0,3
11230,11101,9,12,7,28
11230,11102,10,11,12,33
11230,11103,17,12,15,44
11230,11104,3,6,5,14
11230,11105,5,3,4,12
11230,11106,10,16,9,35
11230,11109,0,2,0,2
11230,11201,32,23,24,79
11230,11203,188,317,150,655
11230,11204,302,444,150,896
11230,11205,37,41,18,96
11230,11206,71,110,42,223
11230,11207,124,215,58,397
11230,11208,114,275,49,438
11230,11209,83,119,103,305
11230,11210,370,528,283,1181
11230,11211,41,60,41,142
11230,11212,161,301,68,530
11230,11213,116,176,69,361
11230,11214,286,448,156,890
11230,11215,41,47,56,144
11230,11216,50,70,35,155
11230,11217,27,33,31,91
11230,11218,244,380,129,753
11230,11219,257,334,107,698
11230,11220,188,319,71,578
11230,11221,64,122,29,215
11230,11222,18,17,12,47
11230,11223,351,519,211,1081
11230,11224,159,302,97,558
11230,11225,117,171,74,362
11230,11226,295,641,140,1076
11230,11228,76,153,62,291
11230,11229,395,693,277,1365
11230,11230,1027,1349,635,3011
11230,11231,23,36,18,77
11230,11232,43,73,19,135
11230,11233,82,130,55,267
11230,11234,278,387,304,969
11230,11235,356,680,244,1280
11230,11236,226,351,160,737
11230,11237,46,74,16,136
11230,11238,40,44,42,126
11230,11239,17,46,7,70
11230,11354,6,24,8,38
11230,11355,22,42,19,83
11230,11356,3,9,7,19
11230,11357,8,8,5,21
11230,11358,8,14,8,30
11230,11360,1,5,1,7
11230,11361,8,11,10,29
11230,11362,2,9,9,20
11230,11363,2,1,0,3
11230,11364,2,9,12,23
11230,11365,18,16,19,53
11230,11366,7,7,10,24
11230,11367,22,24,28,74
11230,11368,51,69,27,147
11230,11369,10,22,9,41
11230,11370,36,36,4,76
11230,11372,21,35,11,67
11230,11373,29,56,14,99
11230,11374,23,29,25,77
11230,11375,42,40,39,121
11230,11377,18,43,15,76
11230,11378,15,31,10,56
11230,11379,10,17,12,39
11230,11385,48,89,47,184
11230,11411,10,11,8,29
11230,11412,23,34,9,66
11230,11413,25,36,12,73
11230,11414,14,14,12,40
11230,11415,6,26,12,44
11230,11416,16,37,11,64
11230,11417,12,32,9,53
11230,11418,25,51,12,88
11230,11419,26,57,19,102
11230,11420,28,41,29,98
11230,11421,23,62,24,109
11230,11422,11,29,16,56
11230,11423,25,29,17,71
11230,11426,8,16,6,30
11230,11427,9,10,8,27
11230,11428,5,10,8,23
11230,11429,8,22,15,45
11230,11430,0,0,1,1
11230,11432,32,40,20,92
11230,11433,21,39,13,73
11230,11434,35,63,26,124
11230,11435,45,40,20,105
11230,11436,9,9,7,25
11230,11691,70,139,62,271
11230,11692,18,36,21,75
11230,11693,13,19,8,40
11230,11694,34,30,30,94
11230,11697,3,5,7,15
11231,10001,5,11,8,24
11231,10002,21,45,44,110
11231,10003,8,7,24,39
11231,10004,1,4,1,6
11231,10005,0,4,2,6
11231,10006,0,1,1,2
11231,10007,2,2,2,6
11231,10009,11,24,31,66
11231,10010,2,6,11,19
11231,10011,11,7,30,48
11231,10012,5,12,20,37
11231,10013,4,4,17,25
11231,10014,4,8,14,26
11231,10016,9,10,11,30
11231,10017,2,1,5,8
11231,10018,3,3,6,12
11231,10019,10,11,12,33
11231,10021,5,2,16,23
11231,10022,3,3,16,22
11231,10023,7,9,21,37
11231,10024,6,9,19,34
11231,10025,7,11,27,45
11231,10026,5,16,14,35
11231,10027,7,16,18,41
11231,10028,4,4,10,18
11231,10029,4,27,20,51
11231,10030,6,14,10,30
11231,10031,8,4,11,23
11231,10032,4,12,16,32
11231,10033,4,15,11,30
11231,10034,3,9,19,31
11231,10035,2,13,10,25
11231,10036,2,5,12,19
11231,10037,5,9,4,18
11231,10038,2,9,9,20
11231,10039,5,9,5,19
11231,10040,4,14,10,28
11231,10044,0,1,4,5
11231,10065,1,0,5,6
11231,10069,0,1,2,3
11231,10075,1,4,7,12
11231,10128,5,4,21,30
11231,10162,0,0,1,1
11231,10280,0,3,5,8
11231,10282,2,0,2,4
11231,10301,12,22,35,69
11231,10302,5,5,18,28
11231,10303,5,14,20,39
11231,10304,6,22,41,69
11231,10305,14,23,45,82
11231,10306,15,18,75,108
11231,10307,6,11,22,39
11231,10308,8,8,38,54
11231,10309,11,7,40,58
11231,10310,6,26,27,59
11231,10312,17,21,73,111
11231,10314,33,39,102,174
11231,10451,9,9,11,29
11231,10452,10,30,19,59
11231,10453,8,22,10,40
11231,10454,8,5,4,17
11231,10455,3,6,9,18
11231,10456,13,23,18,54
11231,10457,7,19,12,38
11231,10458,7,30,13,50
11231,10459,5,14,7,26
11231,10460,1,24,7,32
11231,10461,1,6,18,25
11231,10462,7,21,20,48
11231,10463,6,8,22,36
11231,10465,5,8,8,21
11231,10466,3,20,23,46
11231,10467,4,34,20,58
11231,10468,10,20,20,50
11231,10469,3,18,15,36
11231,10470,2,2,7,11
11231,10471,3,3,3,9
11231,10472,6,8,16,30
11231,10473,4,18,14,36
11231,10474,2,4,2,8
11231,10475,1,9,12,22
11231,11001,0,0,3,3
11231,11004,1,3,4,8
11231,11040,0,0,1,1
11231,11101,8,7,19,34
11231,11102,6,10,9,25
11231,11103,5,10,10,25
11231,11104,5,5,15,25
11231,11105,9,12,11,32
11231,11106,10,13,16,39
11231,11109,1,2,3,6
11231,11201,33,56,76,165
11231,11203,37,96,70,203
11231,11204,48,72,63,183
11231,11205,37,36,67,140
11231,11206,46,100,80,226
11231,11207,36,111,76,223
11231,11208,43,94,62,199
11231,11209,40,64,107,211
11231,11210,33,46,62,141
11231,11211,33,47,90,170
11231,11212,26,89,76,191
11231,11213,19,73,60,152
11231,11214,31,80,77,188
11231,11215,51,84,114,249
11231,11216,47,80,85,212
11231,11217,29,48,70,147
11231,11218,79,83,98,260
11231,11219,34,51,47,132
11231,11220,69,148,71,288
11231,11221,42,89,79,210
11231,11222,17,31,66,114
11231,11223,45,71,58,174
11231,11224,20,60,34,114
11231,11225,22,88,65,175
11231,11226,47,138,86,271
11231,11228,38,52,62,152
11231,11229,17,51,62,130
11231,11230,34,55,82,171
11231,11231,243,305,287,835
11231,11232,37,43,46,126
11231,11233,42,66,65,173
11231,11234,30,96,95,221
11231,11235,25,61,52,138
11231,11236,46,99,71,216
11231,11237,26,37,41,104
11231,11238,29,46,58,133
11231,11239,3,8,18,29
11231,11354,3,15,14,32
11231,11355,5,6,14,25
11231,11356,3,5,7,15
11231,11357,1,4,14,19
11231,11358,2,2,7,11
11231,11360,0,4,0,4
11231,11361,2,1,6,9
11231,11362,1,0,1,2
11231,11363,2,2,0,4
11231,11364,4,2,13,19
11231,11365,3,9,9,21
11231,11366,0,4,4,8
11231,11367,2,9,12,23
11231,11368,11,30,31,72
11231,11369,3,8,8,19
11231,11370,7,13,13,33
11231,11372,14,12,21,47
11231,11373,13,21,22,56
11231,11374,2,6,10,18
11231,11375,7,10,25,42
11231,11377,27,30,23,80
11231,11378,14,22,34,70
11231,11379,15,12,31,58
11231,11385,39,68,91,198
11231,11411,4,2,4,10
11231,11412,6,8,9,23
11231,11413,4,11,15,30
11231,11414,3,4,16,23
11231,11415,4,9,10,23
11231,11416,5,3,18,26
11231,11417,1,5,19,25
11231,11418,14,11,9,34
11231,11419,6,17,16,39
11231,11420,4,17,24,45
11231,11421,6,12,15,33
11231,11422,6,13,12,31
11231,11423,2,5,11,18
11231,11426,0,4,6,10
11231,11427,2,4,8,14
11231,11428,4,4,5,13
11231,11429,5,4,7,16
11231,11432,4,18,19,41
11231,11433,5,15,6,26
11231,11434,4,22,20,46
11231,11435,5,17,14,36
11231,11436,7,4,6,17
11231,11691,12,13,26,51
11231,11692,2,4,13,19
11231,11693,2,9,7,18
11231,11694,3,5,16,24
11231,11697,0,3,4,7
11232,10001,4,7,10,21
11232,10002,54,52,54,160
11232,10003,1,11,28,40
11232,10004,3,1,4,8
11232,10005,0,1,4,5
11232,10006,1,0,0,1
11232,10007,2,4,6,12
11232,10009,12,33,40,85
11232,10010,4,4,10,18
11232,10011,4,11,18,33
11232,10012,13,7,15,35
11232,10013,14,6,13,33
11232,10014,5,4,17,26
11232,10016,4,5,22,31
11232,10017,0,1,7,8
11232,10018,4,4,2,10
11232,10019,3,8,13,24
11232,10021,1,4,13,18
11232,10022,3,8,10,21
11232,10023,0,10,14,24
11232,10024,1,5,13,19
11232,10025,5,15,21,41
11232,10026,6,9,12,27
11232,10027,4,13,22,39
11232,10028,2,1,10,13
11232,10029,18,26,23,67
11232,10030,2,15,8,25
11232,10031,8,11,12,31
11232,10032,3,13,13,29
11232,10033,5,17,12,34
11232,10034,7,6,8,21
11232,10035,8,13,9,30
11232,10036,1,5,11,17
11232,10037,3,5,3,11
11232,10038,4,18,13,35
11232,10039,5,6,6,17
11232,10040,4,7,12,23
11232,10044,1,1,4,6
11232,10065,1,0,8,9
11232,10075,1,2,10,13
11232,10128,5,7,12,24
11232,10280,3,0,10,13
11232,10282,2,1,2,5
11232,10301,16,39,56,111
11232,10302,12,13,19,44
11232,10303,14,17,34,65
11232,10304,20,74,68,162
11232,10305,30,74,74,178
11232,10306,26,51,99,176
11232,10307,7,12,25,44
11232,10308,10,22,39,71
11232,10309,7,26,51,84
11232,10310,16,18,27,61
11232,10312,23,32,72,127
11232,10314,59,85,150,294
11232,10451,9,16,9,34
11232,10452,12,23,18,53
11232,10453,11,31,10,52
11232,10454,2,12,11,25
11232,10455,5,13,8,26
11232,10456,9,33,22,64
11232,10457,11,21,9,41
11232,10458,21,26,17,64
11232,10459,8,13,11,32
11232,10460,5,19,8,32
11232,10461,1,14,8,23
11232,10462,11,16,19,46
11232,10463,2,12,9,23
11232,10464,0,1,1,2
11232,10465,1,11,8,20
11232,10466,11,17,13,41
11232,10467,16,18,21,55
11232,10468,8,24,15,47
11232,10469,7,16,21,44
11232,10470,3,4,5,12
11232,10471,2,3,4,9
11232,10472,8,13,11,32
11232,10473,5,14,22,41
11232,10474,2,5,1,8
11232,10475,4,7,8,19
11232,11001,1,1,1,3
11232,11004,5,5,7,17
11232,11005,0,1,1,2
11232,11040,0,0,2,2
11232,11101,4,11,12,27
11232,11102,2,12,10,24
11232,11103,3,10,22,35
11232,11104,5,13,11,29
11232,11105,5,12,14,31
11232,11106,3,11,14,28
11232,11109,0,2,2,4
11232,11201,19,27,34,80
11232,11203,55,82,70,207
11232,11204,132,180,123,435
11232,11205,28,45,30,103
11232,11206,54,89,43,186
11232,11207,54,131,84,269
11232,11208,57,128,67,252
11232,11209,64,134,211,409
11232,11210,37,108,91,236
11232,11211,28,54,55,137
11232,11212,53,137,55,245
11232,11213,39,86,64,189
11232,11214,128,203,138,469
11232,11215,36,75,91,202
11232,11216,15,53,50,118
11232,11217,16,43,40,99
11232,11218,66,141,106,313
11232,11219,125,212,109,446
11232,11220,251,493,147,891
11232,11221,32,106,65,203
11232,11222,10,31,43,84
11232,11223,99,172,107,378
11232,11224,39,73,74,186
11232,11225,35,71,56,162
11232,11226,55,139,118,312
11232,11228,77,113,71,261
11232,11229,64,137,107,308
11232,11230,46,98,108,252
11232,11231,25,53,46,124
11232,11232,152,284,90,526
11232,11233,32,120,57,209
11232,11234,51,118,141,310
11232,11235,71,121,114,306
11232,11236,49,98,94,241
11232,11237,15,36,36,87
11232,11238,25,30,51,106
11232,11239,3,12,6,21
11232,11354,31,23,13,67
11232,11355,45,29,18,92
11232,11356,6,4,11,21
11232,11357,6,11,14,31
11232,11358,12,10,8,30
11232,11360,6,4,1,11
11232,11361,1,5,12,18
11232,11362,3,6,7,16
11232,11363,0,0,2,2
11232,11364,15,11,8,34
11232,11365,8,8,22,38
11232,11366,3,6,4,13
11232,11367,7,11,18,36
11232,11368,10,28,29,67
11232,11369,5,18,8,31
11232,11370,7,7,13,27
11232,11372,19,32,21,72
11232,11373,19,48,22,89
11232,11374,7,9,22,38
11232,11375,6,15,36,57
11232,11377,16,36,42,94
11232,11378,11,17,34,62
11232,11379,12,24,38,74
11232,11385,25,65,74,164
11232,11411,3,8,11,22
11232,11412,4,16,17,37
11232,11413,7,20,19,46
11232,11414,8,11,17,36
11232,11415,3,8,5,16
11232,11416,6,17,11,34
11232,11417,3,13,17,33
11232,11418,7,18,17,42
11232,11419,10,25,17,52
11232,11420,11,26,21,58
11232,11421,9,11,20,40
11232,11422,8,10,21,39
11232,11423,6,12,11,29
11232,11426,1,5,8,14
11232,11427,8,13,8,29
11232,11428,8,6,7,21
11232,11429,2,8,15,25
11232,11432,15,21,22,58
11232,11433,8,14,7,29
11232,11434,6,30,17,53
11232,11435,11,20,15,46
11232,11436,0,6,5,11
11232,11691,20,37,31,88
11232,11692,8,12,13,33
11232,11693,1,14,10,25
11232,11694,8,19,33,60
11232,11697,7,1,5,13
11233,10001,1,1,4,6
11233,10002,12,20,16,48
11233,10003,2,7,7,16
11233,10004,2,3,3,8
11233,10005,1,0,0,1
11233,10006,0,1,1,2
11233,10007,1,0,0,1
11233,10009,4,5,8,17
11233,10010,0,0,2,2
11233,10011,2,4,3,9
11233,10012,1,0,3,4
11233,10013,1,5,3,9
11233,10014,3,3,1,7
11233,10016,0,2,3,5
11233,10017,0,0,1,1
11233,10018,0,0,1,1
11233,10019,0,1,2,3
11233,10021,0,1,0,1
11233,10022,0,0,4,4
11233,10023,2,3,8,13
11233,10024,1,1,2,4
11233,10025,0,8,10,18
11233,10026,5,6,6,17
11233,10027,3,10,9,22
11233,10028,0,1,1,2
11233,10029,7,8,6,21
11233,10030,5,7,4,16
11233,10031,6,11,4,21
11233,10032,2,10,9,21
11233,10033,5,5,3,13
11233,10034,3,7,6,16
11233,10035,1,8,5,14
11233,10036,1,0,0,1
11233,10037,0,4,3,7
11233,10038,2,0,2,4
11233,10039,5,2,2,9
11233,10040,2,10,3,15
11233,10044,0,0,1,1
11233,10065,0,1,1,2
11233,10075,0,0,3,3
11233,10128,1,1,2,4
11233,10280,0,1,5,6
11233,10301,3,3,4,10
11233,10302,0,0,4,4
11233,10303,2,6,7,15
11233,10304,1,8,11,20
11233,10305,1,4,6,11
11233,10306,3,7,18,28
11233,10307,0,0,2,2
11233,10308,1,5,10,16
11233,10309,0,1,8,9
11233,10310,2,5,5,12
11233,10312,2,6,16,24
11233,10314,1,8,20,29
11233,10451,6,10,13,29
11233,10452,10,22,12,44
11233,10453,12,16,7,35
11233,10454,5,13,4,22
11233,10455,1,18,8,27
11233,10456,17,25,15,57
11233,10457,6,23,11,40
11233,10458,9,19,6,34
11233,10459,9,11,7,27
11233,10460,4,10,5,19
11233,10461,6,6,8,20
11233,10462,14,20,7,41
11233,10463,5,5,8,18
11233,10464,0,1,1,2
11233,10465,0,8,5,13
11233,10466,3,23,10,36
11233,10467,10,18,10,38
11233,10468,7,24,10,41
11233,10469,2,18,7,27
11233,10470,0,4,1,5
11233,10471,1,3,2,6
11233,10472,22,26,10,58
11233,10473,14,17,9,40
11233,10474,0,3,3,6
11233,10475,5,13,7,25
11233,11001,1,1,2,4
11233,11004,1,4,3,8
11233,11005,0,2,2,4
11233,11101,5,9,5,19
11233,11102,5,9,9,23
11233,11103,2,5,5,12
11233,11104,2,8,8,18
11233,11105,4,5,12,21
11233,11106,5,7,8,20
11233,11109,0,0,1,1
11233,11201,10,18,18,46
11233,11203,33,95,86,214
11233,11204,4,12,14,30
11233,11205,7,28,29,64
11233,11206,25,53,33,111
11233,11207,81,181,82,344
11233,11208,90,135,61,286
11233,11209,7,3,13,23
11233,11210,29,101,42,172
11233,11211,20,30,25,75
11233,11212,66,150,85,301
11233,11213,53,96,52,201
11233,11214,6,6,11,23
11233,11215,12,18,17,47
11233,11216,34,53,38,125
11233,11217,9,14,22,45
11233,11218,12,29,37,78
11233,11219,22,14,16,52
11233,11220,26,24,22,72
11233,11221,43,81,50,174
11233,11222,6,7,14,27
11233,11223,6,9,10,25
11233,11224,13,6,10,29
11233,11225,25,71,55,151
11233,11226,40,91,61,192
11233,11228,2,1,2,5
11233,11229,10,10,23,43
11233,11230,11,23,37,71
11233,11231,11,21,16,48
11233,11232,8,3,8,19
11233,11233,126,202,82,410
11233,11234,32,67,63,162
11233,11235,9,5,20,34
11233,11236,66,123,99,288
11233,11237,9,16,21,46
11233,11238,16,28,40,84
11233,11239,5,11,21,37
11233,11354,1,6,4,11
11233,11355,3,8,8,19
11233,11356,1,0,3,4
11233,11357,0,4,6,10
11233,11358,0,2,9,11
11233,11360,0,2,3,5
11233,11361,0,0,4,4
11233,11362,0,1,0,1
11233,11364,0,2,6,8
11233,11365,0,4,11,15
11233,11366,3,5,1,9
11233,11367,2,6,4,12
11233,11368,10,23,30,63
11233,11369,1,7,10,18
11233,11370,0,8,8,16
11233,11372,9,20,9,38
11233,11373,21,24,23,68
11233,11374,5,6,10,21
11233,11375,11,6,20,37
11233,11377,21,36,25,82
11233,11378,7,10,17,34
11233,11379,4,5,12,21
11233,11385,14,31,48,93
11233,11411,5,8,11,24
11233,11412,6,16,22,44
11233,11413,11,13,14,38
11233,11414,1,7,9,17
11233,11415,2,2,8,12
11233,11416,11,8,8,27
11233,11417,8,21,13,42
11233,11418,11,9,10,30
11233,11419,7,17,24,48
11233,11420,7,21,27,55
11233,11421,5,23,21,49
11233,11422,10,6,13,29
11233,11423,7,9,9,25
11233,11426,4,5,4,13
11233,11427,1,4,7,12
11233,11428,7,8,3,18
11233,11429,5,7,8,20
11233,11432,14,33,10,57
11233,11433,8,9,11,28
11233,11434,16,18,20,54
11233,11435,7,23,19,49
11233,11436,5,11,5,21
11233,11691,12,24,27,63
11233,11692,4,20,10,34
11233,11693,2,6,5,13
11233,11694,3,7,9,19
11233,11697,1,0,3,4
11234,10001,1,3,0,4
11234,10002,10,9,10,29
11234,10003,3,3,2,8
11234,10004,1,0,1,2
11234,10005,1,2,3,6
11234,10006,0,0,3,3
11234,10007,1,1,0,2
11234,10009,8,11,6,25
11234,10010,1,2,3,6
11234,10011,5,5,9,19
11234,10012,3,0,4,7
11234,10013,3,1,4,8
11234,10014,3,1,1,5
11234,10016,4,2,8,14
11234,10017,0,1,2,3
11234,10018,1,2,0,3
11234,10019,2,5,5,12
11234,10021,1,2,5,8
11234,10022,0,0,1,1
11234,10023,4,3,6,13
11234,10024,2,2,5,9
11234,10025,10,9,13,32
11234,10026,7,7,11,25
11234,10027,7,11,8,26
11234,10028,0,1,4,5
11234,10029,11,11,15,37
11234,10030,4,6,4,14
11234,10031,10,13,4,27
11234,10032,6,7,3,16
11234,10033,13,16,5,34
11234,10034,3,9,5,17
11234,10035,5,7,6,18
11234,10036,3,3,2,8
11234,10037,4,2,4,10
11234,10038,1,1,2,4
11234,10039,3,1,5,9
11234,10040,5,5,4,14
11234,10044,1,0,1,2
11234,10065,0,1,2,3
11234,10069,0,1,0,1
11234,10075,1,1,3,5
11234,10128,2,4,14,20
11234,10162,0,0,1,1
11234,10280,0,0,2,2
11234,10282,0,1,0,1
11234,10301,13,28,25,66
11234,10302,4,12,14,30
11234,10303,17,13,12,42
11234,10304,12,27,19,58
11234,10305,18,18,30,66
11234,10306,23,35,38,96
11234,10307,7,6,15,28
11234,10308,12,12,31,55
11234,10309,28,23,25,76
11234,10310,8,16,11,35
11234,10312,33,44,50,127
11234,10314,49,60,57,166
11234,10451,8,7,2,17
11234,10452,14,13,7,34
11234,10453,19,17,6,42
11234,10454,12,10,2,24
11234,10455,5,10,6,21
11234,10456,13,15,12,40
11234,10457,20,18,13,51
11234,10458,12,22,10,44
11234,10459,14,7,8,29
11234,10460,8,14,5,27
11234,10461,6,7,6,19
11234,10462,14,17,11,42
11234,10463,5,10,6,21
11234,10465,8,4,12,24
11234,10466,21,23,11,55
11234,10467,15,39,17,71
11234,10468,16,26,14,56
11234,10469,3,12,15,30
11234,10470,6,2,2,10
11234,10471,3,2,4,9
11234,10472,16,13,9,38
11234,10473,12,12,7,31
11234,10474,6,2,1,9
11234,10475,11,5,13,29
11234,11001,3,2,1,6
11234,11004,7,7,6,20
11234,11005,0,0,1,1
11234,11040,0,0,2,2
11234,11101,9,9,3,21
11234,11102,7,3,8,18
11234,11103,3,7,3,13
11234,11104,3,16,6,25
11234,11105,8,10,6,24
11234,11106,5,7,12,24
11234,11109,0,3,1,4
11234,11201,8,17,14,39
11234,11203,153,199,92,444
11234,11204,82,124,50,256
11234,11205,12,13,17,42
11234,11206,22,37,25,84
11234,11207,95,147,75,317
11234,11208,82,123,60,265
11234,11209,73,85,64,222
11234,11210,158,189,145,492
11234,11211,7,17,15,39
11234,11212,142,178,67,387
11234,11213,67,81,48,196
11234,11214,101,147,71,319
11234,11215,27,40,37,104
11234,11216,36,48,24,108
11234,11217,17,12,14,43
11234,11218,72,85,56,213
11234,11219,62,60,47,169
11234,11220,77,81,39,197
11234,11221,34,52,31,117
11234,11222,2,6,9,17
11234,11223,117,168,90,375
11234,11224,92,116,54,262
11234,11225,66,92,34,192
11234,11226,167,199,75,441
11234,11228,52,47,57,156
11234,11229,225,272,158,655
11234,11230,134,202,140,476
11234,11231,19,20,17,56
11234,11232,15,29,15,59
11234,11233,54,78,44,176
11234,11234,763,712,461,1936
11234,11235,124,240,142,506
11234,11236,222,271,113,606
11234,11237,15,41,13,69
11234,11238,28,22,30,80
11234,11239,15,19,18,52
11234,11354,4,7,6,17
11234,11355,9,14,6,29
11234,11356,4,2,1,7
11234,11357,9,9,7,25
11234,11358,8,11,9,28
11234,11360,7,3,7,17
11234,11361,3,6,10,19
11234,11362,3,5,4,12
11234,11363,1,1,1,3
11234,11364,6,5,7,18
11234,11365,7,21,12,40
11234,11366,5,7,10,22
11234,11367,13,15,13,41
11234,11368,15,28,10,53
11234,11369,10,10,6,26
11234,11370,3,6,6,15
11234,11372,17,23,8,48
11234,11373,21,27,17,65
11234,11374,8,15,19,42
11234,11375,19,19,38,76
11234,11377,16,22,11,49
11234,11378,11,24,12,47
11234,11379,10,16,13,39
11234,11385,31,41,26,98
11234,11411,9,9,9,27
11234,11412,17,22,14,53
11234,11413,14,20,12,46
11234,11414,23,19,20,62
11234,11415,11,17,6,34
11234,11416,11,10,7,28
11234,11417,17,22,29,68
11234,11418,18,17,7,42
11234,11419,15,44,19,78
11234,11420,21,41,25,87
11234,11421,9,21,15,45
11234,11422,19,10,5,34
11234,11423,7,21,12,40
11234,11426,9,2,4,15
11234,11427,8,8,8,24
11234,11428,9,6,7,22
11234,11429,10,11,12,33
11234,11432,24,26,16,66
11234,11433,13,17,10,40
11234,11434,23,29,27,79
11234,11435,19,39,12,70
11234,11436,9,16,5,30
11234,11691,48,42,36,126
11234,11692,14,20,10,44
11234,11693,19,15,9,43
11234,11694,46,36,61,143
11234,11697,3,9,14,26
11235,10001,5,5,8,18
11235,10002,68,43,31,142
11235,10003,13,14,23,50
11235,10004,2,1,0,3
11235,10005,1,2,4,7
11235,10006,0,1,1,2
11235,10007,1,3,1,5
11235,10009,24,22,13,59
11235,10010,2,4,10,16
11235,10011,10,17,11,38
11235,10012,5,4,6,15
11235,10013,10,8,7,25
11235,10014,6,2,4,12
11235,10016,7,6,17,30
11235,10017,2,1,5,8
11235,10018,0,0,1,1
11235,10019,5,9,7,21
11235,10021,3,4,6,13
11235,10022,3,1,10,14
11235,10023,5,10,8,23
11235,10024,7,8,13,28
11235,10025,9,14,15,38
11235,10026,17,8,5,30
11235,10027,14,22,25,61
11235,10028,4,3,14,21
11235,10029,32,30,31,93
11235,10030,11,16,9,36
11235,10031,19,22,18,59
11235,10032,16,25,11,52
11235,10033,20,20,9,49
11235,10034,16,14,10,40
11235,10035,13,19,9,41
11235,10036,2,6,4,12
11235,10037,9,17,5,31
11235,10038,1,8,9,18
11235,10039,7,16,5,28
11235,10040,11,20,9,40
11235,10044,2,1,1,4
11235,10065,2,3,5,10
11235,10069,1,0,2,3
11235,10075,0,3,7,10
11235,10128,7,9,15,31
11235,10280,0,3,0,3
11235,10301,26,31,45,102
11235,10302,8,13,19,40
11235,10303,13,26,29,68
11235,10304,28,44,45,117
11235,10305,47,74,81,202
11235,10306,47,103,99,249
11235,10307,8,30,26,64
11235,10308,15,38,31,84
11235,10309,26,46,47,119
11235,10310,9,27,30,66
11235,10312,47,82,75,204
11235,10314,57,130,153,340
11235,10451,26,40,14,80
11235,10452,59,63,29,151
11235,10453,38,71,19,128
11235,10454,17,18,8,43
11235,10455,20,12,11,43
11235,10456,53,64,25,142
11235,10457,36,72,19,127
11235,10458,44,58,19,121
11235,10459,17,42,9,68
11235,10460,29,48,8,85
11235,10461,11,10,15,36
11235,10462,23,30,29,82
11235,10463,23,47,27,97
11235,10464,1,0,1,2
11235,10465,12,9,18,39
11235,10466,16,27,31,74
11235,10467,38,38,26,102
11235,10468,33,66,16,115
11235,10469,14,25,30,69
11235,10470,3,8,4,15
11235,10471,9,7,9,25
11235,10472,11,42,22,75
11235,10473,9,24,16,49
11235,10474,2,6,2,10
11235,10475,3,12,16,31
11235,11001,1,4,4,9
11235,11004,2,7,11,20
11235,11005,2,1,0,3
11235,11040,0,2,0,2
11235,11101,5,3,13,21
11235,11102,4,13,13,30
11235,11103,4,13,17,34
11235,11104,13,10,10,33
11235,11105,6,14,10,30
11235,11106,11,10,11,32
11235,11109,1,1,1,3
11235,11201,20,21,20,61
11235,11203,115,230,181,526
11235,11204,336,478,154,968
11235,11205,20,22,23,65
11235,11206,43,53,31,127
11235,11207,62,119,68,249
11235,11208,67,136,64,267
11235,11209,77,116,115,308
11235,11210,152,278,155,585
11235,11211,28,35,35,98
11235,11212,84,130,86,300
11235,11213,43,66,61,170
11235,11214,509,713,260,1482
11235,11215,19,34,46,99
11235,11216,27,35,33,95
11235,11217,21,20,17,58
11235,11218,209,315,93,617
11235,11219,169,188,81,438
11235,11220,164,192,89,445
11235,11221,43,49,36,128
11235,11222,17,10,10,37
11235,11223,450,643,272,1365
11235,11224,398,616,281,1295
11235,11225,72,93,83,248
11235,11226,199,309,201,709
11235,11228,78,109,66,253
11235,11229,661,1029,428,2118
11235,11230,537,698,256,1491
11235,11231,20,25,28,73
11235,11232,31,38,20,89
11235,11233,48,76,49,173
11235,11234,219,331,294,844
11235,11235,1476,2093,986,4555
11235,11236,158,214,236,608
11235,11237,24,37,16,77
11235,11238,20,44,25,89
11235,11239,21,31,15,67
11235,11354,30,23,15,68
11235,11355,53,46,19,118
11235,11356,4,10,9,23
11235,11357,13,15,18,46
11235,11358,14,24,16,54
11235,11360,4,7,9,20
11235,11361,8,13,12,33
11235,11362,7,6,6,19
11235,11363,2,2,3,7
11235,11364,11,16,12,39
11235,11365,18,36,23,77
11235,11366,15,15,9,39
11235,11367,23,38,33,94
11235,11368,55,72,31,158
11235,11369,13,20,10,43
11235,11370,23,32,11,66
11235,11372,24,38,8,70
11235,11373,47,88,39,174
11235,11374,66,107,32,205
11235,11375,105,165,73,343
11235,11377,20,32,29,81
11235,11378,18,26,20,64
11235,11379,15,33,21,69
11235,11385,52,83,54,189
11235,11411,7,9,7,23
11235,11412,17,24,16,57
11235,11413,18,23,25,66
11235,11414,14,20,16,50
11235,11415,11,29,13,53
11235,11416,19,33,13,65
11235,11417,12,23,24,59
11235,11418,27,31,13,71
11235,11419,33,49,36,118
11235,11420,22,33,31,86
11235,11421,27,39,17,83
11235,11422,11,18,33,62
11235,11423,20,26,16,62
11235,11426,7,9,5,21
11235,11427,6,9,15,30
11235,11428,7,10,12,29
11235,11429,11,13,17,41
11235,11432,49,54,32,135
11235,11433,15,21,17,53
11235,11434,30,36,36,102
11235,11435,20,44,39,103
11235,11436,15,10,12,37
11235,11691,96,82,64,242
11235,11692,37,26,16,79
11235,11693,35,59,32,126
11235,11694,21,32,30,83
11235,11697,1,0,10,11
11236,10001,1,3,3,7
11236,10002,10,11,16,37
11236,10003,1,3,12,16
11236,10004,0,2,1,3
11236,10005,0,2,2,4
11236,10007,0,0,2,2
11236,10009,2,11,7,20
11236,10010,0,0,2,2
11236,10011,0,2,8,10
11236,10012,1,5,4,10
11236,10013,1,1,4,6
11236,10014,0,4,5,9
11236,10016,2,3,6,11
11236,10017,1,0,1,2
11236,10018,0,0,3,3
11236,10019,2,5,8,15
11236,10021,0,0,5,5
11236,10022,1,0,3,4
11236,10023,1,4,12,17
11236,10024,0,2,5,7
11236,10025,4,2,15,21
11236,10026,2,9,10,21
11236,10027,8,10,12,30
11236,10028,0,3,6,9
11236,10029,5,12,13,30
11236,10030,4,1,5,10
11236,10031,2,7,10,19
11236,10032,2,7,12,21
11236,10033,2,8,14,24
11236,10034,1,8,9,18
11236,10035,1,3,10,14
11236,10036,0,4,2,6
11236,10037,2,2,5,9
11236,10038,1,1,1,3
11236,10039,3,3,5,11
11236,10040,2,4,6,12
11236,10044,0,0,2,2
11236,10065,0,1,2,3
11236,10069,0,0,2,2
11236,10075,0,0,5,5
11236,10119,0,1,0,1
11236,10128,1,3,10,14
11236,10280,0,1,2,3
11236,10301,5,14,13,32
11236,10302,5,5,6,16
11236,10303,2,10,12,24
11236,10304,8,20,19,47
11236,10305,5,13,22,40
11236,10306,6,20,39,65
11236,10307,5,2,11,18
11236,10308,4,8,22,34
11236,10309,8,10,18,36
11236,10310,8,11,14,33
11236,10312,5,21,41,67
11236,10314,19,28,62,109
11236,10451,2,10,4,16
11236,10452,8,13,9,30
11236,10453,7,22,8,37
11236,10454,4,7,6,17
11236,10455,2,9,2,13
11236,10456,7,14,13,34
11236,10457,10,25,8,43
11236,10458,10,21,8,39
11236,10459,5,10,6,21
11236,10460,5,9,11,25
11236,10461,1,8,8,17
11236,10462,12,17,15,44
11236,10463,2,8,12,22
11236,10464,0,0,2,2
11236,10465,1,6,5,12
11236,10466,5,20,19,44
11236,10467,9,16,10,35
11236,10468,4,14,11,29
11236,10469,5,20,9,34
11236,10470,2,4,3,9
11236,10471,0,1,3,4
11236,10472,5,14,14,33
11236,10473,1,10,13,24
11236,10474,1,5,1,7
11236,10475,4,4,19,27
11236,11001,1,0,2,3
11236,11004,4,8,15,27
11236,11005,2,0,2,4
11236,11040,0,3,0,3
11236,11101,3,5,6,14
11236,11102,2,7,9,18
11236,11103,5,5,15,25
11236,11104,2,5,13,20
11236,11105,5,3,8,16
11236,11106,1,2,12,15
11236,11109,1,0,0,1
11236,11201,9,15,39,63
11236,11203,113,263,136,512
11236,11204,37,32,31,100
11236,11205,12,27,10,49
11236,11206,49,57,51,157
11236,11207,97,230,124,451
11236,11208,83,177,91,351
11236,11209,6,21,33,60
11236,11210,79,127,105,311
11236,11211,17,33,27,77
11236,11212,133,241,101,475
11236,11213,45,123,67,235
11236,11214,22,46,41,109
11236,11215,14,16,45,75
11236,11216,29,51,59,139
11236,11217,8,14,22,44
11236,11218,31,60,43,134
11236,11219,48,63,40,151
11236,11220,50,61,32,143
11236,11221,29,85,59,173
11236,11222,7,14,14,35
11236,11223,29,51,44,124
11236,11224,15,41,26,82
11236,11225,47,83,76,206
11236,11226,92,233,103,428
11236,11228,14,25,36,75
11236,11229,32,66,103,201
11236,11230,52,94,91,237
11236,11231,6,20,21,47
11236,11232,10,8,12,30
11236,11233,54,104,87,245
11236,11234,140,226,194,560
11236,11235,17,56,58,131
11236,11236,349,590,265,1204
11236,11237,25,36,28,89
11236,11238,14,35,60,109
11236,11239,16,25,26,67
11236,11354,4,8,12,24
11236,11355,9,14,14,37
11236,11356,1,7,4,12
11236,11357,2,4,11,17
11236,11358,5,4,11,20
11236,11360,1,1,9,11
11236,11361,2,6,7,15
11236,11362,2,2,5,9
11236,11363,0,0,1,1
11236,11364,3,5,11,19
11236,11365,8,12,20,40
11236,11366,2,5,6,13
11236,11367,4,15,22,41
11236,11368,8,23,26,57
11236,11369,5,3,11,19
11236,11370,1,9,10,20
11236,11372,7,13,14,34
11236,11373,6,11,13,30
11236,11374,3,8,19,30
11236,11375,3,8,27,38
11236,11377,5,19,26,50
11236,11378,16,22,23,61
11236,11379,9,14,44,67
11236,11385,24,82,82,188
11236,11411,2,16,26,44
11236,11412,15,30,28,73
11236,11413,11,28,26,65
11236,11414,7,14,30,51
11236,11415,6,11,20,37
11236,11416,10,15,14,39
11236,11417,18,27,26,71
11236,11418,18,28,31,77
11236,11419,25,41,24,90
11236,11420,20,42,46,108
11236,11421,18,25,29,72
11236,11422,15,21,21,57
11236,11423,8,20,14,42
11236,11426,1,6,9,16
11236,11427,6,9,11,26
11236,11428,12,8,11,31
11236,11429,9,20,14,43
11236,11430,0,1,0,1
11236,11432,13,19,20,52
11236,11433,6,24,19,49
11236,11434,18,32,47,97
11236,11435,15,19,34,68
11236,11436,3,13,15,31
11236,11691,17,49,50,116
11236,11692,6,21,13,40
11236,11693,8,9,15,32
11236,11694,18,16,37,71
11236,11697,2,1,10,13
11237,10001,5,13,9,27
11237,10002,49,59,21,129
11237,10003,12,11,21,44
11237,10004,2,2,8,12
11237,10005,0,0,9,9
11237,10007,4,3,5,12
11237,10009,19,25,31,75
11237,10010,7,3,10,20
11237,10011,5,11,19,35
11237,10012,5,6,14,25
11237,10013,13,14,4,31
11237,10014,8,5,11,24
11237,10016,8,10,26,44
11237,10017,4,2,8,14
11237,10018,1,1,5,7
11237,10019,8,13,19,40
11237,10021,1,5,10,16
11237,10022,1,6,14,21
11237,10023,7,3,11,21
11237,10024,4,5,18,27
11237,10025,10,19,31,60
11237,10026,9,12,15,36
11237,10027,13,24,19,56
11237,10028,11,6,16,33
11237,10029,12,26,19,57
11237,10030,10,12,10,32
11237,10031,14,18,19,51
11237,10032,14,21,12,47
11237,10033,7,15,11,33
11237,10034,9,14,11,34
11237,10035,12,15,13,40
11237,10036,5,7,13,25
11237,10037,10,8,7,25
11237,10038,3,3,9,15
11237,10039,1,9,7,17
11237,10040,4,6,12,22
11237,10044,7,0,1,8
11237,10065,1,4,11,16
11237,10069,0,0,2,2
11237,10075,1,2,6,9
11237,10128,1,17,24,42
11237,10280,0,0,2,2
11237,10282,1,0,0,1
11237,10301,6,10,17,33
11237,10302,1,7,10,18
11237,10303,7,5,7,19
11237,10304,11,5,12,28
11237,10305,7,16,17,40
11237,10306,4,9,26,39
11237,10307,3,0,8,11
11237,10308,1,1,12,14
11237,10309,2,5,9,16
11237,10310,3,7,9,19
11237,10312,2,8,20,30
11237,10314,3,17,36,56
11237,10451,16,24,10,50
11237,10452,18,41,11,70
11237,10453,15,37,13,65
11237,10454,10,14,6,30
11237,10455,10,25,10,45
11237,10456,28,31,12,71
11237,10457,25,31,6,62
11237,10458,8,29,13,50
11237,10459,15,14,6,35
11237,10460,20,12,12,44
11237,10461,9,13,12,34
11237,10462,15,18,30,63
11237,10463,11,11,14,36
11237,10464,0,1,0,1
11237,10465,4,4,8,16
11237,10466,7,23,17,47
11237,10467,16,16,19,51
11237,10468,9,19,13,41
11237,10469,12,14,12,38
11237,10470,3,3,7,13
11237,10471,4,3,6,13
11237,10472,10,22,22,54
11237,10473,14,24,16,54
11237,10474,3,8,1,12
11237,10475,6,7,11,24
11237,11001,1,1,4,6
11237,11004,3,3,5,11
11237,11005,1,0,0,1
11237,11040,0,1,1,2
11237,11101,12,17,14,43
11237,11102,8,15,22,45
11237,11103,10,15,20,45
11237,11104,11,23,23,57
11237,11105,11,17,32,60
11237,11106,5,10,24,39
11237,11109,0,0,6,6
11237,11201,14,23,49,86
11237,11203,38,64,94,196
11237,11204,15,40,28,83
11237,11205,29,46,51,126
11237,11206,159,244,113,516
11237,11207,127,243,129,499
11237,11208,87,162,107,356
11237,11209,12,18,26,56
11237,11210,11,43,59,113
11237,11211,93,120,108,321
11237,11212,66,119,74,259
11237,11213,45,66,63,174
11237,11214,19,42,35,96
11237,11215,24,23,53,100
11237,11216,22,35,117,174
11237,11217,16,19,50,85
11237,11218,20,27,32,79
11237,11219,15,33,29,77
11237,11220,44,71,44,159
11237,11221,175,327,202,704
11237,11222,28,56,92,176
11237,11223,22,30,41,93
11237,11224,11,16,28,55
11237,11225,27,53,66,146
11237,11226,42,83,101,226
11237,11228,10,9,17,36
11237,11229,16,42,48,106
11237,11230,24,35,43,102
11237,11231,11,22,38,71
11237,11232,8,28,14,50
11237,11233,54,90,92,236
11237,11234,30,64,127,221
11237,11235,14,17,36,67
11237,11236,51,108,137,296
11237,11237,260,445,232,937
11237,11238,19,33,79,131
11237,11239,8,19,14,41
11237,11354,14,55,13,82
11237,11355,39,57,20,116
11237,11356,4,10,19,33
11237,11357,8,23,27,58
11237,11358,8,17,22,47
11237,11359,0,0,1,1
11237,11360,6,9,5,20
11237,11361,7,13,16,36
11237,11362,7,11,14,32
11237,11363,7,0,3,10
11237,11364,11,15,20,46
11237,11365,23,33,35,91
11237,11366,1,3,8,12
11237,11367,5,15,26,46
11237,11368,50,91,66,207
11237,11369,23,35,20,78
11237,11370,8,21,20,49
11237,11372,15,27,29,71
11237,11373,51,71,80,202
11237,11374,18,17,40,75
11237,11375,17,30,73,120
11237,11377,45,50,68,163
11237,11378,31,60,78,169
11237,11379,23,61,77,161
11237,11385,232,414,356,1002
11237,11411,15,11,23,49
11237,11412,11,22,19,52
11237,11413,15,25,47,87
11237,11414,5,28,30,63
11237,11415,5,10,23,38
11237,11416,28,34,16,78
11237,11417,14,44,32,90
11237,11418,15,26,41,82
11237,11419,34,52,54,140
11237,11420,10,46,33,89
11237,11421,33,97,60,190
11237,11422,13,21,24,58
11237,11423,6,15,18,39
11237,11426,5,9,13,27
11237,11427,4,11,10,25
11237,11428,3,18,17,38
11237,11429,8,12,19,39
11237,11432,15,42,32,89
11237,11433,10,21,16,47
11237,11434,12,26,32,70
11237,11435,12,21,43,76
11237,11436,6,5,10,21
11237,11691,23,35,17,75
11237,11692,7,25,19,51
11237,11693,5,8,15,28
11237,11694,1,16,16,33
11237,11697,1,3,3,7
11238,10001,3,2,5,10
11238,10002,25,24,33,82
11238,10003,7,10,20,37
11238,10004,5,2,7,14
11238,10005,0,0,3,3
11238,10006,0,1,2,3
11238,10007,1,3,2,6
11238,10009,8,13,28,49
11238,10010,3,6,5,14
11238,10011,7,10,19,36
11238,10012,5,6,9,20
11238,10013,7,5,6,18
11238,10014,5,13,17,35
11238,10016,6,5,15,26
11238,10017,1,1,7,9
11238,10018,0,0,2,2
11238,10019,7,2,11,20
11238,10021,6,2,12,20
11238,10022,3,3,6,12
11238,10023,2,8,13,23
11238,10024,3,5,8,16
11238,10025,7,9,28,44
11238,10026,5,7,15,27
11238,10027,6,12,16,34
11238,10028,1,2,10,13
11238,10029,8,11,18,37
11238,10030,4,5,7,16
11238,10031,3,11,11,25
11238,10032,5,3,16,24
11238,10033,6,6,14,26
11238,10034,5,3,7,15
11238,10035,0,4,6,10
11238,10036,2,2,14,18
11238,10037,5,2,5,12
11238,10038,5,3,18,26
11238,10039,4,5,6,15
11238,10040,3,7,8,18
11238,10044,1,1,6,8
11238,10065,3,3,6,12
11238,10069,0,0,3,3
11238,10075,2,0,6,8
11238,10119,0,1,0,1
11238,10128,4,7,17,28
11238,10280,1,0,3,4
11238,10301,5,14,12,31
11238,10302,2,6,11,19
11238,10303,2,9,11,22
11238,10304,5,7,16,28
11238,10305,4,11,18,33
11238,10306,5,8,28,41
11238,10307,0,1,2,3
11238,10308,1,7,11,19
11238,10309,1,5,17,23
11238,10310,3,1,16,20
11238,10312,2,6,30,38
11238,10314,8,14,51,73
11238,10451,4,7,3,14
11238,10452,7,11,14,32
11238,10453,7,7,3,17
11238,10454,2,7,4,13
11238,10455,3,5,4,12
11238,10456,6,14,13,33
11238,10457,2,9,11,22
11238,10458,5,13,11,29
11238,10459,3,9,3,15
11238,10460,3,4,6,13
11238,10461,1,5,8,14
11238,10462,5,8,8,21
11238,10463,3,10,11,24
11238,10464,0,0,2,2
11238,10465,3,6,6,15
11238,10466,2,6,5,13
11238,10467,3,9,29,41
11238,10468,4,12,8,24
11238,10469,0,6,11,17
11238,10470,2,2,3,7
11238,10471,1,2,1,4
11238,10472,2,8,7,17
11238,10473,4,5,9,18
11238,10474,2,3,1,6
11238,10475,0,5,9,14
11238,11001,0,2,0,2
11238,11004,0,4,3,7
11238,11005,0,1,0,1
11238,11040,0,0,1,1
11238,11101,7,7,16,30
11238,11102,2,7,5,14
11238,11103,4,2,7,13
11238,11104,7,7,15,29
11238,11105,1,3,12,16
11238,11106,12,5,11,28
11238,11109,0,3,3,6
11238,11201,14,25,61,100
11238,11203,50,79,90,219
11238,11204,25,28,29,82
11238,11205,37,54,58,149
11238,11206,60,69,64,193
11238,11207,35,84,64,183
11238,11208,48,73,60,181
11238,11209,29,38,85,152
11238,11210,30,61,69,160
11238,11211,27,42,46,115
11238,11212,44,74,77,195
11238,11213,65,99,78,242
11238,11214,19,34,27,80
11238,11215,50,50,144,244
11238,11216,87,110,135,332
11238,11217,39,43,88,170
11238,11218,39,58,62,159
11238,11219,23,40,40,103
11238,11220,65,63,67,195
11238,11221,65,77,90,232
11238,11222,11,17,47,75
11238,11223,24,29,34,87
11238,11224,13,23,24,60
11238,11225,52,79,96,227
11238,11226,85,130,109,324
11238,11228,20,25,24,69
11238,11229,22,24,41,87
11238,11230,53,51,67,171
11238,11231,19,29,56,104
11238,11232,24,20,22,66
11238,11233,55,103,82,240
11238,11234,29,58,100,187
11238,11235,17,27,48,92
11238,11236,32,118,89,239
11238,11237,25,38,26,89
11238,11238,203,179,215,597
11238,11239,6,8,10,24
11238,11354,5,5,7,17
11238,11355,14,13,5,32
11238,11356,5,4,3,12
11238,11357,5,8,6,19
11238,11358,1,2,7,10
11238,11360,0,0,3,3
11238,11361,1,1,5,7
11238,11362,1,1,4,6
11238,11363,0,0,1,1
11238,11364,2,1,10,13
11238,11365,5,3,7,15
11238,11366,2,1,1,4
11238,11367,3,6,17,26
11238,11368,20,11,16,47
11238,11369,0,7,5,12
11238,11370,7,9,5,21
11238,11371,1,0,0,1
11238,11372,3,6,12,21
11238,11373,14,22,24,60
11238,11374,12,5,17,34
11238,11375,10,9,26,45
11238,11377,22,28,31,81
11238,11378,7,9,17,33
11238,11379,14,14,22,50
11238,11385,22,34,60,116
11238,11411,1,7,6,14
11238,11412,3,7,11,21
11238,11413,4,8,11,23
11238,11414,1,11,13,25
11238,11415,1,3,10,14
11238,11416,5,9,12,26
11238,11417,6,3,20,29
11238,11418,4,11,15,30
11238,11419,8,15,21,44
11238,11420,5,25,23,53
11238,11421,7,15,26,48
11238,11422,2,10,8,20
11238,11423,0,5,10,15
11238,11426,1,2,6,9
11238,11427,5,5,5,15
11238,11428,1,3,8,12
11238,11429,1,5,6,12
11238,11432,5,15,24,44
11238,11433,2,5,10,17
11238,11434,5,14,19,38
11238,11435,3,8,12,23
11238,11436,2,2,7,11
11238,11691,12,11,26,49
11238,11692,2,0,7,9
11238,11693,1,3,4,8
11238,11694,4,4,11,19
11238,11697,0,4,4,8
11239,10001,1,0,1,2
11239,10002,1,2,1,4
11239,10003,0,1,2,3
11239,10006,0,2,0,2
11239,10009,2,2,3,7
11239,10010,0,0,3,3
11239,10011,1,3,2,6
11239,10012,1,0,2,3
11239,10013,2,1,0,3
11239,10016,0,0,1,1
11239,10019,1,0,1,2
11239,10023,0,0,5,5
11239,10024,0,0,3,3
11239,10025,3,0,3,6
11239,10026,1,3,1,5
11239,10027,2,1,5,8
11239,10028,1,0,2,3
11239,10029,5,11,6,22
11239,10030,5,0,1,6
11239,10031,3,1,1,5
11239,10032,3,3,2,8
11239,10033,1,3,0,4
11239,10034,0,3,1,4
11239,10035,4,3,4,11
11239,10037,2,1,2,5
11239,10038,1,3,3,7
11239,10039,1,0,3,4
11239,10040,2,1,1,4
11239,10044,0,0,1,1
11239,10065,0,1,1,2
11239,10128,0,1,1,2
11239,10280,0,0,1,1
11239,10301,4,1,1,6
11239,10302,4,2,1,7
11239,10303,2,3,1,6
11239,10304,3,3,3,9
11239,10305,2,4,3,9
11239,10306,4,4,1,9
11239,10307,0,1,6,7
11239,10308,1,2,6,9
11239,10309,3,4,3,10
11239,10310,1,3,0,4
11239,10312,4,4,9,17
11239,10314,3,4,5,12
11239,10451,6,4,3,13
11239,10452,4,8,2,14
11239,10453,1,10,1,12
11239,10454,2,2,0,4
11239,10455,3,1,1,5
11239,10456,6,6,0,12
11239,10457,2,3,4,9
11239,10458,1,5,5,11
11239,10459,2,5,1,8
11239,10460,2,5,5,12
11239,10461,3,0,2,5
11239,10462,9,8,2,19
11239,10463,2,5,2,9
11239,10465,1,2,1,4
11239,10466,3,7,4,14
11239,10467,5,15,4,24
11239,10468,3,5,3,11
11239,10469,5,6,3,14
11239,10470,1,1,0,2
11239,10471,1,2,1,4
11239,10472,3,4,2,9
11239,10473,2,5,0,7
11239,10474,0,1,1,2
11239,10475,0,4,1,5
11239,11001,0,1,0,1
11239,11004,0,2,0,2
11239,11040,0,1,0,1
11239,11101,5,1,2,8
11239,11102,1,0,4,5
11239,11103,0,0,3,3
11239,11104,1,5,1,7
11239,11105,1,2,3,6
11239,11106,2,1,1,4
11239,11109,0,0,1,1
11239,11201,3,5,4,12
11239,11203,12,22,15,49
11239,11204,2,10,4,16
11239,11205,3,6,3,12
11239,11206,9,13,11,33
11239,11207,64,77,25,166
11239,11208,52,56,17,125
11239,11209,1,5,1,7
11239,11210,10,28,10,48
11239,11211,2,7,7,16
11239,11212,35,44,14,93
11239,11213,13,23,9,45
11239,11214,7,17,11,35
11239,11215,3,2,6,11
11239,11216,10,9,8,27
11239,11217,2,5,2,9
11239,11218,4,4,11,19
11239,11219,2,5,8,15
11239,11220,8,6,6,20
11239,11221,7,22,4,33
11239,11222,1,3,4,8
11239,11223,7,8,6,21
11239,11224,2,13,7,22
11239,11225,7,3,8,18
11239,11226,23,21,20,64
11239,11228,1,2,3,6
11239,11229,14,13,19,46
11239,11230,1,9,6,16
11239,11231,1,5,2,8
11239,11232,1,2,3,6
11239,11233,14,28,13,55
11239,11234,19,27,30,76
11239,11235,9,7,5,21
11239,11236,49,55,30,134
11239,11237,9,5,6,20
11239,11238,5,13,3,21
11239,11239,35,47,14,96
11239,11354,1,9,2,12
11239,11355,7,3,8,18
11239,11356,3,2,4,9
11239,11357,0,0,8,8
11239,11358,0,1,4,5
11239,11360,0,1,0,1
11239,11361,2,1,0,3
11239,11362,2,0,1,3
11239,11364,0,2,1,3
11239,11365,5,0,2,7
11239,11366,4,1,0,5
11239,11367,4,4,4,12
11239,11368,16,11,5,32
11239,11369,8,4,1,13
11239,11370,2,4,2,8
11239,11372,3,7,6,16
11239,11373,6,15,2,23
11239,11374,0,5,5,10
11239,11375,4,5,1,10
11239,11377,13,10,7,30
11239,11378,3,3,11,17
11239,11379,5,5,7,17
11239,11385,10,17,15,42
11239,11411,2,4,5,11
11239,11412,4,13,6,23
11239,11413,10,13,3,26
11239,11414,6,8,12,26
11239,11415,4,3,1,8
11239,11416,8,10,6,24
11239,11417,8,9,2,19
11239,11418,4,5,7,16
11239,11419,4,11,9,24
11239,11420,10,7,2,19
11239,11421,3,9,5,17
11239,11422,6,10,7,23
11239,11423,3,7,3,13
11239,11426,0,5,2,7
11239,11427,5,3,4,12
11239,11428,2,1,8,11
11239,11429,3,15,7,25
11239,11432,12,8,3,23
11239,11433,9,7,3,19
11239,11434,18,23,15,56
11239,11435,7,10,6,23
11239,11436,3,6,3,12
11239,11691,13,11,5,29
11239,11692,3,5,6,14
11239,11693,2,4,2,8
11239,11694,6,2,8,16
11239,11697,0,2,0,2
11351,10001,0,0,1,1
11351,10002,0,1,1,2
11351,10003,0,0,1,1
11351,10006,0,0,1,1
11351,10009,0,0,3,3
11351,10010,0,0,3,3
11351,10011,2,1,0,3
11351,10012,0,0,2,2
11351,10016,0,0,2,2
11351,10017,0,0,1,1
11351,10019,1,0,1,2
11351,10021,2,0,3,5
11351,10023,0,0,4,4
11351,10024,0,0,4,4
11351,10025,0,1,6,7
11351,10026,0,0,2,2
11351,10027,3,0,2,5
11351,10028,0,1,0,1
11351,10029,1,1,4,6
11351,10030,0,0,3,3
11351,10031,0,1,1,2
11351,10032,2,2,0,4
11351,10033,1,0,3,4
11351,10034,0,0,2,2
11351,10035,0,2,1,3
11351,10037,0,1,3,4
11351,10039,0,1,0,1
11351,10040,0,0,2,2
11351,10044,0,0,5,5
11351,10075,0,1,3,4
11351,10128,0,0,2,2
11351,10301,0,1,0,1
11351,10302,1,1,0,2
11351,10304,1,1,0,2
11351,10306,1,0,0,1
11351,10451,1,1,6,8
11351,10452,1,0,0,1
11351,10453,0,4,0,4
11351,10455,1,0,0,1
11351,10456,2,2,1,5
11351,10457,2,5,1,8
11351,10458,1,0,2,3
11351,10459,0,1,1,2
11351,10460,1,0,3,4
11351,10461,0,2,0,2
11351,10462,1,3,1,5
11351,10463,0,1,1,2
11351,10465,0,1,2,3
11351,10466,3,1,2,6
11351,10467,4,5,3,12
11351,10468,0,1,1,2
11351,10469,3,3,1,7
11351,10471,0,0,1,1
11351,10472,4,0,1,5
11351,10473,0,3,1,4
11351,10475,0,2,5,7
11351,11101,1,8,3,12
11351,11102,0,0,3,3
11351,11103,0,0,2,2
11351,11104,0,0,3,3
11351,11105,1,0,2,3
11351,11106,2,4,1,7
11351,11109,0,0,1,1
11351,11201,0,0,7,7
11351,11203,5,17,4,26
11351,11205,1,3,2,6
11351,11206,3,6,4,13
11351,11207,1,15,6,22
11351,11208,2,8,5,15
11351,11209,1,0,4,5
11351,11210,4,8,5,17
11351,11211,0,3,1,4
11351,11212,6,19,6,31
11351,11213,1,10,8,19
11351,11215,1,1,2,4
11351,11216,8,11,6,25
11351,11217,0,0,3,3
11351,11219,0,0,1,1
11351,11220,1,1,0,2
11351,11221,3,5,5,13
11351,11222,0,0,2,2
11351,11223,0,3,1,4
11351,11224,1,3,1,5
11351,11225,1,5,2,8
11351,11226,0,12,6,18
11351,11228,0,1,0,1
11351,11230,0,1,1,2
11351,11231,1,0,2,3
11351,11233,3,7,4,14
11351,11234,2,12,1,15
11351,11235,1,1,1,3
11351,11236,3,16,8,27
11351,11237,1,3,0,4
11351,11238,0,2,5,7
11351,11239,0,3,0,3
11351,11354,5,16,7,28
11351,11355,4,10,1,15
11351,11356,1,0,2,3
11351,11357,3,3,4,10
11351,11358,1,2,3,6
11351,11360,0,1,3,4
11351,11361,1,0,0,1
11351,11362,2,0,1,3
11351,11363,1,0,0,1
11351,11364,1,1,0,2
11351,11365,4,2,4,10
11351,11366,0,1,0,1
11351,11367,0,2,1,3
11351,11368,1,4,3,8
11351,11369,0,5,1,6
11351,11372,0,2,0,2
11351,11373,1,3,0,4
11351,11374,0,1,1,2
11351,11375,0,1,7,8
11351,11377,1,0,2,3
11351,11378,1,1,1,3
11351,11379,0,5,3,8
11351,11385,2,0,4,6
11351,11411,6,18,0,24
11351,11412,4,25,13,42
11351,11413,4,15,17,36
11351,11414,0,1,1,2
11351,11416,0,3,0,3
11351,11417,0,3,1,4
11351,11418,4,5,4,13
11351,11419,0,11,6,17
11351,11420,0,8,4,12
11351,11421,2,0,4,6
11351,11422,6,21,15,42
11351,11423,0,12,1,13
11351,11426,1,1,1,3
11351,11427,0,2,9,11
11351,11428,0,2,0,2
11351,11429,2,21,8,31
11351,11432,2,8,6,16
11351,11433,4,21,3,28
11351,11434,10,23,13,46
11351,11435,4,9,6,19
11351,11436,1,9,4,14
11351,11691,1,13,0,14
11351,11692,1,4,0,5
11351,11694,0,5,0,5
11351,11697,0,1,0,1
11354,10001,7,3,16,26
11354,10002,99,110,26,235
11354,10003,24,29,17,70
11354,10004,1,0,3,4
11354,10005,5,1,4,10
11354,10006,1,0,0,1
11354,10007,4,3,4,11
11354,10009,23,29,15,67
11354,10010,7,5,15,27
11354,10011,8,10,23,41
11354,10012,7,12,8,27
11354,10013,15,15,8,38
11354,10014,4,9,8,21
11354,10016,4,7,24,35
11354,10017,3,3,14,20
11354,10018,0,2,3,5
11354,10019,9,12,18,39
11354,10021,1,6,19,26
11354,10022,2,2,9,13
11354,10023,10,12,15,37
11354,10024,2,6,23,31
11354,10025,9,11,35,55
11354,10026,6,5,13,24
11354,10027,12,24,22,58
11354,10028,3,10,15,28
11354,10029,36,42,32,110
11354,10030,16,9,12,37
11354,10031,6,12,29,47
11354,10032,13,15,23,51
11354,10033,6,13,32,51
11354,10034,8,9,18,35
11354,10035,18,18,23,59
11354,10036,6,11,9,26
11354,10037,3,7,9,19
11354,10038,14,14,4,32
11354,10039,10,10,11,31
11354,10040,8,9,19,36
11354,10044,0,3,9,12
11354,10065,5,6,7,18
11354,10069,1,0,1,2
11354,10075,4,2,15,21
11354,10128,11,15,18,44
11354,10280,2,2,2,6
11354,10282,3,1,1,5
11354,10301,18,15,14,47
11354,10302,5,0,8,13
11354,10303,7,13,14,34
11354,10304,13,20,20,53
11354,10305,10,7,14,31
11354,10306,12,13,30,55
11354,10307,2,0,2,4
11354,10308,5,7,16,28
11354,10309,4,4,12,20
11354,10310,3,9,11,23
11354,10312,9,13,27,49
11354,10314,15,27,38,80
11354,10451,16,27,19,62
11354,10452,16,27,25,68
11354,10453,25,40,29,94
11354,10454,16,15,16,47
11354,10455,21,17,22,60
11354,10456,34,34,48,116
11354,10457,16,55,30,101
11354,10458,21,39,42,102
11354,10459,24,27,22,73
11354,10460,33,42,45,120
11354,10461,16,35,34,85
11354,10462,39,68,75,182
11354,10463,8,11,32,51
11354,10464,4,1,4,9
11354,10465,22,27,65,114
11354,10466,20,37,31,88
11354,10467,33,46,54,133
11354,10468,13,27,37,77
11354,10469,20,32,45,97
11354,10470,4,8,15,27
11354,10471,0,5,8,13
11354,10472,34,46,31,111
11354,10473,18,45,42,105
11354,10474,4,8,4,16
11354,10475,16,24,27,67
11354,11001,2,6,6,14
11354,11004,12,23,22,57
11354,11005,1,0,1,2
11354,11040,3,2,3,8
11354,11101,23,38,40,101
11354,11102,23,25,30,78
11354,11103,23,27,50,100
11354,11104,31,39,38,108
11354,11105,28,39,43,110
11354,11106,23,33,38,94
11354,11109,0,4,10,14
11354,11201,7,16,22,45
11354,11203,23,24,33,80
11354,11204,41,41,19,101
11354,11205,9,12,21,42
11354,11206,27,37,37,101
11354,11207,35,55,76,166
11354,11208,62,78,62,202
11354,11209,23,24,28,75
11354,11210,14,22,31,67
11354,11211,25,28,33,86
11354,11212,25,38,41,104
11354,11213,7,26,20,53
11354,11214,44,75,29,148
11354,11215,9,11,21,41
11354,11216,17,27,21,65
11354,11217,6,8,15,29
11354,11218,33,32,25,90
11354,11219,43,45,20,108
11354,11220,65,84,21,170
11354,11221,11,27,33,71
11354,11222,16,18,16,50
11354,11223,34,46,36,116
11354,11224,11,19,18,48
11354,11225,9,13,21,43
11354,11226,27,47,32,106
11354,11228,27,24,18,69
11354,11229,27,40,32,99
11354,11230,15,18,19,52
11354,11231,6,1,12,19
11354,11232,20,22,10,52
11354,11233,12,24,24,60
11354,11234,21,32,48,101
11354,11235,19,42,29,90
11354,11236,16,54,47,117
11354,11237,8,39,23,70
11354,11238,10,22,19,51
11354,11239,7,14,8,29
11354,11354,887,1049,385,2321
11354,11355,1246,1263,295,2804
11354,11356,177,212,138,527
11354,11357,175,220,175,570
11354,11358,275,363,211,849
11354,11359,1,3,2,6
11354,11360,38,69,96,203
11354,11361,141,182,121,444
11354,11362,54,87,65,206
11354,11363,13,22,39,74
11354,11364,219,256,183,658
11354,11365,211,284,164,659
11354,11366,35,75,29,139
11354,11367,155,160,62,377
11354,11368,207,296,131,634
11354,11369,55,104,62,221
11354,11370,26,33,41,100
11354,11371,0,2,0,2
11354,11372,69,105,88,262
11354,11373,265,285,125,675
11354,11374,44,58,77,179
11354,11375,87,96,118,301
11354,11377,128,139,99,366
11354,11378,56,71,70,197
11354,11379,31,51,81,163
11354,11385,56,90,114,260
11354,11411,10,39,46,95
11354,11412,34,75,74,183
11354,11413,31,64,56,151
11354,11414,8,17,42,67
11354,11415,17,25,18,60
11354,11416,23,30,20,73
11354,11417,24,34,39,97
11354,11418,22,61,44,127
11354,11419,38,66,61,165
11354,11420,30,78,75,183
11354,11421,51,72,59,182
11354,11422,28,45,50,123
11354,11423,31,59,44,134
11354,11426,19,22,35,76
11354,11427,28,68,47,143
11354,11428,36,52,40,128
11354,11429,24,48,57,129
11354,11430,0,1,2,3
11354,11432,85,102,68,255
11354,11433,32,69,61,162
11354,11434,49,127,114,290
11354,11435,45,88,79,212
11354,11436,13,44,38,95
11354,11691,24,20,27,71
11354,11692,10,5,11,26
11354,11693,7,8,3,18
11354,11694,5,17,11,33
11354,11697,0,2,2,4
11355,10001,10,9,6,25
11355,10002,207,204,18,429
11355,10003,46,49,8,103
11355,10004,4,4,1,9
11355,10005,5,8,1,14
11355,10006,1,3,0,4
11355,10007,3,8,3,14
11355,10009,69,57,10,136
11355,10010,5,8,4,17
11355,10011,8,13,12,33
11355,10012,15,21,3,39
11355,10013,49,40,5,94
11355,10014,13,24,6,43
11355,10016,5,9,10,24
11355,10017,0,5,2,7
11355,10018,2,2,7,11
11355,10019,12,17,9,38
11355,10021,1,5,17,23
11355,10022,2,5,6,13
11355,10023,4,12,6,22
11355,10024,2,10,13,25
11355,10025,11,26,16,53
11355,10026,9,6,5,20
11355,10027,9,12,17,38
11355,10028,3,3,13,19
11355,10029,60,58,21,139
11355,10030,10,5,5,20
11355,10031,2,7,10,19
11355,10032,6,13,6,25
11355,10033,7,9,13,29
11355,10034,1,6,3,10
11355,10035,24,7,8,39
11355,10036,6,11,2,19
11355,10037,3,1,8,12
11355,10038,21,22,5,48
11355,10039,5,1,7,13
11355,10040,4,8,2,14
11355,10044,0,2,6,8
11355,10065,3,4,7,14
11355,10069,0,0,1,1
11355,10075,0,3,5,8
11355,10128,5,10,14,29
11355,10162,0,1,0,1
11355,10280,4,7,3,14
11355,10282,1,5,0,6
11355,10301,12,11,14,37
11355,10302,5,8,4,17
11355,10303,10,8,4,22
11355,10304,22,16,9,47
11355,10305,19,12,14,45
11355,10306,14,10,12,36
11355,10307,0,0,3,3
11355,10308,4,3,5,12
11355,10309,2,7,4,13
11355,10310,5,5,7,17
11355,10312,7,13,14,34
11355,10314,55,56,24,135
11355,10451,7,11,6,24
11355,10452,6,16,8,30
11355,10453,2,12,7,21
11355,10454,4,10,10,24
11355,10455,10,15,20,45
11355,10456,12,21,15,48
11355,10457,11,20,12,43
11355,10458,14,14,12,40
11355,10459,22,14,13,49
11355,10460,14,14,16,44
11355,10461,10,19,21,50
11355,10462,20,38,43,101
11355,10463,10,7,13,30
11355,10464,0,1,1,2
11355,10465,11,12,30,53
11355,10466,8,7,15,30
11355,10467,8,11,17,36
11355,10468,9,17,8,34
11355,10469,7,11,15,33
11355,10470,2,5,5,12
11355,10471,4,3,6,13
11355,10472,28,32,20,80
11355,10473,13,26,18,57
11355,10474,4,3,3,10
11355,10475,7,14,18,39
11355,11001,0,7,11,18
11355,11003,0,0,1,1
11355,11004,12,24,48,84
11355,11005,0,1,4,5
11355,11040,2,0,11,13
11355,11101,34,30,37,101
11355,11102,21,21,50,92
11355,11103,14,28,50,92
11355,11104,11,21,29,61
11355,11105,17,26,43,86
11355,11106,28,22,31,81
11355,11109,2,2,19,23
11355,11201,29,28,13,70
11355,11203,8,23,25,56
11355,11204,186,244,10,440
11355,11205,12,12,13,37
11355,11206,76,74,20,170
11355,11207,21,30,50,101
11355,11208,45,79,60,184
11355,11209,81,92,23,196
11355,11210,9,14,22,45
11355,11211,13,21,36,70
11355,11212,14,30,10,54
11355,11213,6,9,12,27
11355,11214,299,302,19,620
11355,11215,13,14,8,35
11355,11216,9,6,9,24
11355,11217,5,15,10,30
11355,11218,49,62,10,121
11355,11219,110,148,18,276
11355,11220,204,264,23,491
11355,11221,21,20,13,54
11355,11222,11,5,18,34
11355,11223,171,180,18,369
11355,11224,26,37,6,69
11355,11225,3,8,18,29
11355,11226,10,24,31,65
11355,11228,79,132,12,223
11355,11229,120,123,27,270
11355,11230,22,20,17,59
11355,11231,4,0,6,10
11355,11232,41,51,7,99
11355,11233,4,14,14,32
11355,11234,17,29,36,82
11355,11235,76,95,18,189
11355,11236,11,27,49,87
11355,11237,8,21,10,39
11355,11238,13,10,10,33
11355,11239,6,9,8,23
11355,11354,551,446,211,1208
11355,11355,1682,1425,607,3714
11355,11356,130,105,57,292
11355,11357,86,122,178,386
11355,11358,191,238,194,623
11355,11359,1,1,0,2
11355,11360,34,45,76,155
11355,11361,70,118,129,317
11355,11362,40,66,83,189
11355,11363,11,16,25,52
11355,11364,142,209,179,530
11355,11365,210,257,228,695
11355,11366,64,65,84,213
11355,11367,150,150,186,486
11355,11368,179,241,122,542
11355,11369,29,65,65,159
11355,11370,25,32,29,86
11355,11371,0,2,0,2
11355,11372,59,86,74,219
11355,11373,328,309,140,777
11355,11374,69,81,102,252
11355,11375,91,96,194,381
11355,11377,97,118,108,323
11355,11378,43,67,62,172
11355,11379,28,37,57,122
11355,11385,66,64,95,225
11355,11411,10,19,42,71
11355,11412,17,54,91,162
11355,11413,28,43,103,174
11355,11414,5,12,36,53
11355,11415,12,28,30,70
11355,11416,19,40,25,84
11355,11417,30,40,47,117
11355,11418,29,48,71,148
11355,11419,45,81,71,197
11355,11420,39,67,103,209
11355,11421,58,89,62,209
11355,11422,16,30,79,125
11355,11423,22,46,98,166
11355,11426,9,27,61,97
11355,11427,28,26,76,130
11355,11428,16,36,73,125
11355,11429,20,18,66,104
11355,11430,1,1,0,2
11355,11432,55,80,148,283
11355,11433,17,37,25,79
11355,11434,23,56,128,207
11355,11435,37,64,111,212
11355,11436,10,21,24,55
11355,11451,0,1,0,1
11355,11691,11,15,36,62
11355,11692,1,8,12,21
11355,11693,1,1,14,16
11355,11694,5,8,20,33
11355,11697,2,0,3,5
11356,10001,3,0,1,4
11356,10002,18,10,3,31
11356,10003,5,4,5,14
11356,10005,0,0,1,1
11356,10007,1,0,1,2
11356,10009,0,4,9,13
11356,10010,0,3,2,5
11356,10011,1,2,10,13
11356,10012,1,0,6,7
11356,10013,0,1,5,6
11356,10014,0,0,2,2
11356,10016,1,1,4,6
11356,10017,0,1,1,2
11356,10019,2,2,8,12
11356,10021,6,4,9,19
11356,10022,0,0,1,1
11356,10023,3,8,5,16
11356,10024,2,6,11,19
11356,10025,9,6,6,21
11356,10026,6,4,1,11
11356,10027,15,10,10,35
11356,10028,2,5,9,16
11356,10029,17,17,14,48
11356,10030,4,7,9,20
11356,10031,2,8,11,21
11356,10032,7,6,13,26
11356,10033,7,8,10,25
11356,10034,2,10,4,16
11356,10035,7,13,13,33
11356,10036,1,0,1,2
11356,10037,5,7,3,15
11356,10039,3,5,6,14
11356,10040,8,4,7,19
11356,10044,2,11,1,14
11356,10065,2,4,3,9
11356,10069,0,0,1,1
11356,10075,0,1,5,6
11356,10128,2,7,9,18
11356,10280,1,0,0,1
11356,10282,0,1,1,2
11356,10301,2,5,9,16
11356,10302,1,2,5,8
11356,10303,1,5,7,13
11356,10304,0,2,7,9
11356,10305,1,6,11,18
11356,10306,0,6,17,23
11356,10307,0,1,3,4
11356,10308,2,4,11,17
11356,10309,2,0,6,8
11356,10310,2,4,8,14
11356,10312,3,9,24,36
11356,10314,6,7,16,29
11356,10451,6,19,5,30
11356,10452,15,18,18,51
11356,10453,23,20,18,61
11356,10454,7,20,0,27
11356,10455,9,23,10,42
11356,10456,15,42,14,71
11356,10457,19,27,20,66
11356,10458,14,26,12,52
11356,10459,11,29,16,56
11356,10460,8,29,16,53
11356,10461,6,20,32,58
11356,10462,20,40,23,83
11356,10463,11,11,13,35
11356,10464,1,1,4,6
11356,10465,9,10,20,39
11356,10466,16,26,27,69
11356,10467,17,20,25,62
11356,10468,12,28,6,46
11356,10469,16,27,35,78
11356,10470,5,3,6,14
11356,10471,2,2,3,7
11356,10472,14,20,19,53
11356,10473,12,21,9,42
11356,10474,3,5,1,9
11356,10475,10,9,13,32
11356,11001,2,3,0,5
11356,11003,0,0,1,1
11356,11004,2,10,9,21
11356,11005,1,1,1,3
11356,11040,4,0,2,6
11356,11101,2,19,24,45
11356,11102,9,20,25,54
11356,11103,13,16,21,50
11356,11104,8,7,21,36
11356,11105,11,16,18,45
11356,11106,10,18,17,45
11356,11109,1,1,3,5
11356,11201,0,9,7,16
11356,11203,7,16,15,38
11356,11204,6,5,10,21
11356,11205,1,3,6,10
11356,11206,4,8,12,24
11356,11207,9,14,15,38
11356,11208,17,23,29,69
11356,11209,5,8,12,25
11356,11210,5,11,14,30
11356,11211,8,13,18,39
11356,11212,16,19,24,59
11356,11213,2,6,9,17
11356,11214,8,13,14,35
11356,11215,1,3,11,15
11356,11216,4,7,7,18
11356,11217,0,2,9,11
11356,11218,5,5,12,22
11356,11219,6,5,11,22
11356,11220,9,22,4,35
11356,11221,5,9,14,28
11356,11222,2,2,18,22
11356,11223,6,13,18,37
11356,11224,3,2,14,19
11356,11225,5,7,10,22
11356,11226,7,17,16,40
11356,11228,6,7,7,20
11356,11229,4,6,17,27
11356,11230,5,13,14,32
11356,11231,2,0,6,8
11356,11232,2,3,3,8
11356,11233,6,14,13,33
11356,11234,7,8,24,39
11356,11235,3,6,15,24
11356,11236,8,16,24,48
11356,11237,3,7,7,17
11356,11238,3,5,4,12
11356,11239,0,2,1,3
11356,11354,89,101,71,261
11356,11355,69,85,50,204
11356,11356,166,217,137,520
11356,11357,55,82,119,256
11356,11358,32,30,43,105
11356,11360,9,13,28,50
11356,11361,14,50,31,95
11356,11362,9,15,17,41
11356,11363,2,3,5,10
11356,11364,15,29,37,81
11356,11365,26,39,51,116
11356,11366,7,20,9,36
11356,11367,32,22,30,84
11356,11368,37,68,75,180
11356,11369,27,30,21,78
11356,11370,8,12,16,36
11356,11372,19,28,32,79
11356,11373,41,54,30,125
11356,11374,12,16,38,66
11356,11375,11,22,32,65
11356,11377,27,54,45,126
11356,11378,13,15,28,56
11356,11379,11,14,39,64
11356,11385,28,42,106,176
11356,11411,4,8,17,29
11356,11412,23,22,29,74
11356,11413,13,25,23,61
11356,11414,4,10,25,39
11356,11415,5,6,10,21
11356,11416,12,16,19,47
11356,11417,5,8,23,36
11356,11418,19,13,35,67
11356,11419,9,24,38,71
11356,11420,15,26,34,75
11356,11421,18,23,34,75
11356,11422,9,8,17,34
11356,11423,9,26,20,55
11356,11426,4,7,12,23
11356,11427,11,11,21,43
11356,11428,9,31,18,58
11356,11429,9,14,14,37
11356,11430,1,0,1,2
11356,11432,14,25,27,66
11356,11433,8,18,22,48
11356,11434,18,32,34,84
11356,11435,31,25,33,89
11356,11436,8,17,10,35
11356,11691,2,8,9,19
11356,11692,2,2,6,10
11356,11693,0,1,5,6
11356,11694,2,2,7,11
11356,11697,0,0,1,1
11357,10001,0,0,2,2
11357,10002,2,6,2,10
11357,10003,2,0,6,8
11357,10009,3,0,4,7
11357,10010,0,0,4,4
11357,10011,1,2,3,6
11357,10012,0,0,2,2
11357,10013,1,3,1,5
11357,10014,0,1,2,3
11357,10016,0,0,4,4
11357,10019,1,0,3,4
11357,10021,3,1,2,6
11357,10022,2,0,2,4
11357,10023,2,3,4,9
11357,10024,0,2,4,6
11357,10025,5,1,4,10
11357,10026,0,4,7,11
11357,10027,2,4,10,16
11357,10028,4,1,6,11
11357,10029,8,11,8,27
11357,10030,1,6,2,9
11357,10031,2,3,11,16
11357,10032,4,8,4,16
11357,10033,4,6,4,14
11357,10034,5,6,3,14
11357,10035,3,7,7,17
11357,10036,0,2,3,5
11357,10037,2,1,3,6
11357,10038,1,0,0,1
11357,10039,2,0,7,9
11357,10040,5,8,6,19
11357,10044,0,3,1,4
11357,10065,0,1,3,4
11357,10069,1,0,0,1
11357,10075,1,1,3,5
11357,10128,0,3,5,8
11357,10162,1,0,0,1
11357,10280,1,0,1,2
11357,10282,0,1,0,1
11357,10301,3,2,6,11
11357,10302,0,1,2,3
11357,10303,1,0,2,3
11357,10304,2,3,3,8
11357,10305,2,2,5,9
11357,10306,3,3,12,18
11357,10307,0,2,3,5
11357,10308,1,0,5,6
11357,10309,1,0,4,5
11357,10310,1,3,2,6
11357,10312,6,7,9,22
11357,10314,2,5,5,12
11357,10451,4,10,6,20
11357,10452,7,21,8,36
11357,10453,11,15,11,37
11357,10454,2,8,6,16
11357,10455,14,15,3,32
11357,10456,9,22,8,39
11357,10457,5,20,16,41
11357,10458,13,6,12,31
11357,10459,4,6,9,19
11357,10460,19,19,9,47
11357,10461,5,18,25,48
11357,10462,16,21,19,56
11357,10463,10,11,14,35
11357,10464,2,1,4,7
11357,10465,4,17,25,46
11357,10466,10,14,14,38
11357,10467,10,29,26,65
11357,10468,3,12,12,27
11357,10469,10,19,25,54
11357,10470,1,5,5,11
11357,10471,2,2,2,6
11357,10472,16,12,13,41
11357,10473,4,14,21,39
11357,10474,3,3,2,8
11357,10475,4,7,5,16
11357,11001,1,3,0,4
11357,11004,5,5,8,18
11357,11005,1,0,1,2
11357,11040,1,2,0,3
11357,11101,11,11,12,34
11357,11102,9,9,15,33
11357,11103,6,18,23,47
11357,11104,5,12,14,31
11357,11105,10,17,25,52
11357,11106,5,11,17,33
11357,11109,1,0,2,3
11357,11201,2,3,5,10
11357,11203,2,8,5,15
11357,11204,1,3,2,6
11357,11205,2,2,2,6
11357,11206,4,9,9,22
11357,11207,7,18,10,35
11357,11208,8,22,6,36
11357,11209,3,0,3,6
11357,11210,3,5,8,16
11357,11211,5,3,16,24
11357,11212,3,10,13,26
11357,11213,2,8,3,13
11357,11214,3,2,6,11
11357,11215,2,1,4,7
11357,11216,2,4,1,7
11357,11217,0,3,6,9
11357,11218,8,2,5,15
11357,11219,4,4,9,17
11357,11220,9,6,7,22
11357,11221,3,9,4,16
11357,11222,0,2,8,10
11357,11223,1,2,6,9
11357,11224,2,2,5,9
11357,11225,4,6,9,19
11357,11226,6,9,10,25
11357,11228,5,1,1,7
11357,11229,9,3,7,19
11357,11230,4,3,9,16
11357,11231,3,4,3,10
11357,11232,4,1,1,6
11357,11233,2,7,1,10
11357,11234,5,9,14,28
11357,11235,9,2,9,20
11357,11236,9,7,5,21
11357,11237,3,11,6,20
11357,11238,2,4,7,13
11357,11239,1,2,1,4
11357,11354,44,94,53,191
11357,11355,48,64,45,157
11357,11356,29,86,31,146
11357,11357,259,318,243,820
11357,11358,61,65,52,178
11357,11360,25,34,23,82
11357,11361,43,54,20,117
11357,11362,14,10,20,44
11357,11363,1,1,10,12
11357,11364,19,26,46,91
11357,11365,24,45,32,101
11357,11366,4,13,13,30
11357,11367,15,24,19,58
11357,11368,38,91,39,168
11357,11369,18,29,25,72
11357,11370,12,16,13,41
11357,11371,1,1,1,3
11357,11372,10,38,20,68
11357,11373,28,54,39,121
11357,11374,12,11,7,30
11357,11375,20,22,32,74
11357,11377,23,32,42,97
11357,11378,13,21,31,65
11357,11379,6,7,40,53
11357,11385,23,50,58,131
11357,11411,5,11,19,35
11357,11412,13,25,21,59
11357,11413,9,17,25,51
11357,11414,1,8,14,23
11357,11415,3,7,14,24
11357,11416,4,14,13,31
11357,11417,14,14,14,42
11357,11418,12,15,17,44
11357,11419,8,18,22,48
11357,11420,6,21,23,50
11357,11421,17,18,32,67
11357,11422,9,9,18,36
11357,11423,10,24,18,52
11357,11426,4,6,11,21
11357,11427,10,12,12,34
11357,11428,2,18,13,33
11357,11429,15,7,22,44
11357,11430,1,2,0,3
11357,11432,21,48,24,93
11357,11433,13,23,18,54
11357,11434,14,26,34,74
11357,11435,15,30,26,71
11357,11436,8,13,13,34
11357,11691,3,6,3,12
11357,11692,1,5,4,10
11357,11693,0,1,0,1
11357,11694,1,0,0,1
11357,11697,0,1,2,3
11358,10002,3,4,4,11
11358,10003,2,1,3,6
11358,10005,0,1,0,1
11358,10009,0,1,0,1
11358,10010,0,0,1,1
11358,10011,0,3,0,3
11358,10012,0,1,1,2
11358,10013,1,1,1,3
11358,10014,0,1,0,1
11358,10016,0,1,1,2
11358,10017,1,1,1,3
11358,10019,1,2,3,6
11358,10021,0,1,1,2
11358,10022,1,1,1,3
11358,10023,2,0,2,4
11358,10024,1,0,1,2
11358,10025,4,1,5,10
11358,10026,0,0,1,1
11358,10027,1,2,7,10
11358,10028,0,0,2,2
11358,10029,2,3,6,11
11358,10030,0,1,2,3
11358,10031,2,3,0,5
11358,10032,2,2,4,8
11358,10033,0,1,3,4
11358,10034,1,3,2,6
11358,10035,2,0,0,2
11358,10036,1,1,0,2
11358,10038,1,1,1,3
11358,10039,0,0,1,1
11358,10040,2,2,2,6
11358,10044,0,0,2,2
11358,10065,0,1,2,3
11358,10075,0,1,1,2
11358,10128,0,4,3,7
11358,10301,3,1,1,5
11358,10302,2,0,0,2
11358,10303,0,0,1,1
11358,10304,0,2,2,4
11358,10305,2,2,4,8
11358,10306,2,3,4,9
11358,10307,0,1,0,1
11358,10309,0,2,3,5
11358,10310,0,1,1,2
11358,10312,0,4,5,9
11358,10314,3,1,7,11
11358,10451,0,3,1,4
11358,10452,0,3,4,7
11358,10453,1,2,6,9
11358,10454,5,11,5,21
11358,10455,2,4,2,8
11358,10456,3,3,5,11
11358,10457,0,7,1,8
11358,10458,3,3,5,11
11358,10459,6,8,4,18
11358,10460,5,5,3,13
11358,10461,6,7,9,22
11358,10462,1,7,11,19
11358,10463,1,3,5,9
11358,10464,0,0,1,1
11358,10465,7,12,10,29
11358,10466,3,2,8,13
11358,10467,5,2,3,10
11358,10468,2,2,2,6
11358,10469,2,6,10,18
11358,10470,0,1,1,2
11358,10471,0,1,1,2
11358,10472,15,9,8,32
11358,10473,6,8,15,29
11358,10474,2,2,0,4
11358,10475,3,4,4,11
11358,11001,0,1,3,4
11358,11004,3,4,5,12
11358,11040,1,0,0,1
11358,11101,4,5,4,13
11358,11102,8,6,9,23
11358,11103,8,8,10,26
11358,11104,4,11,3,18
11358,11105,7,15,2,24
11358,11106,13,11,10,34
11358,11109,0,0,2,2
11358,11201,0,0,2,2
11358,11203,2,7,4,13
11358,11204,5,1,5,11
11358,11205,3,2,4,9
11358,11206,2,5,3,10
11358,11207,7,7,9,23
11358,11208,5,7,9,21
11358,11209,1,2,2,5
11358,11210,5,1,3,9
11358,11211,0,1,6,7
11358,11212,4,5,6,15
11358,11213,2,5,5,12
11358,11214,3,2,2,7
11358,11215,2,4,3,9
11358,11216,3,3,2,8
11358,11217,0,0,1,1
11358,11218,2,2,1,5
11358,11219,0,4,2,6
11358,11220,7,4,1,12
11358,11221,2,4,3,9
11358,11222,1,2,0,3
11358,11223,3,2,2,7
11358,11224,1,0,3,4
11358,11225,4,2,1,7
11358,11226,5,5,6,16
11358,11228,2,5,4,11
11358,11229,1,2,4,7
11358,11230,3,1,4,8
11358,11231,0,3,2,5
11358,11232,2,4,0,6
11358,11233,4,3,1,8
11358,11234,3,2,6,11
11358,11235,3,3,6,12
11358,11236,2,8,8,18
11358,11237,2,3,3,8
11358,11238,0,3,3,6
11358,11239,0,2,1,3
11358,11354,116,127,62,305
11358,11355,88,101,47,236
11358,11356,11,28,9,48
11358,11357,52,62,68,182
11358,11358,252,262,142,656
11358,11359,0,0,1,1
11358,11360,35,40,20,95
11358,11361,70,95,55,220
11358,11362,31,31,30,92
11358,11363,6,16,8,30
11358,11364,53,62,48,163
11358,11365,58,74,41,173
11358,11366,8,10,11,29
11358,11367,18,20,14,52
11358,11368,44,59,25,128
11358,11369,9,16,13,38
11358,11370,8,11,6,25
11358,11371,0,2,0,2
11358,11372,15,25,20,60
11358,11373,27,43,20,90
11358,11374,13,12,18,43
11358,11375,18,21,17,56
11358,11377,19,32,28,79
11358,11378,10,17,15,42
11358,11379,11,16,22,49
11358,11385,26,20,28,74
11358,11411,3,4,11,18
11358,11412,13,13,18,44
11358,11413,13,11,16,40
11358,11414,5,7,6,18
11358,11415,6,4,4,14
11358,11416,5,10,3,18
11358,11417,5,10,9,24
11358,11418,11,11,18,40
11358,11419,21,7,21,49
11358,11420,10,14,16,40
11358,11421,8,11,14,33
11358,11422,6,9,18,33
11358,11423,14,12,13,39
11358,11426,4,12,5,21
11358,11427,10,12,27,49
11358,11428,11,10,5,26
11358,11429,6,15,10,31
11358,11430,1,0,1,2
11358,11432,16,28,13,57
11358,11433,8,11,16,35
11358,11434,11,18,21,50
11358,11435,12,17,17,46
11358,11436,7,13,2,22
11358,11691,1,7,3,11
11358,11692,1,1,1,3
11358,11693,3,2,1,6
11358,11694,1,2,5,8
11359,10308,0,0,1,1
11359,10453,0,1,0,1
11359,10457,0,1,0,1
11359,10466,0,1,0,1
11359,11102,0,1,0,1
11359,11106,0,1,1,2
11359,11211,0,0,1,1
11359,11212,0,1,0,1
11359,11357,1,0,0,1
11359,11361,0,1,1,2
11359,11364,0,2,0,2
11359,11372,0,3,0,3
11359,11374,0,1,0,1
11359,11377,0,1,0,1
11359,11378,0,0,1,1
11359,11420,0,1,0,1
11359,11429,0,1,0,1
11359,11432,0,1,0,1
11360,10002,0,0,1,1
11360,10005,0,0,1,1
11360,10009,0,0,1,1
11360,10010,0,0,1,1
11360,10011,0,1,0,1
11360,10013,1,0,2,3
11360,10016,2,1,3,6
11360,10019,0,0,2,2
11360,10021,0,1,1,2
11360,10022,0,0,1,1
11360,10023,4,1,0,5
11360,10025,2,2,1,5
11360,10026,1,0,0,1
11360,10027,3,4,2,9
11360,10028,2,0,2,4
11360,10029,7,4,2,13
11360,10030,0,2,0,2
11360,10031,3,0,0,3
11360,10032,1,1,2,4
11360,10033,0,4,2,6
11360,10034,1,0,1,2
11360,10035,1,3,0,4
11360,10036,1,0,0,1
11360,10039,0,1,0,1
11360,10040,4,5,0,9
11360,10044,0,0,1,1
11360,10075,1,0,0,1
11360,10128,2,1,1,4
11360,10282,0,0,1,1
11360,10301,2,1,0,3
11360,10302,1,0,1,2
11360,10303,0,1,0,1
11360,10304,1,1,0,2
11360,10305,0,1,0,1
11360,10306,2,2,2,6
11360,10307,1,0,1,2
11360,10308,2,0,2,4
11360,10309,2,2,0,4
11360,10310,2,3,0,5
11360,10312,3,0,2,5
11360,10314,2,2,2,6
11360,10451,1,1,2,4
11360,10452,0,3,2,5
11360,10453,3,5,1,9
11360,10454,0,4,1,5
11360,10455,0,2,2,4
11360,10456,6,4,3,13
11360,10457,5,9,8,22
11360,10458,5,2,2,9
11360,10459,6,4,1,11
11360,10460,6,10,3,19
11360,10461,4,7,6,17
11360,10462,11,5,9,25
11360,10463,2,5,4,11
11360,10464,1,0,1,2
11360,10465,3,6,5,14
11360,10466,6,2,1,9
11360,10467,9,4,3,16
11360,10468,3,8,2,13
11360,10469,9,8,5,22
11360,10470,2,1,1,4
11360,10471,0,0,2,2
11360,10472,6,13,3,22
11360,10473,7,5,6,18
11360,10474,2,0,0,2
11360,10475,4,4,5,13
11360,11001,5,3,3,11
11360,11004,5,2,6,13
11360,11005,0,1,0,1
11360,11040,1,1,1,3
11360,11101,1,3,2,6
11360,11102,4,6,6,16
11360,11103,1,6,6,13
11360,11104,1,5,9,15
11360,11105,4,2,4,10
11360,11106,4,7,4,15
11360,11109,0,0,1,1
11360,11201,4,1,2,7
11360,11203,3,7,5,15
11360,11204,1,0,2,3
11360,11205,1,1,0,2
11360,11206,0,4,1,5
11360,11207,3,5,4,12
11360,11208,5,10,7,22
11360,11209,3,4,1,8
11360,11210,2,5,3,10
11360,11211,0,3,4,7
11360,11212,1,5,2,8
11360,11213,3,2,4,9
11360,11214,0,3,1,4
11360,11215,0,1,1,2
11360,11216,3,3,1,7
11360,11217,4,0,0,4
11360,11218,2,1,1,4
11360,11219,0,1,0,1
11360,11220,5,0,1,6
11360,11221,2,7,1,10
11360,11222,0,1,4,5
11360,11223,2,3,3,8
11360,11224,0,0,1,1
11360,11225,4,4,1,9
11360,11226,0,6,2,8
11360,11228,2,1,1,4
11360,11229,3,3,1,7
11360,11230,2,0,4,6
11360,11231,0,0,3,3
11360,11233,3,3,1,7
11360,11234,0,3,3,6
11360,11235,2,0,3,5
11360,11236,6,4,2,12
11360,11237,4,4,2,10
11360,11238,4,1,0,5
11360,11239,3,1,1,5
11360,11354,21,17,14,52
11360,11355,9,16,12,37
11360,11356,1,11,5,17
11360,11357,39,26,23,88
11360,11358,18,21,16,55
11360,11360,41,54,67,162
11360,11361,20,17,17,54
11360,11362,8,6,4,18
11360,11363,2,1,1,4
11360,11364,7,24,20,51
11360,11365,17,6,7,30
11360,11366,2,5,6,13
11360,11367,10,16,6,32
11360,11368,11,16,7,34
11360,11369,4,5,9,18
11360,11370,3,4,2,9
11360,11371,0,0,1,1
11360,11372,4,13,8,25
11360,11373,5,7,9,21
11360,11374,6,3,3,12
11360,11375,12,9,16,37
11360,11377,14,9,14,37
11360,11378,5,10,6,21
11360,11379,4,7,4,15
11360,11385,16,11,14,41
11360,11411,2,9,1,12
11360,11412,10,10,9,29
11360,11413,4,14,6,24
11360,11414,4,5,2,11
11360,11415,3,3,1,7
11360,11416,1,6,3,10
11360,11417,3,3,1,7
11360,11418,4,2,4,10
11360,11419,5,4,5,14
11360,11420,0,4,6,10
11360,11421,3,4,13,20
11360,11422,6,9,2,17
11360,11423,3,14,9,26
11360,11426,4,7,4,15
11360,11427,10,9,13,32
11360,11428,10,8,4,22
11360,11429,5,5,8,18
11360,11432,8,13,12,33
11360,11433,7,7,2,16
11360,11434,6,17,10,33
11360,11435,10,13,1,24
11360,11436,7,3,2,12
11360,11691,5,8,0,13
11360,11692,2,2,0,4
11360,11693,1,2,0,3
11360,11694,2,0,3,5
11361,10001,0,5,1,6
11361,10002,20,14,8,42
11361,10003,6,5,8,19
11361,10004,1,1,0,2
11361,10005,1,2,1,4
11361,10006,1,1,0,2
11361,10007,0,1,1,2
11361,10009,3,14,9,26
11361,10010,2,2,4,8
11361,10011,4,6,3,13
11361,10012,0,2,4,6
11361,10013,4,4,2,10
11361,10014,0,4,1,5
11361,10016,0,6,3,9
11361,10017,0,2,1,3
11361,10018,0,1,0,1
11361,10019,3,6,6,15
11361,10021,1,0,4,5
11361,10022,0,1,1,2
11361,10023,3,2,6,11
11361,10024,4,4,9,17
11361,10025,16,11,6,33
11361,10026,16,8,11,35
11361,10027,15,10,9,34
11361,10028,0,0,2,2
11361,10029,26,26,7,59
11361,10030,14,9,5,28
11361,10031,8,8,5,21
11361,10032,15,13,6,34
11361,10033,14,8,13,35
11361,10034,13,9,2,24
11361,10035,9,7,6,22
11361,10036,5,5,1,11
11361,10037,4,6,5,15
11361,10038,0,3,4,7
11361,10039,10,3,3,16
11361,10040,11,8,8,27
11361,10044,0,1,1,2
11361,10065,2,2,3,7
11361,10069,1,0,0,1
11361,10075,1,1,1,3
11361,10128,5,2,5,12
11361,10280,1,1,0,2
11361,10301,25,15,11,51
11361,10302,7,10,3,20
11361,10303,9,7,11,27
11361,10304,18,19,7,44
11361,10305,12,9,14,35
11361,10306,8,11,9,28
11361,10307,1,2,3,6
11361,10308,3,1,5,9
11361,10309,4,4,2,10
11361,10310,11,12,4,27
11361,10312,4,8,19,31
11361,10314,21,26,29,76
11361,10451,23,23,7,53
11361,10452,29,37,9,75
11361,10453,30,39,5,74
11361,10454,32,28,6,66
11361,10455,27,26,4,57
11361,10456,43,56,16,115
11361,10457,44,35,7,86
11361,10458,24,43,15,82
11361,10459,26,30,6,62
11361,10460,25,25,11,61
11361,10461,14,20,16,50
11361,10462,25,30,13,68
11361,10463,11,10,11,32
11361,10464,3,1,3,7
11361,10465,9,25,31,65
11361,10466,22,26,9,57
11361,10467,18,45,19,82
11361,10468,19,24,7,50
11361,10469,19,24,10,53
11361,10470,6,6,6,18
11361,10471,2,2,5,9
11361,10472,26,42,13,81
11361,10473,13,29,19,61
11361,10474,5,12,4,21
11361,10475,5,16,16,37
11361,11001,4,7,4,15
11361,11004,18,15,14,47
11361,11005,1,1,2,4
11361,11040,0,2,2,4
11361,11101,15,15,5,35
11361,11102,14,19,9,42
11361,11103,11,17,12,40
11361,11104,12,13,5,30
11361,11105,15,8,17,40
11361,11106,11,18,10,39
11361,11109,2,2,1,5
11361,11201,6,6,6,18
11361,11203,33,81,12,126
11361,11204,53,71,18,142
11361,11205,7,8,6,21
11361,11206,18,40,14,72
11361,11207,69,76,15,160
11361,11208,65,92,15,172
11361,11209,19,25,18,62
11361,11210,36,76,16,128
11361,11211,9,15,4,28
11361,11212,46,78,18,142
11361,11213,27,34,11,72
11361,11214,66,143,22,231
11361,11215,9,15,14,38
11361,11216,7,23,12,42
11361,11217,8,9,3,20
11361,11218,25,40,9,74
11361,11219,26,42,15,83
11361,11220,20,25,15,60
11361,11221,33,36,10,79
11361,11222,2,4,6,12
11361,11223,62,91,19,172
11361,11224,59,85,8,152
11361,11225,29,40,9,78
11361,11226,55,105,17,177
11361,11228,17,28,9,54
11361,11229,54,106,18,178
11361,11230,52,109,17,178
11361,11231,1,5,6,12
11361,11232,7,5,6,18
11361,11233,28,42,9,79
11361,11234,26,50,18,94
11361,11235,73,148,18,239
11361,11236,38,70,25,133
11361,11237,21,24,7,52
11361,11238,18,13,8,39
11361,11239,14,21,0,35
11361,11354,93,99,55,247
11361,11355,148,196,63,407
11361,11356,28,35,25,88
11361,11357,89,103,81,273
11361,11358,115,149,88,352
11361,11359,0,0,1,1
11361,11360,47,55,42,144
11361,11361,202,275,189,666
11361,11362,35,39,40,114
11361,11363,12,11,11,34
11361,11364,82,108,73,263
11361,11365,48,100,58,206
11361,11366,10,30,23,63
11361,11367,66,63,27,156
11361,11368,120,163,70,353
11361,11369,15,50,22,87
11361,11370,30,28,12,70
11361,11372,38,77,21,136
11361,11373,57,88,40,185
11361,11374,34,75,33,142
11361,11375,39,78,57,174
11361,11377,43,61,26,130
11361,11378,17,35,28,80
11361,11379,12,29,29,70
11361,11385,35,82,56,173
11361,11411,23,38,32,93
11361,11412,68,103,20,191
11361,11413,38,66,36,140
11361,11414,6,14,15,35
11361,11415,14,31,11,56
11361,11416,27,37,16,80
11361,11417,27,44,17,88
11361,11418,39,91,25,155
11361,11419,51,87,19,157
11361,11420,62,92,27,181
11361,11421,46,63,29,138
11361,11422,26,46,20,92
11361,11423,59,139,37,235
11361,11426,21,18,18,57
11361,11427,27,70,22,119
11361,11428,37,56,45,138
11361,11429,28,89,21,138
11361,11432,87,122,43,252
11361,11433,49,60,30,139
11361,11434,95,131,53,279
11361,11435,52,126,31,209
11361,11436,31,49,14,94
11361,11691,33,40,17,90
11361,11692,9,12,2,23
11361,11693,7,7,2,16
11361,11694,6,15,5,26
11361,11697,1,6,1,8
11362,10001,0,0,2,2
11362,10002,3,2,1,6
11362,10003,0,1,0,1
11362,10005,0,0,1,1
11362,10009,2,1,0,3
11362,10010,0,0,2,2
11362,10011,0,1,1,2
11362,10012,0,0,1,1
11362,10013,0,0,1,1
11362,10014,0,0,1,1
11362,10016,0,1,1,2
11362,10017,0,0,2,2
11362,10019,1,1,2,4
11362,10023,0,3,1,4
11362,10024,0,0,2,2
11362,10025,2,4,2,8
11362,10026,0,0,1,1
11362,10027,0,3,1,4
11362,10028,1,1,1,3
11362,10029,2,5,5,12
11362,10030,0,1,1,2
11362,10031,1,3,1,5
11362,10032,0,0,2,2
11362,10033,0,2,3,5
11362,10034,2,1,2,5
11362,10035,4,1,2,7
11362,10036,0,0,4,4
11362,10037,0,0,1,1
11362,10038,0,1,1,2
11362,10039,2,0,0,2
11362,10040,2,1,0,3
11362,10044,0,0,1,1
11362,10065,0,1,0,1
11362,10075,1,0,0,1
11362,10128,1,0,2,3
11362,10282,0,1,0,1
11362,10301,0,2,1,3
11362,10302,2,1,0,3
11362,10303,0,1,2,3
11362,10304,2,0,1,3
11362,10305,1,3,2,6
11362,10306,1,3,1,5
11362,10307,1,0,0,1
11362,10308,0,0,1,1
11362,10309,1,1,1,3
11362,10310,0,1,3,4
11362,10312,1,2,2,5
11362,10314,3,0,4,7
11362,10451,0,2,2,4
11362,10452,0,4,4,8
11362,10453,4,6,3,13
11362,10454,0,0,3,3
11362,10455,1,2,0,3
11362,10456,3,6,3,12
11362,10457,1,2,3,6
11362,10458,0,8,3,11
11362,10459,2,4,4,10
11362,10460,1,5,1,7
11362,10461,4,2,4,10
11362,10462,8,8,3,19
11362,10463,1,0,7,8
11362,10464,1,0,0,1
11362,10465,7,8,13,28
11362,10466,0,3,4,7
11362,10467,3,10,4,17
11362,10468,1,5,4,10
11362,10469,0,2,2,4
11362,10470,0,1,1,2
11362,10471,0,0,1,1
11362,10472,4,6,3,13
11362,10473,4,2,1,7
11362,10474,0,0,1,1
11362,10475,0,3,0,3
11362,11001,5,3,2,10
11362,11004,14,11,7,32
11362,11040,2,0,3,5
11362,11101,2,6,3,11
11362,11102,4,3,1,8
11362,11103,7,5,4,16
11362,11104,1,6,5,12
11362,11105,5,4,2,11
11362,11106,3,5,4,12
11362,11201,1,0,1,2
11362,11203,6,3,2,11
11362,11204,0,10,2,12
11362,11205,0,0,2,2
11362,11206,2,2,5,9
11362,11207,1,14,2,17
11362,11208,5,4,6,15
11362,11209,1,4,3,8
11362,11210,2,3,2,7
11362,11211,2,4,6,12
11362,11212,4,8,2,14
11362,11213,2,4,0,6
11362,11214,6,5,1,12
11362,11215,1,1,1,3
11362,11216,1,3,0,4
11362,11217,1,2,0,3
11362,11218,2,0,1,3
11362,11219,0,5,4,9
11362,11220,0,3,5,8
11362,11221,1,2,2,5
11362,11222,0,2,2,4
11362,11223,0,4,4,8
11362,11224,4,2,2,8
11362,11225,4,3,1,8
11362,11226,5,12,3,20
11362,11228,1,1,2,4
11362,11229,4,1,3,8
11362,11230,1,3,4,8
11362,11231,0,0,1,1
11362,11232,1,2,0,3
11362,11233,1,5,0,6
11362,11234,4,5,3,12
11362,11235,1,6,5,12
11362,11236,2,7,3,12
11362,11237,0,1,2,3
11362,11238,0,1,0,1
11362,11239,1,1,2,4
11362,11354,26,23,14,63
11362,11355,33,55,15,103
11362,11356,17,17,4,38
11362,11357,24,36,29,89
11362,11358,38,39,14,91
11362,11359,0,1,0,1
11362,11360,15,7,13,35
11362,11361,22,20,14,56
11362,11362,70,82,82,234
11362,11363,19,7,2,28
11362,11364,32,23,10,65
11362,11365,26,18,9,53
11362,11366,5,7,4,16
11362,11367,8,13,4,25
11362,11368,14,17,15,46
11362,11369,9,10,3,22
11362,11370,4,4,2,10
11362,11372,8,11,5,24
11362,11373,24,22,10,56
11362,11374,3,7,6,16
11362,11375,9,12,13,34
11362,11377,1,15,9,25
11362,11378,2,5,10,17
11362,11379,1,8,4,13
11362,11385,8,14,13,35
11362,11411,12,6,7,25
11362,11412,13,13,8,34
11362,11413,22,10,9,41
11362,11414,5,8,8,21
11362,11415,4,2,2,8
11362,11416,1,3,3,7
11362,11417,3,7,5,15
11362,11418,5,14,3,22
11362,11419,12,11,5,28
11362,11420,7,6,7,20
11362,11421,12,8,3,23
11362,11422,6,9,7,22
11362,11423,14,24,4,42
11362,11426,19,5,13,37
11362,11427,17,16,1,34
11362,11428,10,6,6,22
11362,11429,12,20,7,39
11362,11432,25,34,17,76
11362,11433,9,12,8,29
11362,11434,23,26,18,67
11362,11435,14,25,10,49
11362,11436,5,5,3,13
11362,11691,1,5,1,7
11362,11692,0,1,0,1
11362,11693,2,2,0,4
11362,11694,1,0,1,2
11362,11697,1,0,0,1
11363,10002,0,1,1,2
11363,10003,0,2,2,4
11363,10005,0,0,1,1
11363,10009,3,1,1,5
11363,10010,0,0,1,1
11363,10011,0,1,1,2
11363,10013,0,1,0,1
11363,10014,0,0,2,2
11363,10016,1,0,0,1
11363,10019,1,0,1,2
11363,10021,0,0,1,1
11363,10022,0,0,1,1
11363,10023,1,0,3,4
11363,10024,0,2,2,4
11363,10025,0,2,0,2
11363,10026,0,1,2,3
11363,10027,0,0,2,2
11363,10028,1,1,1,3
11363,10029,1,0,1,2
11363,10030,0,1,0,1
11363,10034,0,0,1,1
11363,10035,0,1,2,3
11363,10038,1,0,0,1
11363,10039,0,0,1,1
11363,10065,0,0,1,1
11363,10075,0,0,1,1
11363,10128,0,1,0,1
11363,10301,0,1,1,2
11363,10303,0,0,1,1
11363,10304,0,1,1,2
11363,10305,0,1,2,3
11363,10306,0,1,1,2
11363,10308,0,0,1,1
11363,10309,0,0,3,3
11363,10310,1,0,1,2
11363,10312,0,0,7,7
11363,10314,0,0,5,5
11363,10452,0,1,0,1
11363,10454,0,0,1,1
11363,10455,0,0,1,1
11363,10456,1,0,1,2
11363,10457,0,2,1,3
11363,10458,0,1,3,4
11363,10459,0,2,1,3
11363,10460,0,2,1,3
11363,10461,0,3,3,6
11363,10462,5,2,1,8
11363,10463,2,2,1,5
11363,10465,1,2,3,6
11363,10466,2,1,7,10
11363,10467,1,3,2,6
11363,10468,0,1,1,2
11363,10469,0,2,0,2
11363,10470,0,2,0,2
11363,10471,0,0,2,2
11363,10472,1,1,0,2
11363,10473,0,0,3,3
11363,10475,0,0,1,1
11363,11004,1,5,0,6
11363,11040,2,0,0,2
11363,11101,0,2,0,2
11363,11102,3,4,0,7
11363,11103,1,1,3,5
11363,11104,3,0,3,6
11363,11105,2,1,4,7
11363,11106,1,3,6,10
11363,11201,0,1,2,3
11363,11203,0,2,4,6
11363,11204,1,2,2,5
11363,11205,0,1,1,2
11363,11206,0,0,2,2
11363,11207,1,2,5,8
11363,11208,0,2,1,3
11363,11209,0,0,4,4
11363,11210,0,0,3,3
11363,11211,0,0,3,3
11363,11212,1,1,2,4
11363,11213,1,2,0,3
11363,11214,1,1,1,3
11363,11215,0,0,6,6
11363,11216,1,0,2,3
11363,11218,0,2,1,3
11363,11219,0,1,0,1
11363,11220,0,0,3,3
11363,11221,0,1,1,2
11363,11223,1,3,0,4
11363,11224,2,0,0,2
11363,11225,0,0,1,1
11363,11226,0,2,3,5
11363,11228,0,0,2,2
11363,11229,0,1,2,3
11363,11230,0,2,0,2
11363,11231,0,0,1,1
11363,11232,1,0,0,1
11363,11233,1,0,0,1
11363,11234,0,0,3,3
11363,11235,1,0,1,2
11363,11236,0,1,0,1
11363,11237,0,0,2,2
11363,11238,0,2,0,2
11363,11239,1,0,1,2
11363,11354,9,9,3,21
11363,11355,18,10,5,33
11363,11356,5,5,4,14
11363,11357,3,9,5,17
11363,11358,11,8,9,28
11363,11359,0,0,1,1
11363,11360,2,2,7,11
11363,11361,9,5,4,18
11363,11362,9,8,8,25
11363,11363,22,31,19,72
11363,11364,8,9,7,24
11363,11365,6,10,5,21
11363,11367,9,7,6,22
11363,11368,3,6,9,18
11363,11369,3,1,8,12
11363,11370,1,2,3,6
11363,11372,4,2,4,10
11363,11373,8,7,7,22
11363,11374,0,3,2,5
11363,11375,1,5,4,10
11363,11377,1,0,5,6
11363,11378,0,2,2,4
11363,11379,1,2,5,8
11363,11385,3,8,6,17
11363,11411,1,0,2,3
11363,11412,0,1,5,6
11363,11413,3,2,1,6
11363,11414,0,0,4,4
11363,11415,0,0,4,4
11363,11416,1,0,3,4
11363,11417,0,1,3,4
11363,11418,0,2,0,2
11363,11419,0,2,3,5
11363,11420,1,1,4,6
11363,11421,1,0,2,3
11363,11422,1,0,2,3
11363,11423,0,3,5,8
11363,11426,1,5,2,8
11363,11427,2,0,0,2
11363,11428,5,4,3,12
11363,11429,0,2,4,6
11363,11432,4,8,7,19
11363,11433,3,4,1,8
11363,11434,2,4,4,10
11363,11435,3,3,6,12
11363,11436,0,3,0,3
11363,11691,0,1,1,2
11363,11694,0,0,1,1
11364,10001,1,0,0,1
11364,10002,2,5,1,8
11364,10003,0,2,1,3
11364,10005,0,1,0,1
11364,10009,1,0,3,4
11364,10011,4,0,2,6
11364,10012,2,1,0,3
11364,10013,0,2,1,3
11364,10014,1,0,0,1
11364,10016,0,0,1,1
11364,10017,0,0,1,1
11364,10019,1,2,4,7
11364,10021,1,0,2,3
11364,10022,0,0,4,4
11364,10023,0,0,1,1
11364,10024,2,0,0,2
11364,10025,3,5,3,11
11364,10026,1,1,2,4
11364,10027,1,1,4,6
11364,10028,0,0,3,3
11364,10029,2,5,4,11
11364,10030,0,1,1,2
11364,10031,0,3,3,6
11364,10032,2,8,2,12
11364,10033,1,3,0,4
11364,10034,1,4,2,7
11364,10035,2,3,2,7
11364,10036,0,2,3,5
11364,10037,0,0,1,1
11364,10038,1,1,0,2
11364,10039,1,0,0,1
11364,10040,2,1,1,4
11364,10065,0,1,2,3
11364,10128,0,0,1,1
11364,10280,0,1,0,1
11364,10301,1,1,2,4
11364,10302,1,1,0,2
11364,10303,1,0,0,1
11364,10304,1,3,2,6
11364,10305,0,2,2,4
11364,10306,2,3,5,10
11364,10307,0,0,3,3
11364,10308,0,2,2,4
11364,10309,0,1,4,5
11364,10310,0,0,2,2
11364,10312,0,6,5,11
11364,10314,3,1,5,9
11364,10451,0,7,6,13
11364,10452,1,3,1,5
11364,10453,3,4,4,11
11364,10454,0,1,2,3
11364,10455,0,3,1,4
11364,10456,2,3,7,12
11364,10457,2,8,1,11
11364,10458,3,7,5,15
11364,10459,0,1,3,4
11364,10460,1,8,3,12
11364,10461,4,8,3,15
11364,10462,6,3,4,13
11364,10463,0,3,5,8
11364,10464,0,0,3,3
11364,10465,2,10,11,23
11364,10466,2,7,7,16
11364,10467,8,7,9,24
11364,10468,3,4,5,12
11364,10469,3,4,4,11
11364,10470,1,2,0,3
11364,10471,2,0,1,3
11364,10472,4,4,8,16
11364,10473,1,8,3,12
11364,10474,0,2,0,2
11364,10475,1,6,7,14
11364,11001,2,5,3,10
11364,11004,2,7,8,17
11364,11005,1,1,0,2
11364,11040,3,3,0,6
11364,11101,2,2,1,5
11364,11102,2,5,3,10
11364,11103,1,2,3,6
11364,11104,0,1,3,4
11364,11105,0,1,8,9
11364,11106,1,5,4,10
11364,11109,0,0,1,1
11364,11201,1,6,0,7
11364,11203,5,3,7,15
11364,11204,2,2,1,5
11364,11205,1,2,3,6
11364,11206,2,7,4,13
11364,11207,3,5,10,18
11364,11208,5,6,6,17
11364,11209,2,2,5,9
11364,11210,3,2,4,9
11364,11211,2,6,8,16
11364,11212,2,10,7,19
11364,11213,1,4,3,8
11364,11214,6,1,3,10
11364,11215,0,0,4,4
11364,11216,1,2,5,8
11364,11217,0,1,1,2
11364,11218,1,4,4,9
11364,11219,1,5,8,14
11364,11220,0,5,4,9
11364,11221,0,9,5,14
11364,11222,0,2,2,4
11364,11223,2,0,6,8
11364,11224,6,0,3,9
11364,11225,0,0,2,2
11364,11226,1,11,9,21
11364,11228,1,2,1,4
11364,11229,0,1,2,3
11364,11230,7,5,3,15
11364,11231,0,2,1,3
11364,11232,0,2,1,3
11364,11233,2,4,5,11
11364,11234,3,7,5,15
11364,11235,2,3,7,12
11364,11236,4,14,4,22
11364,11237,0,12,4,16
11364,11238,0,4,5,9
11364,11239,0,3,1,4
11364,11354,21,15,11,47
11364,11355,55,41,22,118
11364,11356,12,11,4,27
11364,11357,8,12,12,32
11364,11358,16,20,14,50
11364,11360,8,10,15,33
11364,11361,25,40,21,86
11364,11362,6,11,13,30
11364,11363,2,3,11,16
11364,11364,122,146,96,364
11364,11365,19,25,15,59
11364,11366,8,9,6,23
11364,11367,18,13,14,45
11364,11368,13,38,16,67
11364,11369,3,20,11,34
11364,11370,2,8,6,16
11364,11372,4,11,16,31
11364,11373,12,20,9,41
11364,11374,6,8,12,26
11364,11375,10,10,33,53
11364,11377,6,11,6,23
11364,11378,2,1,7,10
11364,11379,9,7,4,20
11364,11385,12,14,12,38
11364,11411,4,14,13,31
11364,11412,0,20,17,37
11364,11413,9,10,6,25
11364,11414,2,3,4,9
11364,11415,4,4,6,14
11364,11416,6,9,5,20
11364,11417,3,12,7,22
11364,11418,8,5,9,22
11364,11419,6,17,10,33
11364,11420,5,17,18,40
11364,11421,4,9,5,18
11364,11422,1,8,13,22
11364,11423,10,18,9,37
11364,11426,3,8,10,21
11364,11427,14,10,14,38
11364,11428,7,15,10,32
11364,11429,11,10,14,35
11364,11430,1,0,0,1
11364,11432,11,18,15,44
11364,11433,8,7,11,26
11364,11434,8,17,13,38
11364,11435,4,16,12,32
11364,11436,4,5,5,14
11364,11691,3,8,10,21
11364,11692,2,3,4,9
11364,11693,1,1,3,5
11364,11694,0,0,2,2
11364,11697,1,0,1,2
11365,10001,0,2,1,3
11365,10002,4,9,4,17
11365,10003,0,1,3,4
11365,10005,0,1,2,3
11365,10006,0,0,1,1
11365,10009,0,3,13,16
11365,10010,0,2,7,9
11365,10011,0,3,6,9
11365,10012,1,0,2,3
11365,10013,1,1,5,7
11365,10014,0,1,4,5
11365,10016,2,2,6,10
11365,10017,0,1,0,1
11365,10019,1,0,6,7
11365,10021,0,0,3,3
11365,10022,0,2,3,5
11365,10023,1,5,6,12
11365,10024,2,2,4,8
11365,10025,3,4,9,16
11365,10026,2,5,8,15
11365,10027,0,3,6,9
11365,10028,0,0,9,9
11365,10029,4,13,9,26
11365,10030,4,2,3,9
11365,10031,3,4,5,12
11365,10032,4,2,10,16
11365,10033,2,4,9,15
11365,10034,2,4,10,16
11365,10035,0,7,2,9
11365,10036,0,2,4,6
11365,10037,0,1,2,3
11365,10038,1,2,3,6
11365,10039,2,1,3,6
11365,10040,2,1,4,7
11365,10044,0,0,1,1
11365,10065,1,0,5,6
11365,10069,0,0,1,1
11365,10075,0,0,1,1
11365,10128,3,4,6,13
11365,10280,0,0,1,1
11365,10301,4,2,3,9
11365,10302,0,2,2,4
11365,10303,4,7,9,20
11365,10304,1,6,9,16
11365,10305,3,0,10,13
11365,10306,3,5,13,21
11365,10307,1,2,4,7
11365,10308,2,2,9,13
11365,10309,3,3,8,14
11365,10310,2,3,4,9
11365,10312,2,5,14,21
11365,10314,10,6,26,42
11365,10451,2,10,3,15
11365,10452,6,9,2,17
11365,10453,9,3,11,23
11365,10454,2,7,3,12
11365,10455,2,6,5,13
11365,10456,7,6,8,21
11365,10457,1,13,8,22
11365,10458,5,12,11,28
11365,10459,2,9,7,18
11365,10460,2,7,6,15
11365,10461,3,9,20,32
11365,10462,5,12,11,28
11365,10463,5,4,9,18
11365,10464,2,3,5,10
11365,10465,13,16,35,64
11365,10466,6,7,14,27
11365,10467,7,7,20,34
11365,10468,3,7,12,22
11365,10469,3,10,6,19
11365,10470,0,3,3,6
11365,10471,3,2,3,8
11365,10472,8,6,16,30
11365,10473,8,6,9,23
11365,10474,0,2,1,3
11365,10475,6,3,15,24
11365,11001,1,1,5,7
11365,11004,6,4,14,24
11365,11005,0,2,0,2
11365,11040,0,0,1,1
11365,11101,6,10,15,31
11365,11102,7,8,23,38
11365,11103,12,9,21,42
11365,11104,5,9,9,23
11365,11105,13,7,27,47
11365,11106,17,12,17,46
11365,11109,1,1,1,3
11365,11201,6,2,9,17
11365,11203,5,8,13,26
11365,11204,8,12,8,28
11365,11205,2,3,8,13
11365,11206,5,7,13,25
11365,11207,14,28,33,75
11365,11208,16,27,45,88
11365,11209,3,5,19,27
11365,11210,12,5,18,35
11365,11211,4,4,15,23
11365,11212,11,9,17,37
11365,11213,3,3,18,24
11365,11214,11,15,18,44
11365,11215,1,4,13,18
11365,11216,1,7,7,15
11365,11217,2,5,3,10
11365,11218,8,3,11,22
11365,11219,0,5,12,17
11365,11220,10,10,9,29
11365,11221,4,5,19,28
11365,11222,2,3,5,10
11365,11223,7,7,15,29
11365,11224,5,2,5,12
11365,11225,6,7,9,22
11365,11226,2,15,12,29
11365,11228,3,4,8,15
11365,11229,2,3,10,15
11365,11230,6,7,9,22
11365,11231,2,2,6,10
11365,11232,0,4,0,4
11365,11233,8,22,15,45
11365,11234,8,12,27,47
11365,11235,3,8,20,31
11365,11236,9,30,20,59
11365,11237,4,3,5,12
11365,11238,3,10,10,23
11365,11239,2,4,8,14
11365,11354,44,45,43,132
11365,11355,84,89,38,211
11365,11356,4,17,13,34
11365,11357,27,37,43,107
11365,11358,50,53,51,154
11365,11359,0,1,1,2
11365,11360,14,16,20,50
11365,11361,22,16,41,79
11365,11362,19,17,22,58
11365,11363,2,1,14,17
11365,11364,47,30,49,126
11365,11365,158,203,207,568
11365,11366,36,27,25,88
11365,11367,48,43,38,129
11365,11368,35,69,30,134
11365,11369,14,25,28,67
11365,11370,7,9,9,25
11365,11371,2,0,0,2
11365,11372,10,24,26,60
11365,11373,28,56,26,110
11365,11374,17,19,25,61
11365,11375,22,23,62,107
11365,11377,27,37,31,95
11365,11378,10,15,39,64
11365,11379,10,21,44,75
11365,11385,28,41,63,132
11365,11411,14,24,29,67
11365,11412,13,43,25,81
11365,11413,19,25,31,75
11365,11414,3,9,27,39
11365,11415,7,14,10,31
11365,11416,11,19,25,55
11365,11417,8,25,25,58
11365,11418,13,28,27,68
11365,11419,29,63,32,124
11365,11420,8,27,29,64
11365,11421,12,23,19,54
11365,11422,18,29,31,78
11365,11423,25,60,25,110
11365,11426,15,14,22,51
11365,11427,16,31,20,67
11365,11428,17,23,13,53
11365,11429,19,42,22,83
11365,11430,0,0,1,1
11365,11432,66,58,41,165
11365,11433,26,38,21,85
11365,11434,35,56,45,136
11365,11435,19,62,26,107
11365,11436,5,20,19,44
11365,11691,14,23,22,59
11365,11692,5,7,5,17
11365,11693,1,0,7,8
11365,11694,7,7,15,29
11365,11697,2,2,5,9
11366,10001,0,1,0,1
11366,10002,1,7,2,10
11366,10003,0,0,1,1
11366,10009,3,1,1,5
11366,10011,0,2,0,2
11366,10013,2,1,0,3
11366,10014,1,2,0,3
11366,10016,0,0,1,1
11366,10019,1,0,0,1
11366,10021,0,0,1,1
11366,10022,0,0,1,1
11366,10023,2,1,3,6
11366,10024,1,0,3,4
11366,10025,0,2,1,3
11366,10026,2,2,1,5
11366,10027,2,8,3,13
11366,10028,0,0,3,3
11366,10029,1,4,2,7
11366,10030,2,3,1,6
11366,10031,2,3,3,8
11366,10032,0,0,3,3
11366,10033,1,4,3,8
11366,10034,0,0,2,2
11366,10035,0,2,0,2
11366,10036,2,3,1,6
11366,10037,1,2,1,4
11366,10038,0,1,0,1
11366,10039,1,5,1,7
11366,10040,0,1,5,6
11366,10065,0,0,1,1
11366,10128,1,1,1,3
11366,10280,0,0,1,1
11366,10301,2,2,0,4
11366,10302,0,4,1,5
11366,10303,0,2,2,4
11366,10304,1,2,3,6
11366,10305,1,1,3,5
11366,10306,0,4,1,5
11366,10307,0,0,1,1
11366,10308,1,2,3,6
11366,10309,0,4,1,5
11366,10310,0,2,2,4
11366,10312,0,10,4,14
11366,10314,1,3,4,8
11366,10451,1,3,1,5
11366,10452,2,1,4,7
11366,10453,0,9,1,10
11366,10454,1,2,1,4
11366,10455,1,1,0,2
11366,10456,3,2,0,5
11366,10457,0,3,0,3
11366,10458,2,4,3,9
11366,10459,1,1,4,6
11366,10460,2,2,5,9
11366,10461,1,2,3,6
11366,10462,0,2,1,3
11366,10463,0,5,1,6
11366,10464,1,2,0,3
11366,10465,3,3,7,13
11366,10466,0,6,4,10
11366,10467,5,4,2,11
11366,10468,2,4,6,12
11366,10469,1,1,3,5
11366,10472,1,6,7,14
11366,10473,0,4,6,10
11366,10474,0,1,2,3
11366,10475,4,4,2,10
11366,11001,0,0,2,2
11366,11003,0,1,0,1
11366,11004,1,4,2,7
11366,11101,3,3,1,7
11366,11102,3,5,1,9
11366,11103,0,2,3,5
11366,11104,0,2,2,4
11366,11105,3,8,4,15
11366,11106,3,2,1,6
11366,11109,0,0,1,1
11366,11201,0,7,2,9
11366,11203,1,21,7,29
11366,11204,3,8,2,13
11366,11205,1,5,2,8
11366,11206,4,10,7,21
11366,11207,6,30,3,39
11366,11208,10,31,6,47
11366,11209,3,5,1,9
11366,11210,2,19,1,22
11366,11211,5,5,7,17
11366,11212,4,21,6,31
11366,11213,3,13,6,22
11366,11214,0,21,2,23
11366,11215,2,14,4,20
11366,11216,5,11,1,17
11366,11217,1,2,0,3
11366,11218,1,11,2,14
11366,11219,2,11,4,17
11366,11220,1,29,3,33
11366,11221,3,20,6,29
11366,11222,0,1,2,3
11366,11223,0,11,0,11
11366,11224,0,4,1,5
11366,11225,1,19,5,25
11366,11226,2,53,5,60
11366,11228,1,8,2,11
11366,11229,1,8,1,10
11366,11230,5,22,3,30
11366,11231,1,13,1,15
11366,11232,0,6,3,9
11366,11233,4,21,2,27
11366,11234,3,15,2,20
11366,11235,0,11,6,17
11366,11236,6,27,6,39
11366,11237,1,6,4,11
11366,11238,4,12,2,18
11366,11239,0,9,2,11
11366,11354,11,13,7,31
11366,11355,28,42,4,74
11366,11356,9,15,3,27
11366,11357,12,7,5,24
11366,11358,16,18,7,41
11366,11360,3,2,9,14
11366,11361,9,9,10,28
11366,11362,6,1,3,10
11366,11363,1,1,4,6
11366,11364,25,18,12,55
11366,11365,39,45,21,105
11366,11366,48,57,44,149
11366,11367,33,44,21,98
11366,11368,6,24,6,36
11366,11369,2,11,5,18
11366,11370,3,9,2,14
11366,11371,0,0,1,1
11366,11372,3,12,6,21
11366,11373,4,17,8,29
11366,11374,10,7,14,31
11366,11375,13,12,12,37
11366,11377,7,13,13,33
11366,11378,3,4,7,14
11366,11379,9,5,11,25
11366,11385,8,23,18,49
11366,11411,5,6,5,16
11366,11412,9,18,15,42
11366,11413,3,15,14,32
11366,11414,0,8,2,10
11366,11415,6,12,6,24
11366,11416,2,14,3,19
11366,11417,2,15,8,25
11366,11418,12,13,5,30
11366,11419,10,13,13,36
11366,11420,7,11,18,36
11366,11421,7,13,6,26
11366,11422,4,16,5,25
11366,11423,7,26,10,43
11366,11426,4,9,6,19
11366,11427,4,9,10,23
11366,11428,2,12,6,20
11366,11429,6,6,5,17
11366,11432,29,41,20,90
11366,11433,9,14,11,34
11366,11434,14,27,19,60
11366,11435,9,20,11,40
11366,11436,2,2,1,5
11366,11691,2,6,6,14
11366,11692,0,3,1,4
11366,11693,1,1,1,3
11366,11694,1,3,1,5
11366,11697,0,0,1,1
11367,10001,0,1,3,4
11367,10002,9,4,5,18
11367,10003,3,6,3,12
11367,10004,0,0,1,1
11367,10005,0,1,1,2
11367,10006,1,0,0,1
11367,10009,8,5,1,14
11367,10010,1,0,3,4
11367,10011,3,2,2,7
11367,10012,0,0,3,3
11367,10013,2,1,0,3
11367,10014,2,0,3,5
11367,10016,1,2,5,8
11367,10017,4,1,0,5
11367,10019,2,0,2,4
11367,10021,0,3,5,8
11367,10022,2,0,0,2
11367,10023,1,0,4,5
11367,10024,5,6,5,16
11367,10025,5,4,12,21
11367,10026,7,4,2,13
11367,10027,11,5,7,23
11367,10028,0,0,3,3
11367,10029,8,10,4,22
11367,10030,6,2,2,10
11367,10031,12,6,3,21
11367,10032,4,13,8,25
11367,10033,5,3,4,12
11367,10034,6,2,5,13
11367,10035,3,2,1,6
11367,10036,0,0,1,1
11367,10037,1,2,1,4
11367,10038,0,0,1,1
11367,10039,1,1,3,5
11367,10040,4,4,2,10
11367,10044,2,0,1,3
11367,10065,2,2,3,7
11367,10128,2,2,4,8
11367,10282,0,1,0,1
11367,10301,2,3,6,11
11367,10302,0,1,5,6
11367,10303,2,2,7,11
11367,10304,3,1,6,10
11367,10305,1,6,6,13
11367,10306,6,2,9,17
11367,10307,2,2,2,6
11367,10308,0,1,1,2
11367,10309,5,2,8,15
11367,10310,3,1,0,4
11367,10312,2,2,15,19
11367,10314,5,2,10,17
11367,10451,14,10,5,29
11367,10452,32,14,4,50
11367,10453,19,10,2,31
11367,10454,13,14,2,29
11367,10455,10,9,2,21
11367,10456,26,17,3,46
11367,10457,13,22,4,39
11367,10458,19,18,5,42
11367,10459,17,8,1,26
11367,10460,6,9,3,18
11367,10461,7,10,10,27
11367,10462,14,13,9,36
11367,10463,9,8,8,25
11367,10464,2,1,1,4
11367,10465,9,15,17,41
11367,10466,9,7,4,20
11367,10467,12,17,9,38
11367,10468,26,14,9,49
11367,10469,12,9,15,36
11367,10470,4,2,0,6
11367,10471,2,0,4,6
11367,10472,9,10,7,26
11367,10473,13,8,6,27
11367,10474,3,2,5,10
11367,10475,7,5,13,25
11367,11001,0,2,1,3
11367,11004,7,4,10,21
11367,11005,0,1,0,1
11367,11040,1,1,0,2
11367,11101,3,5,5,13
11367,11102,18,12,12,42
11367,11103,19,17,24,60
11367,11104,3,6,7,16
11367,11105,15,31,13,59
11367,11106,10,9,10,29
11367,11201,3,2,7,12
11367,11203,16,13,9,38
11367,11204,7,4,7,18
11367,11205,4,7,2,13
11367,11206,11,12,13,36
11367,11207,40,27,28,95
11367,11208,50,41,27,118
11367,11209,2,7,8,17
11367,11210,7,6,11,24
11367,11211,8,12,6,26
11367,11212,22,18,4,44
11367,11213,12,6,9,27
11367,11214,4,5,9,18
11367,11215,6,2,7,15
11367,11216,6,5,4,15
11367,11217,2,7,2,11
11367,11218,7,3,8,18
11367,11219,5,8,6,19
11367,11220,11,3,3,17
11367,11221,16,16,21,53
11367,11222,4,3,5,12
11367,11223,7,5,9,21
11367,11224,4,4,3,11
11367,11225,15,8,7,30
11367,11226,17,15,8,40
11367,11228,3,2,2,7
11367,11229,11,2,12,25
11367,11230,9,11,15,35
11367,11231,3,0,7,10
11367,11232,4,2,3,9
11367,11233,10,18,9,37
11367,11234,15,19,13,47
11367,11235,4,6,8,18
11367,11236,10,19,7,36
11367,11237,15,8,13,36
11367,11238,5,5,5,15
11367,11239,5,2,4,11
11367,11354,19,33,25,77
11367,11355,92,77,26,195
11367,11356,8,14,5,27
11367,11357,8,10,26,44
11367,11358,18,25,20,63
11367,11360,2,6,9,17
11367,11361,7,7,14,28
11367,11362,0,13,8,21
11367,11363,1,2,3,6
11367,11364,10,19,20,49
11367,11365,67,48,34,149
11367,11366,28,16,11,55
11367,11367,159,204,116,479
11367,11368,36,42,19,97
11367,11369,15,13,20,48
11367,11370,19,15,3,37
11367,11371,0,1,0,1
11367,11372,18,18,18,54
11367,11373,33,32,13,78
11367,11374,24,32,32,88
11367,11375,27,29,49,105
11367,11377,28,29,17,74
11367,11378,10,7,21,38
11367,11379,11,12,32,55
11367,11385,27,38,36,101
11367,11411,7,15,17,39
11367,11412,11,21,20,52
11367,11413,16,14,15,45
11367,11414,8,5,11,24
11367,11415,15,8,9,32
11367,11416,14,18,10,42
11367,11417,13,10,11,34
11367,11418,18,28,15,61
11367,11419,25,25,9,59
11367,11420,19,27,9,55
11367,11421,12,20,13,45
11367,11422,11,14,14,39
11367,11423,16,16,12,44
11367,11426,4,8,11,23
11367,11427,13,6,22,41
11367,11428,7,10,11,28
11367,11429,18,14,12,44
11367,11430,0,1,0,1
11367,11432,48,37,27,112
11367,11433,24,27,21,72
11367,11434,30,17,27,74
11367,11435,28,40,30,98
11367,11436,8,8,11,27
11367,11691,17,15,25,57
11367,11692,11,7,5,23
11367,11693,1,5,8,14
11367,11694,3,4,10,17
11367,11697,0,2,4,6
11368,10001,2,2,7,11
11368,10002,16,16,6,38
11368,10003,6,6,11,23
11368,10004,3,4,2,9
11368,10005,0,1,2,3
11368,10006,0,0,2,2
11368,10007,0,0,1,1
11368,10009,8,2,7,17
11368,10010,4,2,4,10
11368,10011,7,5,10,22
11368,10012,3,5,2,10
11368,10013,0,4,6,10
11368,10014,2,0,4,6
11368,10016,2,6,20,28
11368,10017,4,1,9,14
11368,10018,1,3,0,4
11368,10019,3,6,5,14
11368,10021,1,7,11,19
11368,10022,5,3,14,22
11368,10023,4,6,8,18
11368,10024,5,7,3,15
11368,10025,8,11,19,38
11368,10026,12,10,7,29
11368,10027,7,14,20,41
11368,10028,3,7,15,25
11368,10029,12,24,19,55
11368,10030,3,7,6,16
11368,10031,15,21,19,55
11368,10032,11,18,11,40
11368,10033,3,7,11,21
11368,10034,3,6,9,18
11368,10035,11,12,10,33
11368,10036,2,0,9,11
11368,10037,4,7,4,15
11368,10038,1,0,5,6
11368,10039,3,8,9,20
11368,10040,10,15,12,37
11368,10044,2,0,1,3
11368,10065,6,6,5,17
11368,10069,0,0,2,2
11368,10075,3,2,9,14
11368,10128,6,7,21,34
11368,10162,0,0,1,1
11368,10280,0,1,2,3
11368,10282,0,1,0,1
11368,10301,3,4,13,20
11368,10302,2,2,3,7
11368,10303,3,4,5,12
11368,10304,3,2,11,16
11368,10305,8,6,5,19
11368,10306,9,8,12,29
11368,10307,1,2,7,10
11368,10308,2,5,12,19
11368,10309,4,3,15,22
11368,10310,2,3,3,8
11368,10312,5,7,24,36
11368,10314,8,8,18,34
11368,10451,15,18,7,40
11368,10452,20,20,17,57
11368,10453,16,23,16,55
11368,10454,14,19,9,42
11368,10455,19,19,12,50
11368,10456,32,30,16,78
11368,10457,16,25,10,51
11368,10458,11,16,12,39
11368,10459,15,17,16,48
11368,10460,9,13,21,43
11368,10461,10,23,23,56
11368,10462,15,23,37,75
11368,10463,8,12,10,30
11368,10464,1,1,5,7
11368,10465,11,24,23,58
11368,10466,6,11,12,29
11368,10467,11,13,21,45
11368,10468,3,10,17,30
11368,10469,11,11,15,37
11368,10470,6,1,0,7
11368,10471,5,2,6,13
11368,10472,17,38,16,71
11368,10473,18,32,18,68
11368,10474,2,10,3,15
11368,10475,4,7,10,21
11368,11001,1,5,8,14
11368,11004,6,17,17,40
11368,11005,0,1,1,2
11368,11040,1,1,3,5
11368,11101,12,18,18,48
11368,11102,14,32,26,72
11368,11103,15,22,46,83
11368,11104,8,13,13,34
11368,11105,28,21,31,80
11368,11106,13,23,27,63
11368,11109,2,1,2,5
11368,11201,7,11,11,29
11368,11203,12,21,14,47
11368,11204,9,4,10,23
11368,11205,16,6,9,31
11368,11206,20,39,31,90
11368,11207,43,57,45,145
11368,11208,36,51,31,118
11368,11209,6,7,7,20
11368,11210,13,9,20,42
11368,11211,17,23,30,70
11368,11212,24,30,29,83
11368,11213,12,13,13,38
11368,11214,13,9,12,34
11368,11215,8,1,9,18
11368,11216,7,21,22,50
11368,11217,8,6,7,21
11368,11218,11,7,20,38
11368,11219,8,4,16,28
11368,11220,10,10,10,30
11368,11221,26,31,33,90
11368,11222,7,20,14,41
11368,11223,6,5,12,23
11368,11224,10,6,7,23
11368,11225,8,17,9,34
11368,11226,14,21,17,52
11368,11228,1,8,8,17
11368,11229,10,10,15,35
11368,11230,5,8,14,27
11368,11231,4,6,5,15
11368,11232,6,4,4,14
11368,11233,27,31,21,79
11368,11234,22,34,37,93
11368,11235,15,7,14,36
11368,11236,16,36,41,93
11368,11237,6,19,21,46
11368,11238,9,9,12,30
11368,11239,2,7,5,14
11368,11354,50,56,30,136
11368,11355,90,76,48,214
11368,11356,27,47,32,106
11368,11357,29,50,52,131
11368,11358,28,47,52,127
11368,11359,1,2,3,6
11368,11360,7,28,22,57
11368,11361,22,41,42,105
11368,11362,20,21,14,55
11368,11363,3,4,8,15
11368,11364,34,28,46,108
11368,11365,32,44,42,118
11368,11366,11,7,12,30
11368,11367,37,41,16,94
11368,11368,456,725,151,1332
11368,11369,67,131,30,228
11368,11370,27,23,21,71
11368,11371,0,1,1,2
11368,11372,78,121,38,237
11368,11373,127,144,42,313
11368,11374,35,31,27,93
11368,11375,49,52,64,165
11368,11377,56,97,58,211
11368,11378,21,46,41,108
11368,11379,40,31,35,106
11368,11385,44,58,51,153
11368,11411,12,20,20,52
11368,11412,24,40,42,106
11368,11413,16,23,28,67
11368,11414,9,15,29,53
11368,11415,9,16,16,41
11368,11416,16,19,23,58
11368,11417,13,13,27,53
11368,11418,22,39,27,88
11368,11419,21,40,34,95
11368,11420,12,47,25,84
11368,11421,21,45,36,102
11368,11422,9,31,18,58
11368,11423,14,32,20,66
11368,11426,9,13,14,36
11368,11427,11,19,25,55
11368,11428,12,20,23,55
11368,11429,15,13,12,40
11368,11432,37,45,45,127
11368,11433,25,31,18,74
11368,11434,30,41,41,112
11368,11435,32,72,44,148
11368,11436,14,16,15,45
11368,11451,1,0,0,1
11368,11691,16,20,22,58
11368,11692,10,7,9,26
11368,11693,5,5,6,16
11368,11694,5,9,14,28
11368,11697,2,5,6,13
11369,10001,3,3,3,9
11369,10002,6,8,7,21
11369,10003,2,2,9,13
11369,10004,0,2,0,2
11369,10005,0,1,1,2
11369,10006,1,0,0,1
11369,10007,0,1,1,2
11369,10009,4,5,11,20
11369,10010,3,0,6,9
11369,10011,2,8,9,19
11369,10012,3,1,6,10
11369,10013,0,2,5,7
11369,10014,5,2,3,10
11369,10016,2,4,8,14
11369,10017,1,3,4,8
11369,10018,0,0,2,2
11369,10019,4,2,6,12
11369,10021,0,1,3,4
11369,10022,4,5,7,16
11369,10023,1,3,5,9
11369,10024,5,5,11,21
11369,10025,10,6,17,33
11369,10026,0,9,8,17
11369,10027,8,16,11,35
11369,10028,3,3,11,17
11369,10029,15,18,13,46
11369,10030,5,11,5,21
11369,10031,8,7,17,32
11369,10032,9,13,15,37
11369,10033,8,7,6,21
11369,10034,6,9,11,26
11369,10035,9,9,9,27
11369,10036,4,2,3,9
11369,10037,3,6,5,14
11369,10038,1,1,3,5
11369,10039,8,9,8,25
11369,10040,4,4,15,23
11369,10044,0,0,1,1
11369,10065,0,1,2,3
11369,10069,3,1,2,6
11369,10075,0,1,2,3
11369,10128,5,8,11,24
11369,10280,2,0,1,3
11369,10301,1,0,3,4
11369,10302,1,1,1,3
11369,10303,3,3,4,10
11369,10304,4,4,4,12
11369,10305,3,1,9,13
11369,10306,0,3,7,10
11369,10307,0,0,1,1
11369,10308,0,1,2,3
11369,10309,1,3,6,10
11369,10310,1,2,2,5
11369,10312,2,1,14,17
11369,10314,5,7,19,31
11369,10451,16,16,17,49
11369,10452,15,28,19,62
11369,10453,12,38,18,68
11369,10454,7,19,3,29
11369,10455,8,27,12,47
11369,10456,23,31,17,71
11369,10457,6,19,19,44
11369,10458,9,11,13,33
11369,10459,12,10,9,31
11369,10460,11,23,4,38
11369,10461,6,19,17,42
11369,10462,16,19,13,48
11369,10463,8,15,8,31
11369,10465,3,9,17,29
11369,10466,4,13,10,27
11369,10467,11,22,15,48
11369,10468,9,16,10,35
11369,10469,9,11,9,29
11369,10470,2,4,5,11
11369,10471,1,3,2,6
11369,10472,13,35,11,59
11369,10473,15,13,20,48
11369,10474,4,5,3,12
11369,10475,3,7,12,22
11369,11001,1,2,1,4
11369,11003,0,0,1,1
11369,11004,1,4,14,19
11369,11040,2,0,1,3
11369,11101,6,19,10,35
11369,11102,8,11,17,36
11369,11103,4,19,19,42
11369,11104,6,20,9,35
11369,11105,10,17,25,52
11369,11106,15,22,23,60
11369,11109,3,2,1,6
11369,11201,0,3,5,8
11369,11203,11,21,9,41
11369,11204,1,4,2,7
11369,11205,1,6,3,10
11369,11206,13,23,16,52
11369,11207,24,36,36,96
11369,11208,22,67,40,129
11369,11209,4,4,10,18
11369,11210,5,12,13,30
11369,11211,14,29,16,59
11369,11212,15,21,17,53
11369,11213,5,12,8,25
11369,11214,4,3,6,13
11369,11215,1,4,2,7
11369,11216,9,13,13,35
11369,11217,0,5,2,7
11369,11218,4,7,9,20
11369,11219,10,8,6,24
11369,11220,5,9,10,24
11369,11221,8,22,23,53
11369,11222,4,3,7,14
11369,11223,4,5,15,24
11369,11224,2,2,8,12
11369,11225,5,14,12,31
11369,11226,6,27,17,50
11369,11228,1,4,4,9
11369,11229,1,5,15,21
11369,11230,6,17,12,35
11369,11231,2,7,2,11
11369,11232,0,3,1,4
11369,11233,6,25,12,43
11369,11234,5,24,23,52
11369,11235,2,7,9,18
11369,11236,12,20,27,59
11369,11237,5,17,10,32
11369,11238,4,10,11,25
11369,11239,1,3,5,9
11369,11354,15,17,24,56
11369,11355,21,42,32,95
11369,11356,10,12,15,37
11369,11357,8,18,46,72
11369,11358,13,27,18,58
11369,11360,2,3,15,20
11369,11361,10,6,14,30
11369,11362,5,6,5,16
11369,11363,0,1,1,2
11369,11364,8,20,23,51
11369,11365,19,33,19,71
11369,11366,10,6,8,24
11369,11367,6,23,22,51
11369,11368,84,129,55,268
11369,11369,113,246,83,442
11369,11370,31,46,20,97
11369,11371,1,0,0,1
11369,11372,34,89,44,167
11369,11373,53,80,30,163
11369,11374,6,26,22,54
11369,11375,16,27,29,72
11369,11377,21,66,33,120
11369,11378,4,16,24,44
11369,11379,16,20,20,56
11369,11385,26,47,43,116
11369,11411,12,20,15,47
11369,11412,14,36,13,63
11369,11413,12,30,21,63
11369,11414,3,6,12,21
11369,11415,5,10,15,30
11369,11416,9,15,11,35
11369,11417,6,33,21,60
11369,11418,15,44,36,95
11369,11419,14,81,21,116
11369,11420,13,66,25,104
11369,11421,8,31,24,63
11369,11422,16,28,18,62
11369,11423,11,23,10,44
11369,11426,2,21,8,31
11369,11427,3,21,13,37
11369,11428,9,23,7,39
11369,11429,16,14,16,46
11369,11430,0,1,0,1
11369,11432,29,43,18,90
11369,11433,10,56,17,83
11369,11434,19,47,32,98
11369,11435,25,41,28,94
11369,11436,3,33,13,49
11369,11691,6,16,11,33
11369,11692,0,5,2,7
11369,11693,1,1,4,6
11369,11694,1,6,6,13
11369,11697,1,1,2,4
11370,10001,1,3,12,16
11370,10002,5,10,32,47
11370,10003,3,4,20,27
11370,10004,1,2,0,3
11370,10005,0,1,3,4
11370,10006,1,0,1,2
11370,10007,0,0,5,5
11370,10009,2,7,30,39
11370,10010,4,3,21,28
11370,10011,2,6,27,35
11370,10012,1,6,15,22
11370,10013,2,3,10,15
11370,10014,2,4,12,18
11370,10016,2,8,23,33
11370,10017,3,1,9,13
11370,10018,1,3,7,11
11370,10019,5,6,15,26
11370,10021,1,0,15,16
11370,10022,2,0,18,20
11370,10023,4,7,27,38
11370,10024,4,2,46,52
11370,10025,15,20,69,104
11370,10026,5,12,45,62
11370,10027,8,20,55,83
11370,10028,2,1,26,29
11370,10029,13,22,71,106
11370,10030,6,4,42,52
11370,10031,6,14,49,69
11370,10032,9,16,49,74
11370,10033,7,9,50,66
11370,10034,2,11,37,50
11370,10035,4,13,42,59
11370,10036,2,7,23,32
11370,10037,3,9,26,38
11370,10038,0,2,11,13
11370,10039,5,9,27,41
11370,10040,1,10,35,46
11370,10044,1,1,4,6
11370,10065,4,3,15,22
11370,10069,0,0,3,3
11370,10075,2,1,19,22
11370,10128,5,6,35,46
11370,10162,0,0,1,1
11370,10280,1,0,1,2
11370,10301,2,6,25,33
11370,10302,1,1,15,17
11370,10303,2,3,11,16
11370,10304,4,8,26,38
11370,10305,1,5,29,35
11370,10306,2,10,47,59
11370,10307,0,4,9,13
11370,10308,3,7,26,36
11370,10309,2,5,28,35
11370,10310,1,6,14,21
11370,10312,3,7,55,65
11370,10314,6,9,56,71
11370,10451,8,13,51,72
11370,10452,7,24,56,87
11370,10453,14,38,47,99
11370,10454,3,17,25,45
11370,10455,4,20,33,57
11370,10456,8,23,70,101
11370,10457,15,28,63,106
11370,10458,10,33,53,96
11370,10459,7,28,33,68
11370,10460,10,25,48,83
11370,10461,9,17,96,122
11370,10462,18,29,109,156
11370,10463,6,9,45,60
11370,10464,0,2,6,8
11370,10465,4,20,87,111
11370,10466,10,30,80,120
11370,10467,6,37,62,105
11370,10468,7,22,54,83
11370,10469,11,24,81,116
11370,10470,0,5,17,22
11370,10471,0,5,16,21
11370,10472,17,19,37,73
11370,10473,11,30,78,119
11370,10474,2,1,13,16
11370,10475,4,14,64,82
11370,11001,0,3,2,5
11370,11004,5,9,14,28
11370,11005,0,0,2,2
11370,11040,0,0,6,6
11370,11101,4,20,20,44
11370,11102,12,17,46,75
11370,11103,13,28,50,91
11370,11104,6,8,32,46
11370,11105,17,19,57,93
11370,11106,13,18,47,78
11370,11109,0,0,2,2
11370,11201,7,8,31,46
11370,11203,4,14,39,57
11370,11204,2,2,15,19
11370,11205,5,6,20,31
11370,11206,11,22,53,86
11370,11207,14,23,68,105
11370,11208,14,27,49,90
11370,11209,4,6,31,41
11370,11210,4,7,28,39
11370,11211,6,11,46,63
11370,11212,11,24,53,88
11370,11213,4,16,35,55
11370,11214,3,7,30,40
11370,11215,2,6,25,33
11370,11216,8,9,39,56
11370,11217,5,6,26,37
11370,11218,2,5,24,31
11370,11219,3,3,20,26
11370,11220,6,8,22,36
11370,11221,5,16,55,76
11370,11222,3,6,42,51
11370,11223,3,11,25,39
11370,11224,1,5,16,22
11370,11225,5,9,28,42
11370,11226,6,15,47,68
11370,11228,7,3,17,27
11370,11229,5,4,33,42
11370,11230,2,11,24,37
11370,11231,1,6,25,32
11370,11232,1,5,15,21
11370,11233,8,22,39,69
11370,11234,4,15,67,86
11370,11235,2,10,30,42
11370,11236,15,13,96,124
11370,11237,1,6,24,31
11370,11238,4,11,28,43
11370,11239,0,7,10,17
11370,11354,15,21,53,89
11370,11355,14,28,56,98
11370,11356,9,11,25,45
11370,11357,8,33,79,120
11370,11358,9,21,53,83
11370,11359,0,0,1,1
11370,11360,1,12,29,42
11370,11361,15,12,40,67
11370,11362,8,9,26,43
11370,11363,2,4,11,17
11370,11364,7,7,59,73
11370,11365,11,15,38,64
11370,11366,3,6,19,28
11370,11367,19,12,45,76
11370,11368,14,42,55,111
11370,11369,26,55,51,132
11370,11370,67,71,70,208
11370,11371,1,0,1,2
11370,11372,28,38,87,153
11370,11373,19,36,60,115
11370,11374,8,16,47,71
11370,11375,18,22,91,131
11370,11377,27,40,111,178
11370,11378,10,9,60,79
11370,11379,4,24,72,100
11370,11385,8,41,138,187
11370,11411,11,7,35,53
11370,11412,7,16,54,77
11370,11413,7,15,43,65
11370,11414,6,7,27,40
11370,11415,7,7,22,36
11370,11416,7,4,22,33
11370,11417,2,12,26,40
11370,11418,3,11,33,47
11370,11419,12,22,31,65
11370,11420,9,10,44,63
11370,11421,8,13,31,52
11370,11422,3,9,63,75
11370,11423,3,9,29,41
11370,11426,1,8,22,31
11370,11427,4,12,37,53
11370,11428,4,14,25,43
11370,11429,6,7,36,49
11370,11432,11,26,50,87
11370,11433,9,14,40,63
11370,11434,11,20,73,104
11370,11435,11,22,57,90
11370,11436,3,13,32,48
11370,11691,7,11,35,53
11370,11692,1,4,9,14
11370,11693,2,0,13,15
11370,11694,4,1,12,17
11370,11697,1,0,3,4
11371,10001,0,4,10,14
11371,10002,2,8,9,19
11371,10003,0,3,17,20
11371,10004,0,0,3,3
11371,10005,0,0,1,1
11371,10007,0,0,2,2
11371,10009,2,3,9,14
11371,10010,0,1,12,13
11371,10011,3,7,21,31
11371,10012,3,2,2,7
11371,10013,0,2,1,3
11371,10014,2,1,8,11
11371,10016,1,2,20,23
11371,10017,2,4,7,13
11371,10018,1,3,2,6
11371,10019,1,7,14,22
11371,10021,1,0,20,21
11371,10022,4,5,17,26
11371,10023,8,2,10,20
11371,10024,1,5,7,13
11371,10025,5,14,26,45
11371,10026,4,8,14,26
11371,10027,3,14,17,34
11371,10028,1,3,14,18
11371,10029,7,11,18,36
11371,10030,0,7,10,17
11371,10031,6,6,23,35
11371,10032,0,4,22,26
11371,10033,1,9,5,15
11371,10034,0,3,6,9
11371,10035,1,6,8,15
11371,10036,1,1,7,9
11371,10037,4,5,6,15
11371,10038,0,3,2,5
11371,10039,0,6,2,8
11371,10040,0,7,7,14
11371,10044,3,0,3,6
11371,10065,1,1,9,11
11371,10069,0,0,1,1
11371,10075,0,0,8,8
11371,10128,2,4,15,21
11371,10162,0,0,1,1
11371,10280,0,0,5,5
11371,10301,1,2,9,12
11371,10302,0,1,7,8
11371,10303,0,0,2,2
11371,10304,0,3,9,12
11371,10305,3,1,9,13
11371,10306,0,0,8,8
11371,10307,0,0,2,2
11371,10308,0,1,4,5
11371,10309,0,1,8,9
11371,10310,0,0,9,9
11371,10312,0,0,14,14
11371,10314,1,8,16,25
11371,10451,2,10,10,22
11371,10452,7,7,17,31
11371,10453,3,5,11,19
11371,10454,1,12,0,13
11371,10455,1,8,9,18
11371,10456,3,5,9,17
11371,10457,1,7,11,19
11371,10458,4,10,8,22
11371,10459,1,14,9,24
11371,10460,7,17,6,30
11371,10461,3,3,10,16
11371,10462,1,13,25,39
11371,10463,0,11,13,24
11371,10464,0,2,2,4
11371,10465,3,6,11,20
11371,10466,2,15,16,33
11371,10467,5,17,30,52
11371,10468,0,15,9,24
11371,10469,5,14,20,39
11371,10470,1,2,7,10
11371,10471,0,1,8,9
11371,10472,3,7,9,19
11371,10473,2,10,10,22
11371,10474,0,1,0,1
11371,10475,2,5,8,15
11371,11001,2,0,2,4
11371,11003,0,1,0,1
11371,11004,1,2,6,9
11371,11005,0,1,1,2
11371,11040,1,1,1,3
11371,11101,4,5,22,31
11371,11102,6,16,21,43
11371,11103,6,14,39,59
11371,11104,0,3,11,14
11371,11105,1,8,53,62
11371,11106,1,12,26,39
11371,11109,0,1,11,12
11371,11201,1,4,10,15
11371,11203,7,25,20,52
11371,11204,2,7,6,15
11371,11205,1,7,7,15
11371,11206,6,10,25,41
11371,11207,10,34,30,74
11371,11208,12,23,40,75
11371,11209,1,5,11,17
11371,11210,1,9,17,27
11371,11211,2,9,16,27
11371,11212,4,23,19,46
11371,11213,3,6,13,22
11371,11214,2,3,10,15
11371,11215,0,0,7,7
11371,11216,0,6,10,16
11371,11217,1,2,10,13
11371,11218,0,4,7,11
11371,11219,2,4,8,14
11371,11220,3,2,9,14
11371,11221,9,33,19,61
11371,11222,3,3,8,14
11371,11223,0,7,5,12
11371,11224,1,5,6,12
11371,11225,2,13,12,27
11371,11226,5,28,14,47
11371,11228,1,4,4,9
11371,11229,0,3,12,15
11371,11230,2,4,5,11
11371,11231,0,3,6,9
11371,11232,1,1,2,4
11371,11233,8,20,22,50
11371,11234,3,13,28,44
11371,11235,1,1,6,8
11371,11236,6,24,49,79
11371,11237,5,6,18,29
11371,11238,2,8,14,24
11371,11239,1,1,5,7
11371,11354,1,10,21,32
11371,11355,8,14,29,51
11371,11356,5,3,17,25
11371,11357,2,6,42,50
11371,11358,2,6,27,35
11371,11360,0,7,14,21
11371,11361,5,8,17,30
11371,11362,0,7,13,20
11371,11363,0,2,4,6
11371,11364,0,5,18,23
11371,11365,2,7,19,28
11371,11366,3,3,4,10
11371,11367,3,3,23,29
11371,11368,13,21,66,100
11371,11369,8,42,56,106
11371,11370,7,9,21,37
11371,11372,2,19,55,76
11371,11373,7,21,42,70
11371,11374,1,6,24,31
11371,11375,1,20,63,84
11371,11377,7,24,50,81
11371,11378,5,7,23,35
11371,11379,1,11,36,48
11371,11385,7,18,55,80
11371,11411,1,13,13,27
11371,11412,4,18,35,57
11371,11413,9,17,37,63
11371,11414,1,9,39,49
11371,11415,0,10,54,64
11371,11416,4,13,18,35
11371,11417,2,9,35,46
11371,11418,4,22,35,61
11371,11419,6,39,27,72
11371,11420,9,19,55,83
11371,11421,1,25,26,52
11371,11422,4,12,49,65
11371,11423,3,9,27,39
11371,11426,0,5,9,14
11371,11427,4,9,11,24
11371,11428,0,6,14,20
11371,11429,6,7,15,28
11371,11430,0,1,1,2
11371,11432,7,17,37,61
11371,11433,7,9,23,39
11371,11434,8,41,36,85
11371,11435,7,18,46,71
11371,11436,2,8,15,25
11371,11691,3,15,23,41
11371,11692,1,3,6,10
11371,11693,1,3,4,8
11371,11694,1,4,4,9
11371,11697,0,0,1,1
11372,10001,6,7,4,17
11372,10002,14,8,18,40
11372,10003,5,6,6,17
11372,10004,3,2,4,9
11372,10005,0,2,3,5
11372,10006,1,1,0,2
11372,10007,1,2,1,4
11372,10009,19,8,8,35
11372,10010,3,2,3,8
11372,10011,3,8,11,22
11372,10012,0,3,5,8
11372,10013,1,2,4,7
11372,10014,1,5,10,16
11372,10016,5,6,7,18
11372,10017,2,4,3,9
11372,10018,2,2,4,8
11372,10019,4,9,10,23
11372,10021,4,2,8,14
11372,10022,1,5,9,15
11372,10023,3,5,7,15
11372,10024,7,5,5,17
11372,10025,12,10,11,33
11372,10026,11,8,6,25
11372,10027,10,13,15,38
11372,10028,3,3,12,18
11372,10029,18,19,25,62
11372,10030,2,8,8,18
11372,10031,6,28,12,46
11372,10032,16,10,10,36
11372,10033,7,10,12,29
11372,10034,4,6,4,14
11372,10035,7,11,4,22
11372,10036,1,12,7,20
11372,10037,2,3,4,9
11372,10038,3,4,3,10
11372,10039,0,11,7,18
11372,10040,5,9,9,23
11372,10044,6,3,2,11
11372,10065,1,2,7,10
11372,10069,0,2,2,4
11372,10075,1,3,6,10
11372,10128,4,9,9,22
11372,10162,0,1,0,1
11372,10280,0,0,2,2
11372,10282,2,0,0,2
11372,10301,0,2,3,5
11372,10302,3,2,3,8
11372,10303,2,1,3,6
11372,10304,4,6,4,14
11372,10305,4,2,1,7
11372,10306,1,1,8,10
11372,10307,0,0,2,2
11372,10308,2,0,6,8
11372,10309,1,4,2,7
11372,10310,1,1,1,3
11372,10312,1,2,5,8
11372,10314,4,1,7,12
11372,10451,7,17,10,34
11372,10452,15,29,15,59
11372,10453,16,32,16,64
11372,10454,6,20,5,31
11372,10455,15,18,5,38
11372,10456,21,29,13,63
11372,10457,17,27,13,57
11372,10458,10,25,12,47
11372,10459,7,17,12,36
11372,10460,14,20,6,40
11372,10461,13,16,13,42
11372,10462,29,28,24,81
11372,10463,9,7,7,23
11372,10464,2,1,5,8
11372,10465,12,11,13,36
11372,10466,4,7,8,19
11372,10467,15,21,10,46
11372,10468,13,23,20,56
11372,10469,7,13,5,25
11372,10470,0,2,1,3
11372,10471,2,1,1,4
11372,10472,25,19,17,61
11372,10473,18,16,14,48
11372,10474,2,5,3,10
11372,10475,5,4,8,17
11372,11001,1,2,3,6
11372,11004,11,6,3,20
11372,11040,1,1,0,2
11372,11101,18,13,15,46
11372,11102,19,11,13,43
11372,11103,24,18,26,68
11372,11104,16,25,12,53
11372,11105,20,24,23,67
11372,11106,41,14,15,70
11372,11109,3,1,1,5
11372,11201,9,8,22,39
11372,11203,7,10,12,29
11372,11204,2,4,7,13
11372,11205,3,11,11,25
11372,11206,14,25,20,59
11372,11207,27,32,27,86
11372,11208,33,41,24,98
11372,11209,5,4,13,22
11372,11210,3,6,12,21
11372,11211,12,33,25,70
11372,11212,20,25,13,58
11372,11213,8,16,16,40
11372,11214,5,6,10,21
11372,11215,9,5,17,31
11372,11216,9,10,11,30
11372,11217,4,7,16,27
11372,11218,8,8,13,29
11372,11219,5,5,7,17
11372,11220,14,8,10,32
11372,11221,16,21,22,59
11372,11222,6,12,9,27
11372,11223,3,11,6,20
11372,11224,1,3,2,6
11372,11225,4,5,7,16
11372,11226,11,20,8,39
11372,11228,2,1,5,8
11372,11229,4,7,5,16
11372,11230,8,7,3,18
11372,11231,0,6,3,9
11372,11232,3,2,6,11
11372,11233,22,21,19,62
11372,11234,22,41,32,95
11372,11235,8,7,8,23
11372,11236,26,36,18,80
11372,11237,6,16,12,34
11372,11238,7,16,6,29
11372,11239,0,10,3,13
11372,11354,19,36,24,79
11372,11355,41,37,34,112
11372,11356,10,19,12,41
11372,11357,13,34,38,85
11372,11358,8,32,20,60
11372,11359,1,0,1,2
11372,11360,2,21,10,33
11372,11361,8,21,21,50
11372,11362,7,10,12,29
11372,11363,3,3,0,6
11372,11364,12,23,34,69
11372,11365,15,22,22,59
11372,11366,1,7,6,14
11372,11367,18,30,19,67
11372,11368,133,221,37,391
11372,11369,63,86,29,178
11372,11370,60,84,17,161
11372,11371,0,0,1,1
11372,11372,317,452,188,957
11372,11373,160,221,52,433
11372,11374,19,26,23,68
11372,11375,21,31,30,82
11372,11377,119,153,71,343
11372,11378,19,33,25,77
11372,11379,16,18,24,58
11372,11385,25,50,34,109
11372,11411,11,9,11,31
11372,11412,12,27,21,60
11372,11413,6,12,23,41
11372,11414,5,11,15,31
11372,11415,5,6,13,24
11372,11416,9,20,11,40
11372,11417,14,17,12,43
11372,11418,23,28,16,67
11372,11419,24,42,22,88
11372,11420,15,24,13,52
11372,11421,15,38,17,70
11372,11422,6,15,8,29
11372,11423,11,26,12,49
11372,11426,12,10,8,30
11372,11427,11,12,13,36
11372,11428,8,15,12,35
11372,11429,6,18,12,36
11372,11430,1,0,0,1
11372,11432,69,71,33,173
11372,11433,21,23,9,53
11372,11434,10,26,21,57
11372,11435,37,37,27,101
11372,11436,8,10,12,30
11372,11691,8,5,8,21
11372,11692,0,2,2,4
11372,11693,0,1,1,2
11372,11694,1,0,3,4
11372,11697,0,0,1,1
11373,10001,3,6,11,20
11373,10002,38,33,55,126
11373,10003,8,16,32,56
11373,10004,4,10,6,20
11373,10005,0,0,2,2
11373,10006,0,1,0,1
11373,10007,1,0,4,5
11373,10009,10,23,47,80
11373,10010,4,5,19,28
11373,10011,8,12,18,38
11373,10012,3,7,9,19
11373,10013,10,12,14,36
11373,10014,4,8,25,37
11373,10016,6,8,36,50
11373,10017,4,4,13,21
11373,10018,2,1,5,8
11373,10019,13,8,26,47
11373,10021,8,6,26,40
11373,10022,5,15,15,35
11373,10023,3,12,42,57
11373,10024,9,12,40,61
11373,10025,21,33,70,124
11373,10026,14,17,35,66
11373,10027,21,28,33,82
11373,10028,5,6,34,45
11373,10029,35,60,91,186
11373,10030,7,12,17,36
11373,10031,14,30,30,74
11373,10032,11,19,22,52
11373,10033,18,23,30,71
11373,10034,5,15,22,42
11373,10035,13,23,47,83
11373,10036,10,14,15,39
11373,10037,6,11,32,49
11373,10038,5,8,12,25
11373,10039,8,11,27,46
11373,10040,12,11,12,35
11373,10044,6,4,11,21
11373,10065,10,8,20,38
11373,10069,1,0,5,6
11373,10075,1,2,28,31
11373,10119,0,0,1,1
11373,10128,16,9,89,114
11373,10162,0,1,0,1
11373,10280,1,3,2,6
11373,10282,0,1,3,4
11373,10301,18,11,24,53
11373,10302,3,13,11,27
11373,10303,11,11,15,37
11373,10304,9,14,23,46
11373,10305,14,11,24,49
11373,10306,13,16,30,59
11373,10307,4,3,5,12
11373,10308,10,6,18,34
11373,10309,5,12,26,43
11373,10310,7,7,9,23
11373,10312,13,19,34,66
11373,10314,19,27,49,95
11373,10451,20,39,31,90
11373,10452,12,33,27,72
11373,10453,23,36,37,96
11373,10454,13,42,32,87
11373,10455,24,35,42,101
11373,10456,27,49,41,117
11373,10457,27,34,32,93
11373,10458,29,33,38,100
11373,10459,31,36,37,104
11373,10460,18,44,33,95
11373,10461,21,30,71,122
11373,10462,25,35,104,164
11373,10463,16,17,44,77
11373,10464,1,1,10,12
11373,10465,26,18,80,124
11373,10466,27,23,58,108
11373,10467,34,52,65,151
11373,10468,25,34,44,103
11373,10469,25,32,52,109
11373,10470,12,5,15,32
11373,10471,1,6,17,24
11373,10472,20,44,62,126
11373,10473,20,43,91,154
11373,10474,5,12,5,22
11373,10475,16,26,67,109
11373,11001,5,10,8,23
11373,11003,0,1,0,1
11373,11004,7,10,32,49
11373,11005,1,2,1,4
11373,11040,1,2,6,9
11373,11101,26,22,41,89
11373,11102,26,33,50,109
11373,11103,33,30,60,123
11373,11104,20,21,35,76
11373,11105,23,24,52,99
11373,11106,24,48,46,118
11373,11109,0,2,8,10
11373,11201,9,11,34,54
11373,11203,32,35,69,136
11373,11204,13,17,30,60
11373,11205,18,9,27,54
11373,11206,49,55,78,182
11373,11207,83,107,117,307
11373,11208,56,93,121,270
11373,11209,18,26,48,92
11373,11210,19,30,69,118
11373,11211,29,53,71,153
11373,11212,50,74,96,220
11373,11213,32,42,56,130
11373,11214,23,31,37,91
11373,11215,7,9,34,50
11373,11216,27,39,77,143
11373,11217,18,15,19,52
11373,11218,16,17,29,62
11373,11219,10,16,22,48
11373,11220,26,37,34,97
11373,11221,47,56,87,190
11373,11222,14,16,37,67
11373,11223,14,25,39,78
11373,11224,8,9,24,41
11373,11225,15,26,38,79
11373,11226,29,53,93,175
11373,11228,10,16,19,45
11373,11229,17,21,44,82
11373,11230,20,13,43,76
11373,11231,8,3,24,35
11373,11232,8,15,7,30
11373,11233,50,41,100,191
11373,11234,56,75,142,273
11373,11235,13,11,35,59
11373,11236,75,90,165,330
11373,11237,43,31,46,120
11373,11238,9,16,51,76
11373,11239,4,8,20,32
11373,11354,59,66,69,194
11373,11355,138,139,74,351
11373,11356,19,30,26,75
11373,11357,41,45,67,153
11373,11358,38,52,60,150
11373,11359,2,0,0,2
11373,11360,11,13,29,53
11373,11361,26,37,59,122
11373,11362,6,21,28,55
11373,11363,9,3,13,25
11373,11364,28,48,54,130
11373,11365,45,58,68,171
11373,11366,8,21,25,54
11373,11367,28,35,51,114
11373,11368,221,315,124,660
11373,11369,52,99,63,214
11373,11370,47,62,37,146
11373,11371,0,2,1,3
11373,11372,110,149,104,363
11373,11373,562,686,247,1495
11373,11374,57,70,80,207
11373,11375,74,89,152,315
11373,11377,135,192,131,458
11373,11378,70,97,86,253
11373,11379,59,66,101,226
11373,11385,75,124,135,334
11373,11411,28,30,52,110
11373,11412,51,41,94,186
11373,11413,33,51,94,178
11373,11414,14,20,47,81
11373,11415,18,32,38,88
11373,11416,16,49,39,104
11373,11417,38,42,54,134
11373,11418,52,51,56,159
11373,11419,30,56,52,138
11373,11420,40,41,64,145
11373,11421,65,58,77,200
11373,11422,33,21,58,112
11373,11423,28,35,68,131
11373,11426,19,13,36,68
11373,11427,23,25,42,90
11373,11428,19,23,35,77
11373,11429,28,34,54,116
11373,11430,0,1,1,2
11373,11432,71,84,106,261
11373,11433,36,38,53,127
11373,11434,76,82,107,265
11373,11435,57,74,94,225
11373,11436,17,23,30,70
11373,11451,1,2,0,3
11373,11691,27,27,37,91
11373,11692,8,10,13,31
11373,11693,7,5,11,23
11373,11694,6,11,21,38
11373,11697,2,1,7,10
11374,10001,4,4,5,13
11374,10002,26,24,11,61
11374,10003,6,8,10,24
11374,10005,0,1,0,1
11374,10006,0,0,1,1
11374,10007,1,0,0,1
11374,10009,11,10,9,30
11374,10010,5,0,4,9
11374,10011,4,6,4,14
11374,10012,3,7,3,13
11374,10013,4,7,5,16
11374,10014,0,3,5,8
11374,10016,3,4,11,18
11374,10017,0,0,3,3
11374,10018,0,0,2,2
11374,10019,2,2,5,9
11374,10021,3,1,3,7
11374,10022,2,0,4,6
11374,10023,2,1,13,16
11374,10024,8,4,6,18
11374,10025,7,5,13,25
11374,10026,7,7,7,21
11374,10027,6,14,12,32
11374,10028,1,1,10,12
11374,10029,23,22,12,57
11374,10030,2,7,3,12
11374,10031,8,11,11,30
11374,10032,7,15,12,34
11374,10033,11,12,7,30
11374,10034,8,9,8,25
11374,10035,12,10,2,24
11374,10036,2,1,0,3
11374,10037,1,4,3,8
11374,10038,3,7,3,13
11374,10039,3,2,2,7
11374,10040,4,10,11,25
11374,10044,0,0,3,3
11374,10065,5,4,7,16
11374,10069,0,0,2,2
11374,10075,1,1,2,4
11374,10128,7,6,12,25
11374,10162,0,1,0,1
11374,10280,1,1,2,4
11374,10282,1,2,2,5
11374,10301,3,14,10,27
11374,10302,2,1,6,9
11374,10303,2,9,5,16
11374,10304,4,4,11,19
11374,10305,4,9,18,31
11374,10306,7,12,12,31
11374,10307,2,5,1,8
11374,10308,2,4,5,11
11374,10309,4,3,8,15
11374,10310,1,2,5,8
11374,10312,5,9,12,26
11374,10314,16,19,21,56
11374,10451,10,23,8,41
11374,10452,19,41,22,82
11374,10453,23,31,27,81
11374,10454,16,22,7,45
11374,10455,15,18,9,42
11374,10456,24,43,14,81
11374,10457,24,41,10,75
11374,10458,23,45,10,78
11374,10459,17,27,8,52
11374,10460,14,22,9,45
11374,10461,10,29,16,55
11374,10462,30,35,22,87
11374,10463,11,21,16,48
11374,10464,0,1,0,1
11374,10465,6,13,10,29
11374,10466,8,24,12,44
11374,10467,24,45,15,84
11374,10468,17,23,16,56
11374,10469,12,17,26,55
11374,10470,1,4,3,8
11374,10471,3,6,3,12
11374,10472,35,51,15,101
11374,10473,14,29,15,58
11374,10474,5,8,6,19
11374,10475,3,11,3,17
11374,11001,2,2,2,6
11374,11004,4,5,3,12
11374,11005,2,1,1,4
11374,11040,2,1,0,3
11374,11101,11,18,7,36
11374,11102,19,12,15,46
11374,11103,17,21,11,49
11374,11104,7,11,17,35
11374,11105,8,24,21,53
11374,11106,15,30,15,60
11374,11109,1,1,1,3
11374,11201,9,6,13,28
11374,11203,11,36,13,60
11374,11204,30,31,19,80
11374,11205,7,5,12,24
11374,11206,21,33,20,74
11374,11207,40,51,36,127
11374,11208,37,77,51,165
11374,11209,10,15,17,42
11374,11210,10,32,24,66
11374,11211,25,23,16,64
11374,11212,23,41,19,83
11374,11213,19,15,10,44
11374,11214,46,76,36,158
11374,11215,3,8,10,21
11374,11216,15,8,12,35
11374,11217,4,3,4,11
11374,11218,18,32,12,62
11374,11219,25,38,22,85
11374,11220,23,22,15,60
11374,11221,14,36,20,70
11374,11222,6,13,21,40
11374,11223,40,61,47,148
11374,11224,38,45,27,110
11374,11225,10,13,17,40
11374,11226,22,40,19,81
11374,11228,10,10,10,30
11374,11229,39,50,45,134
11374,11230,29,53,16,98
11374,11231,0,1,3,4
11374,11232,2,10,8,20
11374,11233,19,30,9,58
11374,11234,18,46,25,89
11374,11235,54,83,58,195
11374,11236,16,24,34,74
11374,11237,10,19,16,45
11374,11238,8,12,10,30
11374,11239,8,7,6,21
11374,11354,31,37,33,101
11374,11355,35,66,51,152
11374,11356,9,21,11,41
11374,11357,12,12,24,48
11374,11358,21,27,27,75
11374,11359,0,1,1,2
11374,11360,6,5,13,24
11374,11361,19,15,13,47
11374,11362,1,6,11,18
11374,11363,2,2,6,10
11374,11364,26,31,34,91
11374,11365,26,24,29,79
11374,11366,15,16,24,55
11374,11367,36,43,52,131
11374,11368,113,144,66,323
11374,11369,18,45,31,94
11374,11370,15,34,17,66
11374,11371,1,0,0,1
11374,11372,40,83,33,156
11374,11373,98,148,71,317
11374,11374,228,338,236,802
11374,11375,148,226,187,561
11374,11377,56,104,55,215
11374,11378,26,36,33,95
11374,11379,57,71,68,196
11374,11385,69,114,68,251
11374,11411,7,4,14,25
11374,11412,22,32,29,83
11374,11413,17,48,33,98
11374,11414,8,14,18,40
11374,11415,12,34,33,79
11374,11416,35,32,16,83
11374,11417,25,26,19,70
11374,11418,44,55,21,120
11374,11419,22,68,26,116
11374,11420,21,57,31,109
11374,11421,48,54,30,132
11374,11422,8,17,15,40
11374,11423,22,47,23,92
11374,11426,8,16,13,37
11374,11427,18,14,19,51
11374,11428,13,31,13,57
11374,11429,18,16,14,48
11374,11430,0,0,2,2
11374,11432,82,104,43,229
11374,11433,32,37,10,79
11374,11434,22,53,34,109
11374,11435,65,76,47,188
11374,11436,14,16,16,46
11374,11691,17,25,18,60
11374,11692,4,6,7,17
11374,11693,6,8,9,23
11374,11694,2,8,10,20
11374,11697,2,1,2,5
11375,10001,6,3,9,18
11375,10002,24,33,15,72
11375,10003,11,10,19,40
11375,10004,0,1,1,2
11375,10005,1,0,4,5
11375,10006,0,1,1,2
11375,10007,1,1,1,3
11375,10009,17,18,22,57
11375,10010,4,4,7,15
11375,10011,9,10,9,28
11375,10012,3,4,6,13
11375,10013,6,3,8,17
11375,10014,5,2,7,14
11375,10016,8,9,17,34
11375,10017,0,0,7,7
11375,10018,4,0,1,5
11375,10019,9,8,13,30
11375,10021,1,1,15,17
11375,10022,0,4,10,14
11375,10023,7,8,16,31
11375,10024,9,13,22,44
11375,10025,15,24,31,70
11375,10026,16,21,23,60
11375,10027,17,26,17,60
11375,10028,5,8,18,31
11375,10029,28,46,29,103
11375,10030,10,7,12,29
11375,10031,30,34,25,89
11375,10032,27,41,25,93
11375,10033,27,33,17,77
11375,10034,12,42,13,67
11375,10035,7,21,15,43
11375,10036,12,6,13,31
11375,10037,10,9,14,33
11375,10038,4,5,8,17
11375,10039,9,15,9,33
11375,10040,19,47,13,79
11375,10044,1,2,5,8
11375,10065,0,3,22,25
11375,10069,2,1,0,3
11375,10075,2,4,13,19
11375,10128,6,15,12,33
11375,10280,2,0,0,2
11375,10282,1,0,3,4
11375,10301,10,9,23,42
11375,10302,7,13,5,25
11375,10303,6,13,16,35
11375,10304,10,14,23,47
11375,10305,12,19,43,74
11375,10306,7,33,43,83
11375,10307,2,5,9,16
11375,10308,5,9,31,45
11375,10309,3,11,29,43
11375,10310,8,6,10,24
11375,10312,8,29,53,90
11375,10314,24,42,74,140
11375,10451,33,55,11,99
11375,10452,71,106,25,202
11375,10453,95,133,27,255
11375,10454,25,56,8,89
11375,10455,27,42,10,79
11375,10456,89,119,20,228
11375,10457,69,109,21,199
11375,10458,72,95,23,190
11375,10459,23,65,21,109
11375,10460,43,69,20,132
11375,10461,15,37,40,92
11375,10462,63,67,43,173
11375,10463,28,60,36,124
11375,10464,4,2,3,9
11375,10465,10,21,27,58
11375,10466,58,83,28,169
11375,10467,72,123,46,241
11375,10468,53,101,30,184
11375,10469,47,67,42,156
11375,10470,13,25,9,47
11375,10471,6,18,11,35
11375,10472,33,68,28,129
11375,10473,40,52,26,118
11375,10474,4,17,1,22
11375,10475,25,33,25,83
11375,11001,3,7,6,16
11375,11004,8,23,27,58
11375,11005,0,2,1,3
11375,11040,3,1,7,11
11375,11101,34,42,43,119
11375,11102,33,52,43,128
11375,11103,26,52,62,140
11375,11104,23,29,39,91
11375,11105,26,34,50,110
11375,11106,53,62,48,163
11375,11109,0,4,6,10
11375,11201,13,14,29,56
11375,11203,53,85,37,175
11375,11204,46,40,32,118
11375,11205,9,19,18,46
11375,11206,59,78,58,195
11375,11207,159,194,81,434
11375,11208,130,239,99,468
11375,11209,18,19,41,78
11375,11210,40,74,43,157
11375,11211,43,44,56,143
11375,11212,125,168,49,342
11375,11213,37,32,36,105
11375,11214,77,92,47,216
11375,11215,18,18,31,67
11375,11216,35,52,29,116
11375,11217,10,11,18,39
11375,11218,34,27,30,91
11375,11219,19,37,41,97
11375,11220,14,34,27,75
11375,11221,61,74,49,184
11375,11222,14,42,26,82
11375,11223,58,101,46,205
11375,11224,44,72,35,151
11375,11225,36,38,22,96
11375,11226,66,115,63,244
11375,11228,17,21,21,59
11375,11229,72,95,74,241
11375,11230,53,87,46,186
11375,11231,7,11,19,37
11375,11232,6,15,9,30
11375,11233,60,101,41,202
11375,11234,67,89,113,269
11375,11235,76,111,64,251
11375,11236,92,157,113,362
11375,11237,47,39,33,119
11375,11238,19,25,28,72
11375,11239,28,19,14,61
11375,11354,67,92,59,218
11375,11355,149,131,71,351
11375,11356,24,31,30,85
11375,11357,43,42,78,163
11375,11358,50,50,57,157
11375,11359,1,0,1,2
11375,11360,21,25,32,78
11375,11361,33,32,66,131
11375,11362,28,19,33,80
11375,11363,5,8,9,22
11375,11364,45,38,66,149
11375,11365,83,73,98,254
11375,11366,25,39,47,111
11375,11367,131,155,124,410
11375,11368,211,339,128,678
11375,11369,67,110,46,223
11375,11370,34,51,40,125
11375,11372,75,120,92,287
11375,11373,210,226,97,533
11375,11374,300,422,268,990
11375,11375,565,644,623,1832
11375,11377,94,174,113,381
11375,11378,56,79,82,217
11375,11379,87,107,125,319
11375,11385,135,226,197,558
11375,11411,22,48,65,135
11375,11412,73,99,82,254
11375,11413,64,107,85,256
11375,11414,23,34,58,115
11375,11415,59,84,81,224
11375,11416,55,89,32,176
11375,11417,62,88,65,215
11375,11418,72,132,93,297
11375,11419,100,178,72,350
11375,11420,93,133,64,290
11375,11421,73,100,88,261
11375,11422,42,63,74,179
11375,11423,62,98,74,234
11375,11426,13,12,39,64
11375,11427,25,55,64,144
11375,11428,34,73,45,152
11375,11429,56,72,59,187
11375,11430,1,2,0,3
11375,11432,146,152,124,422
11375,11433,78,74,58,210
11375,11434,110,120,114,344
11375,11435,152,176,158,486
11375,11436,36,55,43,134
11375,11451,0,1,0,1
11375,11691,74,96,46,216
11375,11692,13,27,21,61
11375,11693,22,26,14,62
11375,11694,8,15,38,61
11375,11697,1,4,6,11
11377,10001,2,7,14,23
11377,10002,26,44,29,99
11377,10003,14,9,12,35
11377,10004,2,4,5,11
11377,10005,1,2,4,7
11377,10006,1,1,1,3
11377,10007,0,2,6,8
11377,10009,15,14,16,45
11377,10010,4,6,9,19
11377,10011,9,15,12,36
11377,10012,3,11,8,22
11377,10013,5,8,12,25
11377,10014,10,5,12,27
11377,10016,11,14,21,46
11377,10017,5,2,6,13
11377,10018,4,2,8,14
11377,10019,12,11,16,39
11377,10021,2,6,9,17
11377,10022,4,6,16,26
11377,10023,7,13,18,38
11377,10024,5,11,15,31
11377,10025,17,33,34,84
11377,10026,13,17,17,47
11377,10027,18,27,28,73
11377,10028,8,9,15,32
11377,10029,27,36,44,107
11377,10030,20,14,9,43
11377,10031,23,28,17,68
11377,10032,21,14,22,57
11377,10033,10,7,7,24
11377,10034,14,11,18,43
11377,10035,17,26,14,57
11377,10036,10,12,17,39
11377,10037,8,16,5,29
11377,10038,7,0,5,12
11377,10039,19,14,14,47
11377,10040,8,20,13,41
11377,10044,6,4,4,14
11377,10065,4,15,11,30
11377,10069,1,1,3,5
11377,10075,1,1,9,11
11377,10119,0,0,1,1
11377,10128,11,8,16,35
11377,10162,1,0,1,2
11377,10280,0,1,2,3
11377,10301,8,9,18,35
11377,10302,6,7,4,17
11377,10303,8,9,8,25
11377,10304,3,11,12,26
11377,10305,5,12,19,36
11377,10306,12,9,25,46
11377,10307,3,0,3,6
11377,10308,8,10,5,23
11377,10309,8,6,9,23
11377,10310,3,4,7,14
11377,10312,12,12,23,47
11377,10314,11,13,35,59
11377,10451,19,30,20,69
11377,10452,30,32,38,100
11377,10453,38,47,32,117
11377,10454,12,32,18,62
11377,10455,19,26,25,70
11377,10456,42,47,32,121
11377,10457,41,54,40,135
11377,10458,32,36,11,79
11377,10459,30,32,13,75
11377,10460,33,38,30,101
11377,10461,21,32,28,81
11377,10462,41,35,35,111
11377,10463,16,21,20,57
11377,10464,3,3,2,8
11377,10465,23,22,38,83
11377,10466,23,21,22,66
11377,10467,35,43,25,103
11377,10468,12,30,26,68
11377,10469,22,30,33,85
11377,10470,4,7,5,16
11377,10471,6,5,11,22
11377,10472,11,39,31,81
11377,10473,25,29,25,79
11377,10474,11,10,7,28
11377,10475,17,18,19,54
11377,11001,3,6,2,11
11377,11004,11,6,12,29
11377,11040,1,1,1,3
11377,11101,24,39,36,99
11377,11102,30,38,40,108
11377,11103,32,51,59,142
11377,11104,44,78,48,170
11377,11105,36,41,61,138
11377,11106,33,48,40,121
11377,11109,0,1,3,4
11377,11201,23,20,30,73
11377,11203,59,55,51,165
11377,11204,3,17,15,35
11377,11205,16,31,24,71
11377,11206,34,52,35,121
11377,11207,65,75,56,196
11377,11208,66,95,70,231
11377,11209,7,13,41,61
11377,11210,21,37,28,86
11377,11211,32,33,35,100
11377,11212,58,38,43,139
11377,11213,27,28,35,90
11377,11214,9,18,25,52
11377,11215,20,20,22,62
11377,11216,24,28,39,91
11377,11217,6,18,20,44
11377,11218,17,19,22,58
11377,11219,11,23,9,43
11377,11220,28,34,36,98
11377,11221,43,52,39,134
11377,11222,29,24,48,101
11377,11223,11,13,17,41
11377,11224,6,10,15,31
11377,11225,22,36,31,89
11377,11226,51,61,47,159
11377,11228,7,7,21,35
11377,11229,6,9,21,36
11377,11230,19,26,22,67
11377,11231,13,17,25,55
11377,11232,16,12,11,39
11377,11233,38,66,34,138
11377,11234,49,50,89,188
11377,11235,6,9,26,41
11377,11236,68,67,76,211
11377,11237,16,27,33,76
11377,11238,21,20,34,75
11377,11239,6,9,3,18
11377,11354,46,35,53,134
11377,11355,87,78,58,223
11377,11356,18,28,24,70
11377,11357,34,43,91,168
11377,11358,25,46,36,107
11377,11359,1,2,0,3
11377,11360,8,21,44,73
11377,11361,18,23,56,97
11377,11362,17,22,22,61
11377,11363,2,6,11,19
11377,11364,18,24,44,86
11377,11365,22,55,44,121
11377,11366,8,17,11,36
11377,11367,20,31,33,84
11377,11368,108,166,94,368
11377,11369,46,105,50,201
11377,11370,51,73,53,177
11377,11371,0,0,1,1
11377,11372,86,120,95,301
11377,11373,135,192,92,419
11377,11374,24,39,57,120
11377,11375,32,41,73,146
11377,11377,318,492,239,1049
11377,11378,63,96,108,267
11377,11379,31,37,50,118
11377,11385,74,110,136,320
11377,11411,15,20,22,57
11377,11412,32,37,26,95
11377,11413,30,34,25,89
11377,11414,13,14,44,71
11377,11415,13,22,29,64
11377,11416,16,19,24,59
11377,11417,11,29,34,74
11377,11418,26,37,34,97
11377,11419,26,62,60,148
11377,11420,36,51,43,130
11377,11421,33,54,59,146
11377,11422,24,23,17,64
11377,11423,35,44,44,123
11377,11426,10,14,23,47
11377,11427,13,28,27,68
11377,11428,20,27,28,75
11377,11429,21,39,13,73
11377,11430,0,0,1,1
11377,11432,48,84,57,189
11377,11433,23,29,22,74
11377,11434,50,52,45,147
11377,11435,40,54,61,155
11377,11436,34,27,17,78
11377,11451,0,1,0,1
11377,11691,31,31,20,82
11377,11692,13,13,12,38
11377,11693,9,7,9,25
11377,11694,12,10,27,49
11377,11697,1,4,5,10
11378,10001,3,7,3,13
11378,10002,27,55,27,109
11378,10003,4,7,22,33
11378,10004,3,3,4,10
11378,10005,0,0,2,2
11378,10006,0,0,1,1
11378,10007,0,5,3,8
11378,10009,12,20,26,58
11378,10010,3,5,10,18
11378,10011,6,7,18,31
11378,10012,2,12,9,23
11378,10013,1,10,15,26
11378,10014,9,11,14,34
11378,10016,5,11,30,46
11378,10017,0,2,7,9
11378,10018,3,2,1,6
11378,10019,9,10,13,32
11378,10021,8,8,24,40
11378,10022,5,6,18,29
11378,10023,14,11,20,45
11378,10024,4,12,20,36
11378,10025,13,13,24,50
11378,10026,6,9,11,26
11378,10027,10,17,33,60
11378,10028,3,7,25,35
11378,10029,7,31,39,77
11378,10030,7,8,21,36
11378,10031,7,23,16,46
11378,10032,6,19,26,51
11378,10033,4,30,28,62
11378,10034,3,11,21,35
11378,10035,6,16,13,35
11378,10036,4,4,11,19
11378,10037,2,6,6,14
11378,10038,2,5,7,14
11378,10039,5,7,8,20
11378,10040,6,9,30,45
11378,10044,2,1,5,8
11378,10065,5,7,17,29
11378,10069,0,3,1,4
11378,10075,3,5,11,19
11378,10128,10,16,20,46
11378,10162,0,0,2,2
11378,10280,1,0,7,8
11378,10282,0,1,1,2
11378,10301,8,10,22,40
11378,10302,4,11,12,27
11378,10303,5,11,12,28
11378,10304,10,13,25,48
11378,10305,7,5,21,33
11378,10306,6,18,44,68
11378,10307,1,1,10,12
11378,10308,3,4,21,28
11378,10309,6,13,31,50
11378,10310,2,8,9,19
11378,10312,6,11,49,66
11378,10314,8,11,45,64
11378,10451,12,15,33,60
11378,10452,21,27,40,88
11378,10453,13,45,48,106
11378,10454,4,18,17,39
11378,10455,4,16,29,49
11378,10456,25,45,60,130
11378,10457,14,40,38,92
11378,10458,8,25,31,64
11378,10459,17,42,21,80
11378,10460,13,28,33,74
11378,10461,7,16,37,60
11378,10462,5,30,49,84
11378,10463,7,14,44,65
11378,10464,0,1,3,4
11378,10465,15,16,45,76
11378,10466,14,11,35,60
11378,10467,16,46,67,129
11378,10468,7,30,33,70
11378,10469,7,15,35,57
11378,10470,5,2,7,14
11378,10471,0,4,16,20
11378,10472,9,37,37,83
11378,10473,12,21,49,82
11378,10474,5,6,7,18
11378,10475,7,9,29,45
11378,11001,0,1,5,6
11378,11004,7,9,13,29
11378,11005,0,2,5,7
11378,11040,1,0,3,4
11378,11101,13,41,24,78
11378,11102,11,26,48,85
11378,11103,13,32,62,107
11378,11104,13,32,36,81
11378,11105,12,30,66,108
11378,11106,23,22,49,94
11378,11109,1,2,4,7
11378,11201,11,36,25,72
11378,11203,21,61,80,162
11378,11204,13,25,27,65
11378,11205,18,37,39,94
11378,11206,76,124,102,302
11378,11207,41,96,102,239
11378,11208,48,108,117,273
11378,11209,8,24,52,84
11378,11210,17,46,67,130
11378,11211,42,86,85,213
11378,11212,40,75,81,196
11378,11213,23,51,48,122
11378,11214,8,39,46,93
11378,11215,20,23,43,86
11378,11216,20,35,36,91
11378,11217,9,18,31,58
11378,11218,14,24,43,81
11378,11219,18,32,26,76
11378,11220,31,31,42,104
11378,11221,34,97,110,241
11378,11222,20,44,102,166
11378,11223,16,17,51,84
11378,11224,8,16,26,50
11378,11225,13,22,35,70
11378,11226,19,52,73,144
11378,11228,11,17,21,49
11378,11229,23,18,40,81
11378,11230,16,26,50,92
11378,11231,5,11,25,41
11378,11232,5,24,15,44
11378,11233,19,61,72,152
11378,11234,39,66,94,199
11378,11235,11,20,47,78
11378,11236,35,88,117,240
11378,11237,31,91,98,220
11378,11238,12,26,43,81
11378,11239,7,11,14,32
11378,11354,18,61,77,156
11378,11355,50,118,74,242
11378,11356,15,25,40,80
11378,11357,17,50,119,186
11378,11358,21,36,72,129
11378,11359,0,1,0,1
11378,11360,5,8,37,50
11378,11361,5,32,49,86
11378,11362,3,14,28,45
11378,11363,1,5,21,27
11378,11364,14,29,48,91
11378,11365,14,34,64,112
11378,11366,6,13,19,38
11378,11367,24,42,36,102
11378,11368,130,218,205,553
11378,11369,24,56,64,144
11378,11370,20,39,47,106
11378,11371,1,2,3,6
11378,11372,50,57,93,200
11378,11373,113,172,128,413
11378,11374,23,27,57,107
11378,11375,20,37,94,151
11378,11377,86,170,157,413
11378,11378,265,428,421,1114
11378,11379,84,113,198,395
11378,11385,162,321,400,883
11378,11411,8,23,18,49
11378,11412,8,39,47,94
11378,11413,12,48,61,121
11378,11414,13,26,79,118
11378,11415,2,17,25,44
11378,11416,10,32,62,104
11378,11417,9,38,63,110
11378,11418,13,39,59,111
11378,11419,21,60,91,172
11378,11420,15,55,87,157
11378,11421,30,48,102,180
11378,11422,15,25,47,87
11378,11423,12,35,31,78
11378,11426,5,9,18,32
11378,11427,5,17,27,49
11378,11428,7,19,37,63
11378,11429,9,23,41,73
11378,11430,0,0,1,1
11378,11432,20,50,76,146
11378,11433,11,38,32,81
11378,11434,28,51,80,159
11378,11435,16,36,49,101
11378,11436,11,22,14,47
11378,11451,0,0,1,1
11378,11691,14,30,33,77
11378,11692,4,14,12,30
11378,11693,4,13,12,29
11378,11694,2,11,29,42
11378,11697,2,2,9,13
11379,10001,1,0,3,4
11379,10002,5,6,6,17
11379,10003,0,4,7,11
11379,10004,0,0,5,5
11379,10005,0,0,2,2
11379,10006,0,0,1,1
11379,10007,1,0,1,2
11379,10009,1,3,10,14
11379,10010,0,3,2,5
11379,10011,0,3,3,6
11379,10012,0,1,1,2
11379,10013,1,5,5,11
11379,10014,4,2,6,12
11379,10016,0,1,3,4
11379,10017,1,0,1,2
11379,10018,0,0,1,1
11379,10019,0,1,1,2
11379,10021,1,1,6,8
11379,10022,0,0,3,3
11379,10023,0,1,1,2
11379,10024,0,0,1,1
11379,10025,0,2,7,9
11379,10026,1,2,5,8
11379,10027,1,2,4,7
11379,10028,3,5,0,8
11379,10029,3,6,9,18
11379,10030,0,0,3,3
11379,10031,0,3,10,13
11379,10032,0,1,5,6
11379,10033,2,2,3,7
11379,10034,0,1,0,1
11379,10035,1,1,4,6
11379,10036,0,0,2,2
11379,10037,0,1,2,3
11379,10038,1,1,4,6
11379,10040,0,4,9,13
11379,10044,0,0,2,2
11379,10065,1,1,2,4
11379,10075,1,0,0,1
11379,10128,4,2,7,13
11379,10280,0,1,1,2
11379,10282,0,0,1,1
11379,10301,5,0,5,10
11379,10302,2,2,3,7
11379,10303,0,3,1,4
11379,10304,2,0,7,9
11379,10305,1,4,9,14
11379,10306,4,3,15,22
11379,10307,0,0,2,2
11379,10308,1,2,7,10
11379,10309,2,0,13,15
11379,10310,3,3,2,8
11379,10312,0,4,6,10
11379,10314,2,6,14,22
11379,10451,3,3,4,10
11379,10452,1,4,4,9
11379,10453,3,3,2,8
11379,10454,0,3,1,4
11379,10455,0,4,2,6
11379,10456,6,1,3,10
11379,10457,2,8,3,13
11379,10458,3,8,3,14
11379,10459,1,3,2,6
11379,10460,3,6,10,19
11379,10461,2,3,8,13
11379,10462,1,6,12,19
11379,10463,4,5,5,14
11379,10465,0,4,4,8
11379,10466,7,6,11,24
11379,10467,7,12,9,28
11379,10468,7,5,7,19
11379,10469,4,2,8,14
11379,10470,0,1,3,4
11379,10471,2,0,1,3
11379,10472,2,5,4,11
11379,10473,0,2,3,5
11379,10474,0,2,0,2
11379,10475,2,1,5,8
11379,11001,1,3,2,6
11379,11004,2,2,3,7
11379,11040,0,1,0,1
11379,11101,8,12,7,27
11379,11102,6,7,22,35
11379,11103,4,14,15,33
11379,11104,6,10,9,25
11379,11105,9,14,9,32
11379,11106,11,7,20,38
11379,11109,0,0,1,1
11379,11201,1,6,11,18
11379,11203,8,22,19,49
11379,11204,3,5,4,12
11379,11205,4,4,8,16
11379,11206,24,38,14,76
11379,11207,15,34,30,79
11379,11208,20,35,37,92
11379,11209,2,5,6,13
11379,11210,5,11,12,28
11379,11211,6,17,14,37
11379,11212,19,22,21,62
11379,11213,3,11,11,25
11379,11214,4,1,11,16
11379,11215,2,7,16,25
11379,11216,8,12,23,43
11379,11217,1,3,8,12
11379,11218,0,3,3,6
11379,11219,2,6,8,16
11379,11220,4,5,7,16
11379,11221,15,35,13,63
11379,11222,6,14,16,36
11379,11223,5,6,3,14
11379,11224,1,5,6,12
11379,11225,9,14,11,34
11379,11226,8,23,21,52
11379,11228,0,6,4,10
11379,11229,1,7,8,16
11379,11230,1,5,7,13
11379,11231,1,3,4,8
11379,11232,0,0,3,3
11379,11233,11,18,20,49
11379,11234,7,28,30,65
11379,11235,1,5,6,12
11379,11236,21,30,29,80
11379,11237,12,25,9,46
11379,11238,4,8,12,24
11379,11239,0,4,3,7
11379,11354,10,15,14,39
11379,11355,13,18,14,45
11379,11356,8,4,6,18
11379,11357,7,18,29,54
11379,11358,7,17,10,34
11379,11359,0,0,1,1
11379,11360,5,1,6,12
11379,11361,4,3,7,14
11379,11362,0,8,5,13
11379,11363,3,5,4,12
11379,11364,3,5,15,23
11379,11365,8,11,14,33
11379,11366,7,6,8,21
11379,11367,9,17,20,46
11379,11368,29,43,23,95
11379,11369,7,22,11,40
11379,11370,9,3,10,22
11379,11371,0,2,1,3
11379,11372,11,20,15,46
11379,11373,33,44,29,106
11379,11374,18,22,25,65
11379,11375,14,20,48,82
11379,11377,18,24,36,78
11379,11378,41,66,46,153
11379,11379,157,209,180,546
11379,11385,99,165,104,368
11379,11411,5,10,12,27
11379,11412,3,20,23,46
11379,11413,9,14,23,46
11379,11414,15,10,19,44
11379,11415,3,6,13,22
11379,11416,6,12,11,29
11379,11417,6,24,14,44
11379,11418,16,17,18,51
11379,11419,4,29,13,46
11379,11420,7,14,24,45
11379,11421,24,27,24,75
11379,11422,3,6,14,23
11379,11423,8,9,11,28
11379,11426,5,3,6,14
11379,11427,6,8,9,23
11379,11428,2,10,9,21
11379,11429,4,5,9,18
11379,11430,1,0,0,1
11379,11432,14,23,21,58
11379,11433,12,9,6,27
11379,11434,10,20,34,64
11379,11435,11,31,27,69
11379,11436,3,12,9,24
11379,11691,12,4,8,24
11379,11692,4,10,11,25
11379,11693,1,7,6,14
11379,11694,4,10,15,29
11379,11697,2,2,5,9
11385,10001,1,2,7,10
11385,10002,17,28,29,74
11385,10003,8,14,18,40
11385,10004,2,1,6,9
11385,10005,1,1,4,6
11385,10006,0,2,1,3
11385,10007,0,0,4,4
11385,10009,5,21,19,45
11385,10010,1,3,11,15
11385,10011,5,6,13,24
11385,10012,5,9,11,25
11385,10013,8,4,12,24
11385,10014,7,7,13,27
11385,10016,4,7,15,26
11385,10017,0,2,7,9
11385,10018,0,0,2,2
11385,10019,7,2,8,17
11385,10021,1,3,17,21
11385,10022,3,2,9,14
11385,10023,3,3,6,12
11385,10024,5,1,5,11
11385,10025,11,10,12,33
11385,10026,2,9,12,23
11385,10027,7,15,20,42
11385,10028,3,3,11,17
11385,10029,24,17,25,66
11385,10030,4,4,9,17
11385,10031,10,15,21,46
11385,10032,2,13,7,22
11385,10033,8,10,17,35
11385,10034,3,15,8,26
11385,10035,5,8,14,27
11385,10036,3,2,6,11
11385,10037,3,6,2,11
11385,10038,3,10,5,18
11385,10039,5,5,3,13
11385,10040,9,11,10,30
11385,10044,3,4,4,11
11385,10065,1,2,16,19
11385,10069,0,0,1,1
11385,10075,2,5,6,13
11385,10128,3,9,12,24
11385,10162,0,0,1,1
11385,10199,0,0,1,1
11385,10280,0,0,9,9
11385,10282,0,1,1,2
11385,10301,7,16,21,44
11385,10302,1,6,10,17
11385,10303,6,11,13,30
11385,10304,5,8,18,31
11385,10305,5,12,24,41
11385,10306,5,12,43,60
11385,10307,6,4,3,13
11385,10308,4,4,28,36
11385,10309,9,7,21,37
11385,10310,4,4,14,22
11385,10312,3,17,41,61
11385,10314,11,23,50,84
11385,10451,4,21,8,33
11385,10452,15,26,15,56
11385,10453,20,23,4,47
11385,10454,4,4,11,19
11385,10455,4,12,2,18
11385,10456,11,26,16,53
11385,10457,17,23,10,50
11385,10458,12,15,17,44
11385,10459,10,20,12,42
11385,10460,11,12,11,34
11385,10461,10,12,17,39
11385,10462,12,21,24,57
11385,10463,6,15,31,52
11385,10464,1,3,2,6
11385,10465,4,7,16,27
11385,10466,9,14,24,47
11385,10467,8,19,31,58
11385,10468,11,12,22,45
11385,10469,7,8,31,46
11385,10470,9,4,7,20
11385,10471,3,3,10,16
11385,10472,4,31,23,58
11385,10473,11,31,17,59
11385,10474,1,2,2,5
11385,10475,5,12,18,35
11385,11001,10,0,7,17
11385,11003,0,0,1,1
11385,11004,4,15,11,30
11385,11005,1,0,1,2
11385,11040,0,2,2,4
11385,11101,23,22,26,71
11385,11102,11,19,24,54
11385,11103,22,25,30,77
11385,11104,13,17,26,56
11385,11105,19,21,32,72
11385,11106,17,21,28,66
11385,11109,2,1,2,5
11385,11201,16,26,37,79
11385,11203,42,70,61,173
11385,11204,6,15,30,51
11385,11205,16,39,24,79
11385,11206,68,84,62,214
11385,11207,83,122,107,312
11385,11208,92,165,90,347
11385,11209,14,28,31,73
11385,11210,24,33,37,94
11385,11211,37,54,62,153
11385,11212,44,66,65,175
11385,11213,24,47,50,121
11385,11214,15,20,25,60
11385,11215,10,18,49,77
11385,11216,29,34,47,110
11385,11217,13,15,29,57
11385,11218,8,9,28,45
11385,11219,11,17,25,53
11385,11220,18,31,36,85
11385,11221,75,101,68,244
11385,11222,24,43,54,121
11385,11223,15,20,33,68
11385,11224,8,16,15,39
11385,11225,17,30,48,95
11385,11226,27,40,44,111
11385,11228,10,10,23,43
11385,11229,18,18,38,74
11385,11230,4,17,30,51
11385,11231,13,12,19,44
11385,11232,2,10,5,17
11385,11233,49,55,62,166
11385,11234,43,82,106,231
11385,11235,8,16,21,45
11385,11236,61,91,91,243
11385,11237,97,132,55,284
11385,11238,20,21,43,84
11385,11239,8,11,16,35
11385,11354,22,40,41,103
11385,11355,66,70,39,175
11385,11356,20,20,14,54
11385,11357,21,33,50,104
11385,11358,16,25,34,75
11385,11359,1,2,1,4
11385,11360,14,11,19,44
11385,11361,13,13,26,52
11385,11362,5,14,15,34
11385,11363,3,1,4,8
11385,11364,17,22,31,70
11385,11365,16,33,29,78
11385,11366,12,15,18,45
11385,11367,22,34,45,101
11385,11368,69,92,58,219
11385,11369,30,40,26,96
11385,11370,15,34,30,79
11385,11371,1,1,2,4
11385,11372,15,61,47,123
11385,11373,76,84,51,211
11385,11374,30,28,67,125
11385,11375,36,55,89,180
11385,11377,48,83,73,204
11385,11378,69,158,90,317
11385,11379,109,151,174,434
11385,11385,694,828,514,2036
11385,11411,19,17,19,55
11385,11412,25,24,31,80
11385,11413,24,38,60,122
11385,11414,29,30,78,137
11385,11415,10,17,27,54
11385,11416,27,52,39,118
11385,11417,46,40,44,130
11385,11418,44,53,47,144
11385,11419,31,42,47,120
11385,11420,41,50,49,140
11385,11421,61,71,70,202
11385,11422,15,27,25,67
11385,11423,14,29,36,79
11385,11426,14,17,19,50
11385,11427,8,24,24,56
11385,11428,13,23,35,71
11385,11429,16,15,36,67
11385,11430,1,1,0,2
11385,11432,29,65,53,147
11385,11433,22,35,32,89
11385,11434,28,44,54,126
11385,11435,41,62,35,138
11385,11436,6,20,17,43
11385,11451,0,0,1,1
11385,11691,21,25,41,87
11385,11692,10,22,13,45
11385,11693,13,10,21,44
11385,11694,9,22,27,58
11385,11697,4,6,10,20
11411,10002,0,1,1,2
11411,10003,0,1,1,2
11411,10009,1,0,2,3
11411,10012,0,2,1,3
11411,10019,0,1,1,2
11411,10021,1,0,1,2
11411,10024,0,0,2,2
11411,10025,1,3,1,5
11411,10026,1,5,1,7
11411,10027,0,1,1,2
11411,10029,2,0,0,2
11411,10030,2,4,1,7
11411,10031,1,0,1,2
11411,10032,1,2,1,4
11411,10034,1,2,1,4
11411,10035,1,0,0,1
11411,10036,0,0,1,1
11411,10037,0,1,1,2
11411,10038,0,0,1,1
11411,10040,1,0,0,1
11411,10044,0,0,1,1
11411,10128,0,0,1,1
11411,10301,0,0,1,1
11411,10302,0,0,1,1
11411,10305,0,0,3,3
11411,10306,3,2,1,6
11411,10308,0,0,1,1
11411,10309,0,0,1,1
11411,10310,0,0,1,1
11411,10312,0,1,0,1
11411,10314,0,0,1,1
11411,10451,2,1,1,4
11411,10453,2,1,1,4
11411,10456,2,2,1,5
11411,10457,1,2,0,3
11411,10458,0,0,3,3
11411,10460,0,1,0,1
11411,10461,1,2,5,8
11411,10462,1,3,3,7
11411,10463,1,0,1,2
11411,10465,2,3,0,5
11411,10466,3,1,1,5
11411,10467,0,3,0,3
11411,10468,0,3,0,3
11411,10469,1,0,1,2
11411,10471,0,0,1,1
11411,10472,1,2,1,4
11411,10473,2,3,2,7
11411,10474,1,0,0,1
11411,10475,3,1,6,10
11411,11004,2,2,3,7
11411,11005,1,2,0,3
11411,11101,0,2,2,4
11411,11102,1,0,1,2
11411,11103,1,1,2,4
11411,11104,2,2,1,5
11411,11105,0,0,1,1
11411,11106,3,0,2,5
11411,11109,1,1,0,2
11411,11201,1,0,0,1
11411,11203,6,6,4,16
11411,11204,1,0,0,1
11411,11205,1,0,0,1
11411,11206,2,1,2,5
11411,11207,16,11,7,34
11411,11208,6,5,1,12
11411,11209,1,1,2,4
11411,11210,1,5,3,9
11411,11211,0,7,1,8
11411,11212,10,6,5,21
11411,11213,1,2,3,6
11411,11214,0,1,0,1
11411,11215,1,0,0,1
11411,11216,0,1,1,2
11411,11217,0,1,1,2
11411,11218,1,0,4,5
11411,11219,1,0,2,3
11411,11220,1,0,1,2
11411,11221,3,6,1,10
11411,11222,0,1,0,1
11411,11223,1,0,1,2
11411,11224,1,1,0,2
11411,11225,4,4,3,11
11411,11226,7,14,2,23
11411,11229,1,0,5,6
11411,11230,3,5,0,8
11411,11231,0,0,1,1
11411,11232,1,1,0,2
11411,11233,7,2,3,12
11411,11234,5,9,12,26
11411,11235,0,1,4,5
11411,11236,9,8,6,23
11411,11237,1,4,1,6
11411,11238,3,2,4,9
11411,11239,0,1,1,2
11411,11354,1,5,3,9
11411,11355,11,13,4,28
11411,11356,1,1,2,4
11411,11357,1,2,5,8
11411,11358,3,6,3,12
11411,11360,1,1,1,3
11411,11361,0,3,3,6
11411,11362,1,2,0,3
11411,11363,0,1,4,5
11411,11364,2,5,4,11
11411,11365,2,2,3,7
11411,11366,2,0,0,2
11411,11367,0,3,2,5
11411,11368,7,6,2,15
11411,11369,1,2,1,4
11411,11370,3,0,0,3
11411,11371,0,1,0,1
11411,11372,1,3,4,8
11411,11373,4,2,5,11
11411,11374,1,5,4,10
11411,11375,2,2,7,11
11411,11377,0,7,5,12
11411,11378,3,3,2,8
11411,11379,2,2,2,6
11411,11385,7,2,11,20
11411,11411,22,40,20,82
11411,11412,20,32,8,60
11411,11413,8,17,6,31
11411,11414,1,1,2,4
11411,11415,2,2,3,7
11411,11416,1,4,0,5
11411,11417,4,7,3,14
11411,11418,3,6,4,13
11411,11419,7,4,6,17
11411,11420,4,7,3,14
11411,11421,2,6,6,14
11411,11422,5,7,8,20
11411,11423,8,10,2,20
11411,11426,1,0,5,6
11411,11427,4,6,5,15
11411,11428,5,10,3,18
11411,11429,10,17,5,32
11411,11430,0,0,1,1
11411,11432,14,14,11,39
11411,11433,7,12,0,19
11411,11434,7,17,8,32
11411,11435,10,10,7,27
11411,11436,3,1,1,5
11411,11691,7,3,4,14
11411,11692,0,3,0,3
11411,11693,0,0,1,1
11411,11694,1,4,5,10
11411,11697,1,0,0,1
11412,10002,3,0,1,4
11412,10003,0,1,0,1
11412,10004,0,1,0,1
11412,10009,0,1,1,2
11412,10011,0,0,1,1
11412,10012,0,0,2,2
11412,10013,1,0,0,1
11412,10014,0,1,1,2
11412,10016,0,1,2,3
11412,10017,1,0,0,1
11412,10019,0,1,0,1
11412,10022,0,0,1,1
11412,10023,1,1,0,2
11412,10025,1,2,2,5
11412,10026,1,3,0,4
11412,10027,2,2,3,7
11412,10028,0,1,1,2
11412,10029,4,2,1,7
11412,10030,0,0,3,3
11412,10031,0,1,2,3
11412,10032,0,0,2,2
11412,10033,1,0,2,3
11412,10034,0,1,1,2
11412,10035,2,4,0,6
11412,10036,0,0,1,1
11412,10037,0,0,2,2
11412,10038,0,1,0,1
11412,10039,0,1,1,2
11412,10040,0,1,1,2
11412,10128,0,1,0,1
11412,10301,0,2,3,5
11412,10302,0,0,1,1
11412,10303,0,0,1,1
11412,10304,1,3,0,4
11412,10305,0,1,3,4
11412,10306,0,0,2,2
11412,10307,0,0,1,1
11412,10308,0,0,5,5
11412,10309,0,0,4,4
11412,10310,0,1,2,3
11412,10312,1,0,10,11
11412,10314,1,3,4,8
11412,10451,0,0,3,3
11412,10452,3,5,2,10
11412,10453,1,7,4,12
11412,10454,0,0,1,1
11412,10455,2,0,3,5
11412,10456,2,4,7,13
11412,10457,2,0,2,4
11412,10458,1,2,0,3
11412,10459,0,1,1,2
11412,10460,2,3,0,5
11412,10461,0,2,2,4
11412,10462,1,5,3,9
11412,10463,1,0,8,9
11412,10464,0,0,1,1
11412,10465,3,0,3,6
11412,10466,1,1,3,5
11412,10467,3,5,3,11
11412,10468,1,5,2,8
11412,10469,2,2,3,7
11412,10470,0,1,0,1
11412,10471,2,0,0,2
11412,10472,0,3,3,6
11412,10473,2,3,0,5
11412,10475,4,2,5,11
11412,11001,1,0,0,1
11412,11004,1,4,3,8
11412,11005,1,0,0,1
11412,11040,0,1,0,1
11412,11101,0,3,4,7
11412,11102,1,1,2,4
11412,11103,0,3,0,3
11412,11104,1,1,2,4
11412,11105,0,3,0,3
11412,11106,0,2,0,2
11412,11201,0,1,2,3
11412,11203,2,6,8,16
11412,11204,2,0,2,4
11412,11205,1,4,4,9
11412,11206,2,3,3,8
11412,11207,12,19,13,44
11412,11208,11,10,19,40
11412,11209,0,1,3,4
11412,11210,1,2,1,4
11412,11211,0,2,1,3
11412,11212,5,15,6,26
11412,11213,4,6,2,12
11412,11214,2,1,3,6
11412,11215,0,0,2,2
11412,11216,3,10,2,15
11412,11217,1,2,2,5
11412,11218,1,1,1,3
11412,11219,2,3,9,14
11412,11220,9,5,3,17
11412,11221,5,5,4,14
11412,11222,0,1,0,1
11412,11223,1,2,3,6
11412,11224,0,0,2,2
11412,11225,3,2,3,8
11412,11226,3,4,4,11
11412,11228,0,1,1,2
11412,11229,1,1,3,5
11412,11230,3,3,4,10
11412,11231,0,0,1,1
11412,11232,2,0,0,2
11412,11233,5,6,1,12
11412,11234,1,7,7,15
11412,11235,1,1,3,5
11412,11236,5,12,11,28
11412,11237,1,3,0,4
11412,11238,3,7,3,13
11412,11239,0,3,2,5
11412,11354,4,7,2,13
11412,11355,5,7,6,18
11412,11356,1,6,3,10
11412,11357,3,5,6,14
11412,11358,4,9,9,22
11412,11359,0,2,1,3
11412,11360,2,2,0,4
11412,11361,2,7,5,14
11412,11362,0,2,4,6
11412,11364,4,7,6,17
11412,11365,2,9,12,23
11412,11366,1,2,4,7
11412,11367,3,5,5,13
11412,11368,3,3,13,19
11412,11369,0,2,1,3
11412,11370,1,0,0,1
11412,11372,2,5,1,8
11412,11373,6,9,6,21
11412,11374,2,3,4,9
11412,11375,4,7,11,22
11412,11377,2,6,3,11
11412,11378,1,3,2,6
11412,11379,3,4,4,11
11412,11385,7,10,10,27
11412,11411,11,12,15,38
11412,11412,50,75,29,154
11412,11413,16,18,18,52
11412,11414,4,3,7,14
11412,11415,1,1,6,8
11412,11416,4,7,4,15
11412,11417,3,7,5,15
11412,11418,3,9,8,20
11412,11419,7,9,11,27
11412,11420,1,10,9,20
11412,11421,9,7,4,20
11412,11422,9,17,12,38
11412,11423,14,19,10,43
11412,11426,3,3,3,9
11412,11427,6,11,4,21
11412,11428,6,7,6,19
11412,11429,8,17,13,38
11412,11430,0,1,0,1
11412,11432,20,17,15,52
11412,11433,8,30,13,51
11412,11434,24,48,29,101
11412,11435,8,7,5,20
11412,11436,3,10,9,22
11412,11691,5,10,12,27
11412,11692,4,5,1,10
11412,11693,0,2,1,3
11412,11694,0,1,9,10
11413,10001,0,0,2,2
11413,10002,6,7,4,17
11413,10003,2,0,5,7
11413,10005,0,0,1,1
11413,10007,0,1,0,1
11413,10009,5,5,2,12
11413,10010,0,0,2,2
11413,10011,3,5,4,12
11413,10012,1,0,2,3
11413,10013,1,1,4,6
11413,10014,0,2,0,2
11413,10016,0,0,4,4
11413,10017,0,0,1,1
11413,10019,1,1,4,6
11413,10021,0,0,1,1
11413,10022,1,0,2,3
11413,10023,0,0,6,6
11413,10024,1,1,7,9
11413,10025,1,6,10,17
11413,10026,5,5,6,16
11413,10027,7,7,9,23
11413,10028,0,1,3,4
11413,10029,4,24,10,38
11413,10030,3,4,4,11
11413,10031,2,7,4,13
11413,10032,2,10,2,14
11413,10033,1,6,3,10
11413,10034,1,4,3,8
11413,10035,0,5,8,13
11413,10036,2,0,4,6
11413,10037,1,3,3,7
11413,10038,2,2,2,6
11413,10039,2,5,3,10
11413,10040,1,3,1,5
11413,10065,1,1,2,4
11413,10075,0,0,2,2
11413,10128,0,2,4,6
11413,10280,0,0,1,1
11413,10282,0,0,2,2
11413,10301,1,4,4,9
11413,10302,0,1,2,3
11413,10303,1,4,3,8
11413,10304,3,4,2,9
11413,10305,2,0,10,12
11413,10306,1,1,5,7
11413,10307,0,2,3,5
11413,10308,1,1,5,7
11413,10309,1,0,7,8
11413,10310,3,3,3,9
11413,10312,0,2,11,13
11413,10314,8,6,23,37
11413,10451,3,13,2,18
11413,10452,4,15,4,23
11413,10453,4,20,3,27
11413,10454,4,8,9,21
11413,10455,2,10,6,18
11413,10456,8,17,11,36
11413,10457,5,18,4,27
11413,10458,5,12,8,25
11413,10459,7,11,8,26
11413,10460,1,7,7,15
11413,10461,3,3,7,13
11413,10462,10,15,11,36
11413,10463,1,3,5,9
11413,10464,0,0,1,1
11413,10465,5,4,7,16
11413,10466,4,13,18,35
11413,10467,5,21,12,38
11413,10468,1,12,8,21
11413,10469,4,16,16,36
11413,10470,0,2,1,3
11413,10471,0,2,1,3
11413,10472,7,15,13,35
11413,10473,3,13,12,28
11413,10474,3,5,0,8
11413,10475,5,7,6,18
11413,11001,0,1,2,3
11413,11004,5,6,7,18
11413,11005,3,0,1,4
11413,11040,0,1,1,2
11413,11101,4,14,9,27
11413,11102,5,12,8,25
11413,11103,1,7,3,11
11413,11104,3,5,10,18
11413,11105,3,5,7,15
11413,11106,9,14,4,27
11413,11109,0,0,5,5
11413,11201,2,11,6,19
11413,11203,15,42,25,82
11413,11204,3,4,18,25
11413,11205,4,6,9,19
11413,11206,9,25,20,54
11413,11207,30,111,41,182
11413,11208,31,173,47,251
11413,11209,3,4,8,15
11413,11210,10,41,18,69
11413,11211,3,9,6,18
11413,11212,29,116,29,174
11413,11213,13,39,18,70
11413,11214,1,16,25,42
11413,11215,0,7,10,17
11413,11216,11,21,11,43
11413,11217,3,8,0,11
11413,11218,4,10,7,21
11413,11219,1,4,7,12
11413,11220,4,9,9,22
11413,11221,15,38,17,70
11413,11222,0,5,4,9
11413,11223,5,11,19,35
11413,11224,3,16,8,27
11413,11225,2,36,10,48
11413,11226,17,55,24,96
11413,11228,0,5,7,12
11413,11229,5,17,27,49
11413,11230,4,15,15,34
11413,11231,0,1,2,3
11413,11232,1,2,3,6
11413,11233,16,49,22,87
11413,11234,24,63,55,142
11413,11235,4,6,15,25
11413,11236,25,104,55,184
11413,11237,3,15,11,29
11413,11238,4,21,8,33
11413,11239,1,17,7,25
11413,11354,9,27,22,58
11413,11355,24,31,40,95
11413,11356,3,5,9,17
11413,11357,4,12,23,39
11413,11358,7,15,27,49
11413,11359,0,0,1,1
11413,11360,1,5,10,16
11413,11361,5,17,16,38
11413,11362,3,3,17,23
11413,11363,0,2,1,3
11413,11364,5,16,28,49
11413,11365,7,37,39,83
11413,11366,0,3,3,6
11413,11367,7,12,15,34
11413,11368,21,77,34,132
11413,11369,4,28,7,39
11413,11370,2,15,6,23
11413,11371,0,0,1,1
11413,11372,4,17,15,36
11413,11373,13,37,30,80
11413,11374,4,7,28,39
11413,11375,8,18,53,79
11413,11377,10,28,20,58
11413,11378,2,13,26,41
11413,11379,7,11,22,40
11413,11385,18,37,40,95
11413,11411,24,59,33,116
11413,11412,45,138,59,242
11413,11413,102,141,100,343
11413,11414,12,18,25,55
11413,11415,4,11,15,30
11413,11416,13,51,23,87
11413,11417,11,39,26,76
11413,11418,8,45,31,84
11413,11419,23,122,53,198
11413,11420,22,141,62,225
11413,11421,11,43,40,94
11413,11422,34,104,39,177
11413,11423,18,65,28,111
11413,11426,4,12,7,23
11413,11427,12,30,36,78
11413,11428,12,29,26,67
11413,11429,21,89,19,129
11413,11430,0,1,1,2
11413,11432,34,94,47,175
11413,11433,17,96,34,147
11413,11434,66,212,77,355
11413,11435,27,117,49,193
11413,11436,9,57,27,93
11413,11691,17,72,58,147
11413,11692,12,18,14,44
11413,11693,5,29,6,40
11413,11694,6,9,24,39
11413,11697,0,3,4,7
11414,10001,0,0,1,1
11414,10002,0,1,1,2
11414,10003,3,0,3,6
11414,10009,2,1,4,7
11414,10010,0,1,2,3
11414,10011,0,1,5,6
11414,10012,1,0,1,2
11414,10013,4,1,1,6
11414,10016,1,0,1,2
11414,10017,0,0,1,1
11414,10018,0,1,0,1
11414,10019,1,0,1,2
11414,10021,0,2,0,2
11414,10022,1,2,0,3
11414,10023,0,0,1,1
11414,10025,0,0,2,2
11414,10026,0,0,2,2
11414,10027,1,0,3,4
11414,10028,1,0,0,1
11414,10029,2,9,3,14
11414,10030,0,0,1,1
11414,10031,0,0,2,2
11414,10032,0,2,2,4
11414,10033,0,0,1,1
11414,10034,1,1,2,4
11414,10036,0,0,4,4
11414,10038,0,0,2,2
11414,10039,0,0,1,1
11414,10040,0,2,0,2
11414,10044,1,0,0,1
11414,10065,0,0,2,2
11414,10075,0,0,2,2
11414,10128,1,0,1,2
11414,10301,2,3,4,9
11414,10302,0,3,2,5
11414,10303,0,3,3,6
11414,10304,0,1,3,4
11414,10305,1,2,1,4
11414,10306,2,3,2,7
11414,10307,1,0,4,5
11414,10308,1,1,1,3
11414,10309,3,2,6,11
11414,10310,0,1,1,2
11414,10312,2,0,9,11
11414,10314,0,3,6,9
11414,10451,0,1,1,2
11414,10452,1,2,4,7
11414,10453,1,0,2,3
11414,10454,4,0,1,5
11414,10455,3,1,1,5
11414,10456,1,4,4,9
11414,10457,2,0,1,3
11414,10458,1,2,1,4
11414,10459,1,0,0,1
11414,10460,3,2,1,6
11414,10461,1,2,1,4
11414,10462,3,2,2,7
11414,10463,0,2,4,6
11414,10465,0,2,6,8
11414,10466,3,5,3,11
11414,10467,0,4,2,6
11414,10468,1,7,1,9
11414,10469,1,4,4,9
11414,10470,0,3,0,3
11414,10471,1,3,1,5
11414,10472,1,1,4,6
11414,10473,3,2,1,6
11414,10474,1,0,1,2
11414,10475,0,0,2,2
11414,11001,3,1,0,4
11414,11004,2,6,1,9
11414,11040,0,1,1,2
11414,11101,4,3,1,8
11414,11102,0,2,0,2
11414,11103,0,5,2,7
11414,11104,0,3,6,9
11414,11105,1,4,2,7
11414,11106,2,7,2,11
11414,11201,4,3,2,9
11414,11203,3,11,8,22
11414,11204,2,5,6,13
11414,11205,6,0,2,8
11414,11206,8,10,7,25
11414,11207,22,22,9,53
11414,11208,23,43,10,76
11414,11209,7,6,8,21
11414,11210,3,4,6,13
11414,11211,6,7,9,22
11414,11212,11,11,10,32
11414,11213,6,4,3,13
11414,11214,5,9,7,21
11414,11215,3,5,5,13
11414,11216,2,6,10,18
11414,11217,6,3,0,9
11414,11218,2,6,2,10
11414,11219,3,0,5,8
11414,11220,9,12,0,21
11414,11221,10,18,7,35
11414,11222,4,5,7,16
11414,11223,7,9,6,22
11414,11224,1,4,2,7
11414,11225,2,3,5,10
11414,11226,11,13,10,34
11414,11228,4,4,5,13
11414,11229,9,17,10,36
11414,11230,9,12,4,25
11414,11231,1,3,3,7
11414,11232,0,2,0,2
11414,11233,12,14,9,35
11414,11234,13,16,16,45
11414,11235,10,5,8,23
11414,11236,5,10,12,27
11414,11237,9,14,11,34
11414,11238,0,4,2,6
11414,11239,1,0,1,2
11414,11354,6,6,2,14
11414,11355,10,14,4,28
11414,11356,4,1,3,8
11414,11357,2,3,5,10
11414,11358,5,4,7,16
11414,11360,1,4,3,8
11414,11361,3,4,5,12
11414,11362,0,1,6,7
11414,11363,0,1,1,2
11414,11364,10,12,12,34
11414,11365,5,8,4,17
11414,11366,1,0,2,3
11414,11367,5,3,3,11
11414,11368,7,23,8,38
11414,11369,1,2,2,5
11414,11370,1,2,3,6
11414,11372,2,5,1,8
11414,11373,14,14,10,38
11414,11374,9,8,6,23
11414,11375,5,5,17,27
11414,11377,9,10,15,34
11414,11378,13,12,4,29
11414,11379,8,12,11,31
11414,11385,35,32,21,88
11414,11411,3,4,3,10
11414,11412,2,9,9,20
11414,11413,7,8,5,20
11414,11414,244,183,126,553
11414,11415,4,1,8,13
11414,11416,24,40,4,68
11414,11417,74,69,10,153
11414,11418,12,26,15,53
11414,11419,17,21,8,46
11414,11420,26,29,10,65
11414,11421,19,20,12,51
11414,11422,1,9,4,14
11414,11423,8,6,3,17
11414,11426,3,4,0,7
11414,11427,1,2,7,10
11414,11428,3,1,4,8
11414,11429,4,3,6,13
11414,11432,8,7,10,25
11414,11433,4,10,11,25
11414,11434,9,8,10,27
11414,11435,7,5,8,20
11414,11436,1,6,2,9
11414,11691,20,12,6,38
11414,11692,11,8,1,20
11414,11693,24,14,5,43
11414,11694,12,16,10,38
11414,11697,2,1,4,7
11415,10001,0,1,2,3
11415,10002,4,7,7,18
11415,10003,3,4,8,15
11415,10004,1,0,1,2
11415,10005,0,1,0,1
11415,10006,0,1,0,1
11415,10009,6,6,4,16
11415,10010,0,0,2,2
11415,10011,1,0,4,5
11415,10012,0,0,1,1
11415,10013,0,0,1,1
11415,10014,2,3,0,5
11415,10016,0,3,3,6
11415,10017,0,1,0,1
11415,10019,1,1,2,4
11415,10021,0,1,5,6
11415,10022,0,1,2,3
11415,10023,1,1,6,8
11415,10024,1,2,3,6
11415,10025,4,4,7,15
11415,10026,3,3,7,13
11415,10027,3,6,9,18
11415,10028,0,1,3,4
11415,10029,6,8,11,25
11415,10030,1,8,2,11
11415,10031,2,5,10,17
11415,10032,7,9,6,22
11415,10033,7,10,9,26
11415,10034,1,4,4,9
11415,10035,3,4,9,16
11415,10036,2,1,3,6
11415,10037,1,0,1,2
11415,10039,3,1,2,6
11415,10040,5,6,1,12
11415,10044,0,1,2,3
11415,10065,0,3,2,5
11415,10069,0,0,2,2
11415,10128,1,1,4,6
11415,10280,0,1,1,2
11415,10301,0,3,4,7
11415,10302,1,3,5,9
11415,10303,1,3,3,7
11415,10304,0,2,2,4
11415,10305,2,1,7,10
11415,10306,3,6,9,18
11415,10307,0,2,5,7
11415,10308,1,1,3,5
11415,10309,0,0,6,6
11415,10310,0,5,7,12
11415,10312,0,4,15,19
11415,10314,0,6,18,24
11415,10451,7,12,5,24
11415,10452,10,16,6,32
11415,10453,12,20,10,42
11415,10454,3,12,2,17
11415,10455,5,9,5,19
11415,10456,18,14,10,42
11415,10457,17,10,8,35
11415,10458,9,13,9,31
11415,10459,6,9,2,17
11415,10460,5,13,9,27
11415,10461,3,9,13,25
11415,10462,10,22,10,42
11415,10463,9,14,8,31
11415,10464,1,0,3,4
11415,10465,4,3,12,19
11415,10466,9,14,8,31
11415,10467,22,20,12,54
11415,10468,5,13,13,31
11415,10469,7,9,9,25
11415,10470,2,3,2,7
11415,10471,1,2,2,5
11415,10472,4,19,12,35
11415,10473,9,19,6,34
11415,10474,2,3,1,6
11415,10475,5,9,9,23
11415,11001,1,0,1,2
11415,11004,2,3,4,9
11415,11005,1,0,0,1
11415,11040,0,1,0,1
11415,11101,3,11,5,19
11415,11102,5,7,5,17
11415,11103,6,9,15,30
11415,11104,5,6,10,21
11415,11105,6,18,10,34
11415,11106,3,12,14,29
11415,11109,0,1,1,2
11415,11201,1,4,9,14
11415,11203,10,25,16,51
11415,11204,4,4,6,14
11415,11205,5,4,7,16
11415,11206,4,15,10,29
11415,11207,27,38,39,104
11415,11208,26,60,32,118
11415,11209,0,1,6,7
11415,11210,6,16,15,37
11415,11211,4,10,11,25
11415,11212,19,32,22,73
11415,11213,8,7,11,26
11415,11214,5,4,8,17
11415,11215,1,5,16,22
11415,11216,10,9,10,29
11415,11217,3,4,9,16
11415,11218,4,4,8,16
11415,11219,1,8,12,21
11415,11220,8,6,7,21
11415,11221,9,20,15,44
11415,11222,2,4,3,9
11415,11223,5,4,12,21
11415,11224,3,8,4,15
11415,11225,5,19,5,29
11415,11226,6,27,10,43
11415,11228,1,0,10,11
11415,11229,4,14,12,30
11415,11230,4,12,9,25
11415,11231,1,1,7,9
11415,11232,0,2,2,4
11415,11233,8,22,20,50
11415,11234,15,15,46,76
11415,11235,2,5,13,20
11415,11236,21,29,30,80
11415,11237,6,6,15,27
11415,11238,2,4,10,16
11415,11239,2,2,3,7
11415,11354,7,10,10,27
11415,11355,20,29,19,68
11415,11356,3,6,8,17
11415,11357,7,6,8,21
11415,11358,6,14,17,37
11415,11359,0,1,0,1
11415,11360,1,4,5,10
11415,11361,9,7,17,33
11415,11362,5,4,6,15
11415,11363,5,0,2,7
11415,11364,6,7,18,31
11415,11365,5,29,32,66
11415,11366,1,9,4,14
11415,11367,15,31,30,76
11415,11368,37,69,18,124
11415,11369,19,37,14,70
11415,11370,6,11,6,23
11415,11371,0,0,1,1
11415,11372,18,29,20,67
11415,11373,20,44,20,84
11415,11374,17,23,24,64
11415,11375,35,38,57,130
11415,11377,26,60,24,110
11415,11378,8,8,16,32
11415,11379,6,16,26,48
11415,11385,36,36,44,116
11415,11411,11,10,15,36
11415,11412,15,33,23,71
11415,11413,12,15,19,46
11415,11414,2,6,19,27
11415,11415,46,98,57,201
11415,11416,11,26,15,52
11415,11417,13,42,11,66
11415,11418,24,66,31,121
11415,11419,25,97,40,162
11415,11420,18,79,22,119
11415,11421,17,24,13,54
11415,11422,17,18,15,50
11415,11423,7,30,13,50
11415,11426,3,6,8,17
11415,11427,12,12,15,39
11415,11428,8,10,6,24
11415,11429,1,20,7,28
11415,11432,27,68,33,128
11415,11433,19,49,16,84
11415,11434,34,58,28,120
11415,11435,28,52,33,113
11415,11436,15,24,21,60
11415,11691,12,22,10,44
11415,11692,2,10,8,20
11415,11693,0,6,11,17
11415,11694,1,8,10,19
11415,11697,0,0,2,2
11416,10001,1,2,2,5
11416,10002,5,10,4,19
11416,10003,1,2,5,8
11416,10005,0,0,1,1
11416,10007,0,0,2,2
11416,10009,1,3,1,5
11416,10011,1,0,4,5
11416,10012,2,0,2,4
11416,10013,0,0,2,2
11416,10014,1,0,2,3
11416,10016,1,1,2,4
11416,10017,0,1,2,3
11416,10018,0,1,0,1
11416,10019,1,2,0,3
11416,10021,0,0,2,2
11416,10022,0,0,2,2
11416,10023,0,2,2,4
11416,10024,3,2,1,6
11416,10025,3,5,5,13
11416,10026,1,4,2,7
11416,10027,1,5,5,11
11416,10028,0,0,1,1
11416,10029,2,4,3,9
11416,10030,2,1,3,6
11416,10031,2,4,2,8
11416,10032,3,12,3,18
11416,10033,2,4,5,11
11416,10034,0,4,2,6
11416,10035,1,4,2,7
11416,10036,0,0,1,1
11416,10037,2,0,2,4
11416,10038,0,2,1,3
11416,10039,1,2,3,6
11416,10040,2,5,4,11
11416,10044,1,2,0,3
11416,10065,0,1,0,1
11416,10069,0,1,0,1
11416,10075,0,0,1,1
11416,10128,1,1,1,3
11416,10282,0,0,1,1
11416,10301,2,4,7,13
11416,10302,0,2,4,6
11416,10303,0,0,2,2
11416,10304,2,2,8,12
11416,10305,1,1,7,9
11416,10306,2,3,16,21
11416,10307,0,3,5,8
11416,10308,0,2,16,18
11416,10309,2,1,15,18
11416,10310,1,1,9,11
11416,10312,3,2,33,38
11416,10314,0,7,23,30
11416,10451,12,23,6,41
11416,10452,10,20,13,43
11416,10453,4,26,11,41
11416,10454,9,22,7,38
11416,10455,5,23,7,35
11416,10456,20,34,19,73
11416,10457,10,26,15,51
11416,10458,6,29,12,47
11416,10459,5,24,5,34
11416,10460,13,21,16,50
11416,10461,4,12,19,35
11416,10462,9,27,25,61
11416,10463,2,15,6,23
11416,10464,1,0,1,2
11416,10465,4,5,15,24
11416,10466,6,6,17,29
11416,10467,10,20,12,42
11416,10468,7,19,14,40
11416,10469,6,17,12,35
11416,10470,0,1,4,5
11416,10471,0,3,0,3
11416,10472,24,30,25,79
11416,10473,9,32,26,67
11416,10474,1,2,2,5
11416,10475,4,9,9,22
11416,11001,0,1,0,1
11416,11004,3,3,1,7
11416,11040,0,0,1,1
11416,11101,1,7,1,9
11416,11102,8,5,5,18
11416,11103,4,4,6,14
11416,11104,4,9,4,17
11416,11105,4,7,3,14
11416,11106,1,6,6,13
11416,11201,2,1,5,8
11416,11203,19,24,42,85
11416,11204,1,2,3,6
11416,11205,1,7,1,9
11416,11206,13,48,21,82
11416,11207,24,99,42,165
11416,11208,74,163,45,282
11416,11209,4,8,4,16
11416,11210,6,26,22,54
11416,11211,8,19,11,38
11416,11212,11,33,15,59
11416,11213,9,20,12,41
11416,11214,0,4,7,11
11416,11215,0,1,4,5
11416,11216,6,12,12,30
11416,11217,5,4,3,12
11416,11218,1,4,9,14
11416,11219,1,2,7,10
11416,11220,4,2,7,13
11416,11221,14,16,32,62
11416,11222,3,5,8,16
11416,11223,7,3,6,16
11416,11224,2,6,5,13
11416,11225,5,11,4,20
11416,11226,12,37,23,72
11416,11228,0,1,2,3
11416,11229,1,4,12,17
11416,11230,6,3,7,16
11416,11231,2,1,1,4
11416,11232,0,1,4,5
11416,11233,6,20,10,36
11416,11234,22,25,34,81
11416,11235,6,7,7,20
11416,11236,16,51,56,123
11416,11237,10,27,7,44
11416,11238,5,10,8,23
11416,11239,5,7,6,18
11416,11354,3,8,8,19
11416,11355,16,19,8,43
11416,11356,5,8,8,21
11416,11357,3,8,20,31
11416,11358,7,15,7,29
11416,11360,2,8,2,12
11416,11361,7,17,13,37
11416,11362,2,11,5,18
11416,11363,0,1,1,2
11416,11364,4,9,12,25
11416,11365,8,12,50,70
11416,11366,4,5,8,17
11416,11367,6,10,21,37
11416,11368,20,50,17,87
11416,11369,8,21,9,38
11416,11370,6,10,17,33
11416,11372,13,16,11,40
11416,11373,14,21,15,50
11416,11374,8,9,23,40
11416,11375,6,16,12,34
11416,11377,9,25,17,51
11416,11378,5,12,22,39
11416,11379,5,25,30,60
11416,11385,23,75,57,155
11416,11411,7,10,18,35
11416,11412,20,39,29,88
11416,11413,10,30,29,69
11416,11414,33,56,72,161
11416,11415,8,9,7,24
11416,11416,75,169,49,293
11416,11417,56,145,45,246
11416,11418,15,70,39,124
11416,11419,47,119,60,226
11416,11420,35,103,61,199
11416,11421,39,126,45,210
11416,11422,6,14,29,49
11416,11423,16,34,18,68
11416,11426,0,4,6,10
11416,11427,3,5,16,24
11416,11428,6,22,19,47
11416,11429,7,24,17,48
11416,11430,0,2,0,2
11416,11432,9,36,18,63
11416,11433,12,31,28,71
11416,11434,23,58,49,130
11416,11435,12,39,45,96
11416,11436,7,24,15,46
11416,11691,8,20,17,45
11416,11692,4,13,7,24
11416,11693,2,5,15,22
11416,11694,1,6,13,20
11416,11697,1,1,2,4
11417,10001,0,0,2,2
11417,10002,2,2,6,10
11417,10003,2,0,4,6
11417,10004,1,0,0,1
11417,10005,0,0,2,2
11417,10007,0,0,1,1
11417,10009,0,1,11,12
11417,10010,0,1,3,4
11417,10011,0,1,2,3
11417,10013,1,1,0,2
11417,10014,0,0,1,1
11417,10016,0,0,1,1
11417,10019,2,0,7,9
11417,10021,0,0,3,3
11417,10022,0,0,1,1
11417,10023,0,0,5,5
11417,10024,1,0,1,2
11417,10025,1,1,3,5
11417,10026,0,2,3,5
11417,10027,1,1,5,7
11417,10028,0,0,4,4
11417,10029,2,3,2,7
11417,10030,2,3,2,7
11417,10031,1,4,3,8
11417,10032,3,3,5,11
11417,10033,3,2,5,10
11417,10034,2,1,2,5
11417,10035,1,1,1,3
11417,10037,0,2,4,6
11417,10038,0,0,1,1
11417,10039,0,0,2,2
11417,10040,1,1,5,7
11417,10065,1,0,1,2
11417,10128,0,0,2,2
11417,10280,0,1,0,1
11417,10301,2,1,9,12
11417,10302,1,0,2,3
11417,10303,3,2,2,7
11417,10304,0,4,5,9
11417,10305,2,4,3,9
11417,10306,3,2,12,17
11417,10307,0,0,3,3
11417,10308,1,2,7,10
11417,10309,2,1,3,6
11417,10310,0,1,0,1
11417,10312,3,1,17,21
11417,10314,5,4,9,18
11417,10451,1,1,3,5
11417,10452,2,3,5,10
11417,10453,6,8,6,20
11417,10454,1,1,3,5
11417,10455,2,3,2,7
11417,10456,3,3,8,14
11417,10457,4,1,3,8
11417,10458,3,4,3,10
11417,10459,3,1,3,7
11417,10460,2,5,7,14
11417,10461,0,5,9,14
11417,10462,7,1,12,20
11417,10463,1,1,4,6
11417,10464,0,1,0,1
11417,10465,1,0,5,6
11417,10466,2,3,5,10
11417,10467,5,5,5,15
11417,10468,0,3,3,6
11417,10469,1,3,8,12
11417,10470,0,0,1,1
11417,10471,0,1,3,4
11417,10472,5,1,7,13
11417,10473,1,2,9,12
11417,10474,0,0,1,1
11417,10475,1,3,3,7
11417,11001,3,3,3,9
11417,11004,2,8,6,16
11417,11005,0,2,0,2
11417,11101,3,3,3,9
11417,11102,1,2,4,7
11417,11103,4,0,4,8
11417,11104,0,9,8,17
11417,11105,4,4,4,12
11417,11106,1,3,3,7
11417,11201,2,1,6,9
11417,11203,4,29,17,50
11417,11204,4,5,5,14
11417,11205,0,4,6,10
11417,11206,6,8,10,24
11417,11207,11,35,22,68
11417,11208,33,45,29,107
11417,11209,5,4,13,22
11417,11210,6,5,19,30
11417,11211,7,22,14,43
11417,11212,13,18,17,48
11417,11213,10,10,13,33
11417,11214,8,3,9,20
11417,11215,3,4,10,17
11417,11216,3,7,18,28
11417,11217,1,5,7,13
11417,11218,2,3,6,11
11417,11219,5,6,2,13
11417,11220,10,5,12,27
11417,11221,7,13,15,35
11417,11222,3,5,5,13
11417,11223,2,5,5,12
11417,11224,2,3,6,11
11417,11225,3,5,5,13
11417,11226,6,9,15,30
11417,11228,1,3,5,9
11417,11229,5,5,15,25
11417,11230,2,7,11,20
11417,11231,0,1,2,3
11417,11232,2,1,3,6
11417,11233,9,9,18,36
11417,11234,13,29,46,88
11417,11235,3,3,10,16
11417,11236,15,25,32,72
11417,11237,4,8,4,16
11417,11238,1,7,12,20
11417,11239,5,6,7,18
11417,11354,4,11,4,19
11417,11355,21,23,13,57
11417,11356,6,6,8,20
11417,11357,3,5,20,28
11417,11358,9,7,8,24
11417,11360,1,1,2,4
11417,11361,3,8,13,24
11417,11362,6,3,4,13
11417,11363,0,0,1,1
11417,11364,5,8,10,23
11417,11365,10,10,13,33
11417,11366,1,0,2,3
11417,11367,7,5,17,29
11417,11368,22,20,21,63
11417,11369,5,4,17,26
11417,11370,4,2,5,11
11417,11371,0,1,0,1
11417,11372,4,9,17,30
11417,11373,10,14,18,42
11417,11374,5,5,15,25
11417,11375,5,10,25,40
11417,11377,9,12,16,37
11417,11378,5,7,5,17
11417,11379,6,7,16,29
11417,11385,16,26,27,69
11417,11411,5,4,11,20
11417,11412,10,10,16,36
11417,11413,13,15,14,42
11417,11414,30,38,40,108
11417,11415,4,10,11,25
11417,11416,38,54,12,104
11417,11417,100,102,45,247
11417,11418,14,12,9,35
11417,11419,22,30,25,77
11417,11420,15,47,28,90
11417,11421,20,27,19,66
11417,11422,4,6,11,21
11417,11423,5,9,14,28
11417,11426,2,8,5,15
11417,11427,10,9,12,31
11417,11428,7,6,8,21
11417,11429,5,7,12,24
11417,11432,16,37,18,71
11417,11433,7,7,18,32
11417,11434,6,18,27,51
11417,11435,6,37,20,63
11417,11436,7,6,19,32
11417,11691,8,10,13,31
11417,11692,1,4,7,12
11417,11693,4,3,8,15
11417,11694,7,8,13,28
11417,11697,2,0,4,6
11418,10001,0,4,4,8
11418,10002,1,11,9,21
11418,10003,1,2,5,8
11418,10004,0,0,1,1
11418,10005,0,0,2,2
11418,10006,0,0,3,3
11418,10007,1,2,2,5
11418,10009,3,15,11,29
11418,10010,1,2,4,7
11418,10011,0,1,11,12
11418,10012,0,1,6,7
11418,10013,1,1,2,4
11418,10014,0,3,6,9
11418,10016,1,3,8,12
11418,10017,0,1,1,2
11418,10018,0,1,1,2
11418,10019,1,3,6,10
11418,10021,0,3,8,11
11418,10022,2,3,9,14
11418,10023,1,2,6,9
11418,10024,3,3,11,17
11418,10025,5,3,10,18
11418,10026,1,6,9,16
11418,10027,4,10,12,26
11418,10028,1,0,2,3
11418,10029,6,18,12,36
11418,10030,5,5,3,13
11418,10031,4,9,8,21
11418,10032,6,11,11,28
11418,10033,3,7,5,15
11418,10034,5,4,5,14
11418,10035,2,8,3,13
11418,10036,0,2,3,5
11418,10037,3,7,4,14
11418,10039,1,2,3,6
11418,10040,3,9,7,19
11418,10044,0,0,3,3
11418,10065,0,3,4,7
11418,10075,0,2,4,6
11418,10128,1,5,10,16
11418,10282,0,1,1,2
11418,10301,2,5,11,18
11418,10302,1,1,2,4
11418,10303,1,2,5,8
11418,10304,0,4,9,13
11418,10305,3,2,11,16
11418,10306,3,2,17,22
11418,10307,0,0,3,3
11418,10308,1,2,7,10
11418,10309,3,5,18,26
11418,10310,2,4,3,9
11418,10312,0,5,15,20
11418,10314,6,11,30,47
11418,10451,10,13,5,28
11418,10452,5,24,13,42
11418,10453,17,24,7,48
11418,10454,0,8,8,16
11418,10455,9,12,6,27
11418,10456,17,23,11,51
11418,10457,7,25,11,43
11418,10458,20,35,13,68
11418,10459,11,11,8,30
11418,10460,17,22,11,50
11418,10461,2,10,8,20
11418,10462,10,18,13,41
11418,10463,5,10,10,25
11418,10464,0,2,3,5
11418,10465,2,12,14,28
11418,10466,16,22,8,46
11418,10467,8,19,15,42
11418,10468,5,7,16,28
11418,10469,9,15,15,39
11418,10470,5,6,4,15
11418,10471,1,3,4,8
11418,10472,13,18,17,48
11418,10473,7,9,7,23
11418,10474,1,1,1,3
11418,10475,6,9,13,28
11418,11001,0,5,13,18
11418,11004,2,8,20,30
11418,11005,1,0,4,5
11418,11040,1,2,6,9
11418,11101,4,8,16,28
11418,11102,7,9,13,29
11418,11103,9,13,15,37
11418,11104,6,9,14,29
11418,11105,5,17,25,47
11418,11106,5,9,21,35
11418,11109,0,0,2,2
11418,11201,3,5,19,27
11418,11203,14,25,40,79
11418,11204,5,16,17,38
11418,11205,7,7,13,27
11418,11206,11,32,35,78
11418,11207,43,95,68,206
11418,11208,50,126,97,273
11418,11209,9,9,20,38
11418,11210,14,26,27,67
11418,11211,5,20,32,57
11418,11212,20,52,64,136
11418,11213,8,9,27,44
11418,11214,11,27,29,67
11418,11215,2,4,14,20
11418,11216,9,17,14,40
11418,11217,1,8,13,22
11418,11218,10,20,8,38
11418,11219,5,11,8,24
11418,11220,1,10,11,22
11418,11221,12,29,24,65
11418,11222,2,4,12,18
11418,11223,12,20,14,46
11418,11224,10,20,11,41
11418,11225,9,18,22,49
11418,11226,19,45,33,97
11418,11228,1,9,15,25
11418,11229,8,23,27,58
11418,11230,10,20,19,49
11418,11231,1,3,6,10
11418,11232,3,5,9,17
11418,11233,12,39,47,98
11418,11234,21,45,73,139
11418,11235,15,28,16,59
11418,11236,38,47,75,160
11418,11237,10,37,11,58
11418,11238,6,8,8,22
11418,11239,4,15,3,22
11418,11354,13,34,26,73
11418,11355,35,41,36,112
11418,11356,3,9,26,38
11418,11357,10,15,41,66
11418,11358,14,26,34,74
11418,11359,0,0,1,1
11418,11360,0,8,35,43
11418,11361,4,19,38,61
11418,11362,6,9,24,39
11418,11363,6,2,12,20
11418,11364,16,15,59,90
11418,11365,13,16,41,70
11418,11366,11,7,43,61
11418,11367,12,36,65,113
11418,11368,55,64,53,172
11418,11369,15,23,32,70
11418,11370,11,17,20,48
11418,11371,0,1,0,1
11418,11372,15,23,40,78
11418,11373,33,45,66,144
11418,11374,19,43,65,127
11418,11375,30,50,157,237
11418,11377,24,50,57,131
11418,11378,13,26,41,80
11418,11379,10,31,53,94
11418,11385,49,75,113,237
11418,11411,8,20,52,80
11418,11412,21,40,85,146
11418,11413,16,48,115,179
11418,11414,20,28,53,101
11418,11415,42,69,80,191
11418,11416,35,67,57,159
11418,11417,26,59,74,159
11418,11418,158,278,196,632
11418,11419,84,180,107,371
11418,11420,56,129,120,305
11418,11421,44,101,84,229
11418,11422,15,26,53,94
11418,11423,24,54,69,147
11418,11426,3,16,40,59
11418,11427,14,33,38,85
11418,11428,10,28,51,89
11418,11429,13,34,66,113
11418,11430,0,1,0,1
11418,11432,37,65,97,199
11418,11433,30,60,71,161
11418,11434,33,74,133,240
11418,11435,39,122,124,285
11418,11436,16,50,54,120
11418,11451,1,0,1,2
11418,11691,24,32,33,89
11418,11692,5,15,21,41
11418,11693,2,11,9,22
11418,11694,4,12,19,35
11418,11697,0,1,2,3
11419,10002,5,4,1,10
11419,10003,1,0,1,2
11419,10007,0,1,0,1
11419,10009,2,1,2,5
11419,10010,1,0,0,1
11419,10011,0,1,1,2
11419,10012,1,2,0,3
11419,10013,0,2,0,2
11419,10016,0,0,1,1
11419,10017,1,0,0,1
11419,10019,0,1,1,2
11419,10021,0,1,3,4
11419,10022,0,0,2,2
11419,10023,2,1,2,5
11419,10024,0,1,0,1
11419,10025,2,1,2,5
11419,10026,0,0,1,1
11419,10027,0,0,2,2
11419,10028,0,0,1,1
11419,10029,1,0,3,4
11419,10030,0,0,1,1
11419,10031,2,1,3,6
11419,10032,2,4,0,6
11419,10033,0,1,0,1
11419,10034,1,1,0,2
11419,10035,1,0,2,3
11419,10036,0,1,1,2
11419,10037,1,0,0,1
11419,10038,0,0,1,1
11419,10039,0,2,1,3
11419,10040,0,6,1,7
11419,10065,0,0,1,1
11419,10128,0,1,4,5
11419,10301,1,0,2,3
11419,10302,0,1,1,2
11419,10303,2,2,1,5
11419,10304,4,4,0,8
11419,10305,4,4,0,8
11419,10306,0,3,8,11
11419,10308,0,0,2,2
11419,10309,0,1,1,2
11419,10310,0,1,0,1
11419,10312,2,1,3,6
11419,10314,5,8,7,20
11419,10451,2,2,1,5
11419,10452,3,11,0,14
11419,10453,4,4,3,11
11419,10454,0,2,0,2
11419,10455,3,1,0,4
11419,10456,5,10,2,17
11419,10457,5,4,1,10
11419,10458,3,3,4,10
11419,10459,0,3,0,3
11419,10460,2,3,0,5
11419,10461,1,4,2,7
11419,10462,2,4,4,10
11419,10463,0,5,2,7
11419,10465,0,4,2,6
11419,10466,3,5,3,11
11419,10467,4,8,2,14
11419,10468,1,6,2,9
11419,10469,3,3,2,8
11419,10470,2,1,1,4
11419,10471,0,0,1,1
11419,10472,2,2,1,5
11419,10473,2,3,3,8
11419,10474,0,0,1,1
11419,10475,0,2,1,3
11419,11001,2,3,1,6
11419,11004,8,7,2,17
11419,11040,1,0,0,1
11419,11101,4,5,2,11
11419,11102,4,2,2,8
11419,11103,5,4,2,11
11419,11104,4,7,3,14
11419,11105,3,1,2,6
11419,11106,2,1,1,4
11419,11109,1,0,1,2
11419,11201,6,2,6,14
11419,11203,8,22,10,40
11419,11204,8,16,5,29
11419,11205,1,3,4,8
11419,11206,5,11,8,24
11419,11207,14,40,8,62
11419,11208,46,61,14,121
11419,11209,12,10,7,29
11419,11210,9,10,4,23
11419,11211,0,3,4,7
11419,11212,6,15,16,37
11419,11213,4,10,3,17
11419,11214,12,19,5,36
11419,11215,3,1,5,9
11419,11216,4,13,6,23
11419,11217,1,2,3,6
11419,11218,7,4,2,13
11419,11219,10,8,2,20
11419,11220,22,12,5,39
11419,11221,8,15,3,26
11419,11222,0,1,0,1
11419,11223,4,12,4,20
11419,11224,0,5,3,8
11419,11225,1,8,10,19
11419,11226,8,21,13,42
11419,11228,1,9,2,12
11419,11229,7,8,3,18
11419,11230,6,6,3,15
11419,11231,1,0,3,4
11419,11232,2,3,1,6
11419,11233,11,16,8,35
11419,11234,8,31,23,62
11419,11235,3,7,4,14
11419,11236,17,29,18,64
11419,11237,7,8,4,19
11419,11238,3,8,9,20
11419,11239,3,0,0,3
11419,11354,24,22,5,51
11419,11355,32,39,10,81
11419,11356,5,2,1,8
11419,11357,7,5,6,18
11419,11358,14,9,12,35
11419,11359,0,1,1,2
11419,11360,6,2,5,13
11419,11361,6,12,7,25
11419,11362,2,2,8,12
11419,11363,0,3,1,4
11419,11364,8,12,5,25
11419,11365,9,7,11,27
11419,11366,3,5,2,10
11419,11367,7,4,12,23
11419,11368,32,27,20,79
11419,11369,2,7,2,11
11419,11370,4,10,2,16
11419,11372,7,3,6,16
11419,11373,24,19,7,50
11419,11374,11,6,15,32
11419,11375,11,20,17,48
11419,11377,22,12,15,49
11419,11378,10,9,8,27
11419,11379,10,3,19,32
11419,11385,18,30,17,65
11419,11411,9,10,4,23
11419,11412,12,27,7,46
11419,11413,10,8,8,26
11419,11414,20,23,13,56
11419,11415,5,4,7,16
11419,11416,22,58,7,87
11419,11417,42,45,15,102
11419,11418,37,58,14,109
11419,11419,227,325,73,625
11419,11420,104,142,19,265
11419,11421,21,21,14,56
11419,11422,7,12,7,26
11419,11423,16,26,21,63
11419,11426,6,8,8,22
11419,11427,4,7,6,17
11419,11428,12,10,11,33
11419,11429,12,3,6,21
11419,11430,1,0,0,1
11419,11432,25,30,13,68
11419,11433,11,18,14,43
11419,11434,14,47,13,74
11419,11435,29,41,12,82
11419,11436,8,33,10,51
11419,11451,0,0,1,1
11419,11691,7,14,9,30
11419,11692,6,10,3,19
11419,11693,1,1,1,3
11419,11694,4,6,5,15
11419,11697,1,1,1,3
11420,10001,0,0,1,1
11420,10002,2,0,3,5
11420,10003,1,1,3,5
11420,10009,0,1,2,3
11420,10010,1,0,0,1
11420,10011,0,0,4,4
11420,10012,0,0,1,1
11420,10013,2,0,0,2
11420,10016,0,0,2,2
11420,10019,1,1,3,5
11420,10021,0,0,3,3
11420,10022,0,1,2,3
11420,10023,0,2,1,3
11420,10024,2,1,4,7
11420,10025,0,3,6,9
11420,10026,0,2,4,6
11420,10027,0,1,6,7
11420,10028,0,1,3,4
11420,10029,2,1,9,12
11420,10030,2,0,3,5
11420,10031,2,2,1,5
11420,10032,0,2,1,3
11420,10033,1,1,3,5
11420,10034,1,2,2,5
11420,10035,0,2,1,3
11420,10036,1,2,2,5
11420,10037,0,0,2,2
11420,10038,0,2,1,3
11420,10039,0,1,0,1
11420,10040,0,2,2,4
11420,10065,0,0,1,1
11420,10069,0,0,1,1
11420,10128,0,1,3,4
11420,10280,1,0,1,2
11420,10282,0,0,1,1
11420,10301,1,4,4,9
11420,10302,0,1,0,1
11420,10303,0,7,1,8
11420,10304,2,2,4,8
11420,10305,1,1,7,9
11420,10306,0,1,10,11
11420,10307,0,1,3,4
11420,10308,2,3,5,10
11420,10309,1,1,5,7
11420,10310,0,5,1,6
11420,10312,5,2,10,17
11420,10314,2,5,15,22
11420,10451,0,4,1,5
11420,10452,3,4,3,10
11420,10453,3,4,6,13
11420,10454,0,5,3,8
11420,10455,3,2,2,7
11420,10456,5,5,3,13
11420,10457,0,1,7,8
11420,10458,3,7,3,13
11420,10459,3,5,1,9
11420,10460,3,3,4,10
11420,10461,0,2,6,8
11420,10462,1,8,8,17
11420,10463,0,3,10,13
11420,10464,0,1,0,1
11420,10465,3,4,6,13
11420,10466,6,6,11,23
11420,10467,0,9,9,18
11420,10468,1,7,3,11
11420,10469,5,3,6,14
11420,10470,1,0,1,2
11420,10471,1,3,4,8
11420,10472,2,6,7,15
11420,10473,4,5,5,14
11420,10474,0,1,2,3
11420,10475,0,1,4,5
11420,11001,2,1,1,4
11420,11004,0,3,4,7
11420,11040,0,0,1,1
11420,11101,2,3,3,8
11420,11102,1,2,5,8
11420,11103,1,3,4,8
11420,11104,2,2,14,18
11420,11105,0,1,3,4
11420,11106,2,1,5,8
11420,11109,0,0,1,1
11420,11201,0,3,5,8
11420,11203,8,16,28,52
11420,11204,2,3,8,13
11420,11205,1,5,4,10
11420,11206,9,10,23,42
11420,11207,8,26,42,76
11420,11208,21,35,52,108
11420,11209,1,2,8,11
11420,11210,7,9,24,40
11420,11211,1,3,6,10
11420,11212,10,26,23,59
11420,11213,7,7,16,30
11420,11214,4,4,9,17
11420,11215,0,1,4,5
11420,11216,2,5,6,13
11420,11217,1,2,2,5
11420,11218,0,2,8,10
11420,11219,3,1,15,19
11420,11220,2,9,17,28
11420,11221,6,11,19,36
11420,11222,2,2,8,12
11420,11223,3,4,6,13
11420,11224,2,2,8,12
11420,11225,2,9,9,20
11420,11226,6,11,12,29
11420,11228,1,5,3,9
11420,11229,3,6,12,21
11420,11230,0,5,8,13
11420,11231,1,1,0,2
11420,11232,2,0,1,3
11420,11233,1,8,18,27
11420,11234,14,31,32,77
11420,11235,6,3,11,20
11420,11236,14,22,59,95
11420,11237,6,6,8,20
11420,11238,1,2,10,13
11420,11239,1,2,11,14
11420,11354,5,7,18,30
11420,11355,8,14,21,43
11420,11356,1,2,9,12
11420,11357,3,5,14,22
11420,11358,1,5,9,15
11420,11360,2,3,8,13
11420,11361,7,5,9,21
11420,11362,1,1,9,11
11420,11363,0,0,3,3
11420,11364,2,14,18,34
11420,11365,4,8,20,32
11420,11366,1,1,5,7
11420,11367,3,9,22,34
11420,11368,8,21,36,65
11420,11369,7,3,11,21
11420,11370,4,6,6,16
11420,11372,4,6,5,15
11420,11373,5,10,32,47
11420,11374,4,7,9,20
11420,11375,8,9,23,40
11420,11377,10,15,34,59
11420,11378,12,10,26,48
11420,11379,1,17,22,40
11420,11385,13,25,33,71
11420,11411,5,8,16,29
11420,11412,8,27,28,63
11420,11413,11,27,28,66
11420,11414,11,16,63,90
11420,11415,2,2,9,13
11420,11416,9,17,29,55
11420,11417,19,50,65,134
11420,11418,22,25,26,73
11420,11419,53,66,54,173
11420,11420,123,219,142,484
11420,11421,9,14,32,55
11420,11422,8,9,20,37
11420,11423,8,18,19,45
11420,11426,2,6,14,22
11420,11427,2,8,9,19
11420,11428,5,13,11,29
11420,11429,6,20,13,39
11420,11430,2,0,0,2
11420,11432,17,22,33,72
11420,11433,13,24,26,63
11420,11434,17,38,53,108
11420,11435,17,40,32,89
11420,11436,23,17,26,66
11420,11691,11,26,39,76
11420,11692,3,4,5,12
11420,11693,4,6,4,14
11420,11694,7,6,25,38
11420,11697,1,0,2,3
11421,10001,1,0,1,2
11421,10002,5,4,0,9
11421,10003,0,1,1,2
11421,10004,0,0,1,1
11421,10007,0,0,1,1
11421,10009,0,0,1,1
11421,10010,0,0,1,1
11421,10011,1,1,2,4
11421,10012,0,1,0,1
11421,10013,0,1,0,1
11421,10014,1,2,0,3
11421,10016,1,1,1,3
11421,10017,0,0,1,1
11421,10019,1,1,1,3
11421,10021,0,0,1,1
11421,10022,0,1,0,1
11421,10023,0,0,2,2
11421,10025,2,0,2,4
11421,10026,0,1,1,2
11421,10027,0,1,5,6
11421,10028,0,0,4,4
11421,10029,2,3,5,10
11421,10030,2,0,1,3
11421,10031,2,2,2,6
11421,10032,2,1,2,5
11421,10033,1,3,1,5
11421,10034,1,1,1,3
11421,10035,1,2,1,4
11421,10037,0,1,0,1
11421,10039,1,1,3,5
11421,10040,0,1,3,4
11421,10065,2,0,1,3
11421,10280,0,1,0,1
11421,10282,0,2,0,2
11421,10301,0,2,2,4
11421,10302,0,0,2,2
11421,10303,0,1,0,1
11421,10304,0,2,2,4
11421,10305,0,2,3,5
11421,10306,0,3,5,8
11421,10308,0,1,0,1
11421,10309,1,0,2,3
11421,10310,0,1,0,1
11421,10312,0,2,5,7
11421,10314,1,2,7,10
11421,10451,0,3,1,4
11421,10452,2,2,2,6
11421,10453,1,4,4,9
11421,10454,1,1,2,4
11421,10455,0,3,1,4
11421,10456,7,8,5,20
11421,10457,2,1,2,5
11421,10458,2,8,2,12
11421,10459,0,2,1,3
11421,10460,3,7,3,13
11421,10461,1,3,2,6
11421,10462,3,7,3,13
11421,10463,1,3,3,7
11421,10465,1,2,4,7
11421,10466,1,1,2,4
11421,10467,3,4,3,10
11421,10468,4,6,3,13
11421,10469,0,2,4,6
11421,10471,0,0,2,2
11421,10472,2,2,1,5
11421,10473,3,2,2,7
11421,10475,0,0,3,3
11421,11001,0,2,1,3
11421,11004,1,2,3,6
11421,11005,0,0,1,1
11421,11040,0,1,0,1
11421,11101,2,3,2,7
11421,11102,7,2,3,12
11421,11103,5,8,8,21
11421,11104,3,7,1,11
11421,11105,2,7,2,11
11421,11106,5,3,2,10
11421,11109,0,0,1,1
11421,11201,3,2,0,5
11421,11203,12,15,12,39
11421,11204,1,1,1,3
11421,11205,2,0,1,3
11421,11206,11,10,9,30
11421,11207,17,32,12,61
11421,11208,18,35,20,73
11421,11209,5,1,1,7
11421,11210,4,6,6,16
11421,11211,11,9,4,24
11421,11212,8,18,9,35
11421,11213,10,13,6,29
11421,11214,8,2,0,10
11421,11215,2,1,3,6
11421,11216,2,9,7,18
11421,11217,0,1,1,2
11421,11218,4,3,4,11
11421,11219,2,4,3,9
11421,11220,11,4,5,20
11421,11221,6,16,8,30
11421,11222,4,4,6,14
11421,11223,3,4,4,11
11421,11224,3,4,1,8
11421,11225,3,5,1,9
11421,11226,6,7,5,18
11421,11228,1,1,1,3
11421,11229,0,3,4,7
11421,11230,2,4,3,9
11421,11231,2,2,4,8
11421,11232,2,2,0,4
11421,11233,7,14,11,32
11421,11234,10,11,11,32
11421,11235,3,1,3,7
11421,11236,7,20,13,40
11421,11237,6,12,3,21
11421,11238,0,4,4,8
11421,11239,0,0,5,5
11421,11354,3,13,2,18
11421,11355,10,9,11,30
11421,11356,5,3,5,13
11421,11357,5,8,3,16
11421,11358,11,10,2,23
11421,11359,0,1,0,1
11421,11360,1,7,3,11
11421,11361,2,6,1,9
11421,11362,4,10,6,20
11421,11364,2,6,3,11
11421,11365,4,9,8,21
11421,11366,1,1,6,8
11421,11367,3,5,7,15
11421,11368,9,24,9,42
11421,11369,5,10,1,16
11421,11370,4,2,5,11
11421,11372,13,10,14,37
11421,11373,13,15,11,39
11421,11374,6,5,6,17
11421,11375,7,9,11,27
11421,11377,15,14,10,39
11421,11378,8,13,3,24
11421,11379,12,12,10,34
11421,11385,19,18,19,56
11421,11411,2,8,5,15
11421,11412,2,8,5,15
11421,11413,5,10,5,20
11421,11414,10,10,9,29
11421,11415,1,7,5,13
11421,11416,11,18,10,39
11421,11417,13,14,7,34
11421,11418,13,41,5,59
11421,11419,19,22,9,50
11421,11420,11,22,13,46
11421,11421,145,153,40,338
11421,11422,1,6,4,11
11421,11423,7,4,2,13
11421,11426,2,2,2,6
11421,11427,6,3,2,11
11421,11428,2,7,2,11
11421,11429,4,2,2,8
11421,11432,18,10,5,33
11421,11433,5,14,3,22
11421,11434,7,7,10,24
11421,11435,9,13,5,27
11421,11436,2,3,2,7
11421,11691,2,0,4,6
11421,11692,1,2,2,5
11421,11693,5,4,1,10
11421,11694,4,5,6,15
11422,10001,1,0,0,1
11422,10002,0,1,1,2
11422,10003,0,1,1,2
11422,10009,2,0,1,3
11422,10010,0,2,0,2
11422,10011,0,1,1,2
11422,10013,1,1,0,2
11422,10014,1,0,1,2
11422,10017,1,0,1,2
11422,10019,0,1,0,1
11422,10021,0,0,1,1
11422,10022,0,1,0,1
11422,10023,1,0,1,2
11422,10024,0,1,0,1
11422,10025,1,0,1,2
11422,10026,1,1,0,2
11422,10027,0,2,3,5
11422,10028,0,0,2,2
11422,10029,0,3,2,5
11422,10030,1,1,1,3
11422,10031,1,1,2,4
11422,10032,1,2,2,5
11422,10033,1,1,2,4
11422,10034,0,1,0,1
11422,10035,0,0,1,1
11422,10036,0,0,3,3
11422,10037,0,3,1,4
11422,10038,0,1,0,1
11422,10039,0,3,0,3
11422,10040,1,2,2,5
11422,10044,0,0,2,2
11422,10065,0,0,1,1
11422,10075,0,0,1,1
11422,10128,0,0,2,2
11422,10301,1,6,3,10
11422,10302,0,1,0,1
11422,10303,2,0,0,2
11422,10304,2,1,1,4
11422,10305,0,3,2,5
11422,10306,2,0,2,4
11422,10307,1,0,0,1
11422,10308,0,1,2,3
11422,10309,0,1,1,2
11422,10310,2,0,0,2
11422,10312,2,4,5,11
11422,10314,2,4,3,9
11422,10451,3,3,1,7
11422,10452,1,4,1,6
11422,10453,2,5,3,10
11422,10454,0,0,1,1
11422,10455,0,2,2,4
11422,10456,1,4,4,9
11422,10457,4,3,2,9
11422,10458,3,3,0,6
11422,10459,2,3,1,6
11422,10460,1,3,3,7
11422,10461,0,1,1,2
11422,10462,3,1,6,10
11422,10463,0,0,5,5
11422,10464,1,0,0,1
11422,10465,1,0,2,3
11422,10466,2,1,2,5
11422,10467,3,4,5,12
11422,10468,3,0,2,5
11422,10469,1,3,2,6
11422,10470,1,1,1,3
11422,10471,0,1,0,1
11422,10472,2,4,2,8
11422,10473,2,4,0,6
11422,10474,0,1,1,2
11422,10475,4,1,7,12
11422,11001,1,0,0,1
11422,11004,1,1,4,6
11422,11005,0,1,1,2
11422,11040,0,1,0,1
11422,11101,1,1,2,4
11422,11102,0,1,1,2
11422,11103,1,2,3,6
11422,11104,1,2,1,4
11422,11105,0,2,3,5
11422,11106,2,2,3,7
11422,11201,2,0,1,3
11422,11203,2,11,4,17
11422,11204,5,2,3,10
11422,11205,1,2,3,6
11422,11206,2,6,6,14
11422,11207,12,34,15,61
11422,11208,23,26,11,60
11422,11209,3,4,5,12
11422,11210,4,11,2,17
11422,11211,0,6,0,6
11422,11212,17,19,5,41
11422,11213,0,3,2,5
11422,11214,4,3,4,11
11422,11215,0,2,4,6
11422,11216,0,8,1,9
11422,11217,0,1,2,3
11422,11218,1,3,2,6
11422,11219,7,3,0,10
11422,11220,4,2,3,9
11422,11221,3,7,3,13
11422,11223,3,3,3,9
11422,11224,0,5,1,6
11422,11225,3,3,4,10
11422,11226,5,13,1,19
11422,11228,1,4,0,5
11422,11229,1,4,4,9
11422,11230,0,4,4,8
11422,11231,0,1,1,2
11422,11232,2,0,0,2
11422,11233,1,9,7,17
11422,11234,9,20,26,55
11422,11235,2,3,4,9
11422,11236,21,12,16,49
11422,11237,2,3,4,9
11422,11238,7,3,3,13
11422,11239,1,0,1,2
11422,11354,3,2,9,14
11422,11355,8,12,9,29
11422,11356,3,2,3,8
11422,11357,4,7,11,22
11422,11358,6,8,8,22
11422,11360,1,2,6,9
11422,11361,0,8,14,22
11422,11362,1,3,13,17
11422,11363,0,2,1,3
11422,11364,10,8,17,35
11422,11365,3,8,6,17
11422,11366,2,1,7,10
11422,11367,0,7,6,13
11422,11368,4,6,4,14
11422,11369,1,1,2,4
11422,11370,0,3,1,4
11422,11371,0,0,1,1
11422,11372,0,3,2,5
11422,11373,3,9,8,20
11422,11374,2,6,5,13
11422,11375,8,11,11,30
11422,11377,2,8,2,12
11422,11378,2,4,4,10
11422,11379,8,4,2,14
11422,11385,11,12,8,31
11422,11411,11,13,6,30
11422,11412,10,20,8,38
11422,11413,22,36,19,77
11422,11414,2,3,10,15
11422,11415,1,2,5,8
11422,11416,9,9,5,23
11422,11417,4,12,6,22
11422,11418,5,10,2,17
11422,11419,7,39,11,57
11422,11420,8,46,11,65
11422,11421,4,13,11,28
11422,11422,42,65,21,128
11422,11423,3,16,6,25
11422,11426,0,3,3,6
11422,11427,6,7,7,20
11422,11428,4,8,6,18
11422,11429,11,17,9,37
11422,11432,8,23,10,41
11422,11433,12,18,5,35
11422,11434,12,24,24,60
11422,11435,7,12,8,27
11422,11436,11,15,5,31
11422,11691,18,22,3,43
11422,11692,5,13,0,18
11422,11693,1,3,2,6
11422,11694,1,7,7,15
11422,11697,0,0,1,1
11423,10002,2,2,2,6
11423,10003,1,1,3,5
11423,10007,0,2,1,3
11423,10009,0,0,4,4
11423,10010,0,0,1,1
11423,10011,0,1,1,2
11423,10013,1,0,0,1
11423,10014,0,1,0,1
11423,10016,0,0,3,3
11423,10017,1,0,0,1
11423,10019,0,1,2,3
11423,10021,0,0,1,1
11423,10024,0,1,2,3
11423,10025,0,0,1,1
11423,10026,1,2,2,5
11423,10027,0,2,1,3
11423,10028,0,0,2,2
11423,10029,2,4,1,7
11423,10030,0,3,0,3
11423,10031,1,2,2,5
11423,10032,0,0,1,1
11423,10033,0,1,2,3
11423,10034,2,1,1,4
11423,10035,2,2,0,4
11423,10036,1,1,1,3
11423,10037,0,1,1,2
11423,10038,0,1,0,1
11423,10039,1,3,0,4
11423,10040,0,1,2,3
11423,10075,0,0,1,1
11423,10128,0,0,2,2
11423,10162,0,0,1,1
11423,10280,0,1,0,1
11423,10301,3,3,2,8
11423,10302,0,1,1,2
11423,10303,0,2,1,3
11423,10304,0,0,6,6
11423,10305,0,0,5,5
11423,10306,0,0,5,5
11423,10307,0,1,0,1
11423,10308,0,1,1,2
11423,10309,0,3,2,5
11423,10310,0,1,0,1
11423,10312,0,2,3,5
11423,10314,0,3,7,10
11423,10451,2,1,0,3
11423,10452,2,4,0,6
11423,10453,5,8,1,14
11423,10454,2,1,4,7
11423,10455,1,1,4,6
11423,10456,3,3,3,9
11423,10457,2,4,2,8
11423,10458,0,2,4,6
11423,10459,0,3,1,4
11423,10460,1,4,4,9
11423,10461,1,5,4,10
11423,10462,2,3,3,8
11423,10463,1,1,3,5
11423,10464,0,0,1,1
11423,10465,0,3,8,11
11423,10466,2,3,1,6
11423,10467,2,4,7,13
11423,10468,1,0,5,6
11423,10469,3,3,4,10
11423,10470,0,1,0,1
11423,10471,1,1,3,5
11423,10472,3,4,6,13
11423,10473,1,2,2,5
11423,10474,0,0,1,1
11423,10475,1,1,2,4
11423,11001,2,4,1,7
11423,11004,2,3,6,11
11423,11005,0,0,1,1
11423,11040,2,1,0,3
11423,11101,0,8,1,9
11423,11102,4,1,3,8
11423,11103,1,4,3,8
11423,11104,2,3,2,7
11423,11105,2,1,1,4
11423,11106,0,2,3,5
11423,11201,1,1,1,3
11423,11203,3,8,8,19
11423,11204,3,0,5,8
11423,11205,0,3,2,5
11423,11206,1,13,3,17
11423,11207,3,21,11,35
11423,11208,11,20,25,56
11423,11209,2,2,2,6
11423,11210,1,3,4,8
11423,11211,2,3,0,5
11423,11212,5,10,5,20
11423,11213,7,6,2,15
11423,11214,1,4,1,6
11423,11215,2,1,3,6
11423,11216,1,5,1,7
11423,11217,0,1,1,2
11423,11218,4,3,1,8
11423,11219,1,2,1,4
11423,11220,2,2,1,5
11423,11221,2,4,4,10
11423,11222,0,1,1,2
11423,11223,4,7,1,12
11423,11224,0,3,1,4
11423,11225,3,7,5,15
11423,11226,2,8,10,20
11423,11228,1,0,1,2
11423,11229,0,6,4,10
11423,11230,1,5,3,9
11423,11231,2,0,0,2
11423,11232,1,1,0,2
11423,11233,3,9,4,16
11423,11234,1,12,11,24
11423,11235,1,3,2,6
11423,11236,4,10,11,25
11423,11237,1,8,2,11
11423,11238,3,7,3,13
11423,11239,0,4,2,6
11423,11354,10,7,2,19
11423,11355,15,28,10,53
11423,11356,3,1,2,6
11423,11357,4,2,8,14
11423,11358,4,1,9,14
11423,11359,0,1,0,1
11423,11360,0,8,6,14
11423,11361,2,2,10,14
11423,11362,3,1,6,10
11423,11363,2,4,1,7
11423,11364,1,11,14,26
11423,11365,9,19,11,39
11423,11366,4,6,11,21
11423,11367,6,13,7,26
11423,11368,10,19,18,47
11423,11369,5,8,7,20
11423,11370,0,4,4,8
11423,11372,0,8,9,17
11423,11373,4,15,8,27
11423,11374,9,10,11,30
11423,11375,5,11,17,33
11423,11377,4,10,3,17
11423,11378,4,8,4,16
11423,11379,1,10,6,17
11423,11385,2,7,23,32
11423,11411,12,18,16,46
11423,11412,10,39,19,68
11423,11413,13,23,26,62
11423,11414,2,3,8,13
11423,11415,4,4,5,13
11423,11416,7,14,12,33
11423,11417,10,13,16,39
11423,11418,10,6,15,31
11423,11419,21,48,20,89
11423,11420,20,24,18,62
11423,11421,9,12,12,33
11423,11422,8,10,21,39
11423,11423,64,114,49,227
11423,11426,3,5,8,16
11423,11427,15,24,24,63
11423,11428,19,20,14,53
11423,11429,16,20,26,62
11423,11432,39,61,28,128
11423,11433,16,33,19,68
11423,11434,20,53,36,109
11423,11435,11,23,17,51
11423,11436,6,13,8,27
11423,11691,6,13,8,27
11423,11692,1,3,5,9
11423,11693,2,3,1,6
11423,11694,3,3,3,9
11423,11697,2,0,0,2
11424,10001,0,0,1,1
11424,10002,0,0,4,4
11424,10003,0,1,1,2
11424,10009,0,0,3,3
11424,10013,0,0,1,1
11424,10014,0,0,1,1
11424,10021,0,0,4,4
11424,10022,0,0,2,2
11424,10023,0,0,1,1
11424,10024,0,0,1,1
11424,10025,1,0,0,1
11424,10026,0,0,3,3
11424,10027,0,1,2,3
11424,10029,0,1,3,4
11424,10030,0,0,1,1
11424,10031,0,0,1,1
11424,10032,0,0,3,3
11424,10033,0,1,0,1
11424,10034,1,0,4,5
11424,10036,0,0,1,1
11424,10037,0,0,2,2
11424,10039,0,2,0,2
11424,10040,0,1,0,1
11424,10075,0,0,1,1
11424,10128,0,0,2,2
11424,10301,0,0,3,3
11424,10303,0,0,3,3
11424,10305,0,0,3,3
11424,10306,0,0,5,5
11424,10307,1,1,3,5
11424,10308,0,1,4,5
11424,10309,0,0,2,2
11424,10310,0,0,4,4
11424,10312,0,0,1,1
11424,10314,1,0,6,7
11424,10451,1,0,1,2
11424,10452,1,0,0,1
11424,10453,1,1,0,2
11424,10454,0,1,1,2
11424,10455,0,1,1,2
11424,10456,0,0,2,2
11424,10457,0,0,2,2
11424,10458,0,0,3,3
11424,10459,0,0,1,1
11424,10460,0,3,2,5
11424,10461,0,0,2,2
11424,10462,0,0,3,3
11424,10463,0,1,4,5
11424,10465,0,0,1,1
11424,10466,1,0,4,5
11424,10467,0,2,6,8
11424,10468,2,0,5,7
11424,10469,1,2,5,8
11424,10472,0,4,3,7
11424,10473,0,0,2,2
11424,10475,1,3,3,7
11424,11101,1,1,2,4
11424,11102,2,0,3,5
11424,11103,0,0,3,3
11424,11104,0,0,3,3
11424,11105,0,1,6,7
11424,11106,0,0,8,8
11424,11201,0,1,0,1
11424,11203,0,1,5,6
11424,11204,0,0,1,1
11424,11205,0,0,2,2
11424,11206,2,1,2,5
11424,11207,0,4,11,15
11424,11208,4,2,3,9
11424,11209,1,2,2,5
11424,11210,0,1,4,5
11424,11211,0,0,5,5
11424,11212,1,1,4,6
11424,11213,0,1,4,5
11424,11214,0,1,3,4
11424,11215,0,0,5,5
11424,11216,0,3,0,3
11424,11218,0,2,2,4
11424,11219,0,0,1,1
11424,11220,0,2,2,4
11424,11221,0,2,4,6
11424,11222,0,2,0,2
11424,11223,0,0,7,7
11424,11224,0,1,2,3
11424,11226,0,0,4,4
11424,11228,0,0,2,2
11424,11229,0,2,2,4
11424,11230,0,1,0,1
11424,11231,0,0,1,1
11424,11232,0,1,0,1
11424,11233,0,1,5,6
11424,11234,1,2,12,15
11424,11235,1,0,4,5
11424,11236,1,1,11,13
11424,11237,0,0,5,5
11424,11238,0,0,2,2
11424,11239,0,0,1,1
11424,11354,0,0,5,5
11424,11355,0,0,8,8
11424,11357,0,1,10,11
11424,11358,1,1,3,5
11424,11360,0,0,4,4
11424,11361,0,1,8,9
11424,11362,0,0,4,4
11424,11364,1,1,6,8
11424,11365,1,1,6,8
11424,11366,1,0,1,2
11424,11367,0,0,10,10
11424,11368,0,1,3,4
11424,11369,0,0,4,4
11424,11370,0,1,0,1
11424,11372,1,1,6,8
11424,11373,1,1,7,9
11424,11374,0,3,3,6
11424,11375,1,0,10,11
11424,11377,2,1,4,7
11424,11378,1,0,9,10
11424,11379,4,1,5,10
11424,11385,1,2,13,16
11424,11411,1,1,4,6
11424,11412,1,1,8,10
11424,11413,1,1,6,8
11424,11414,0,1,6,7
11424,11415,0,0,5,5
11424,11416,0,0,6,6
11424,11417,0,2,7,9
11424,11418,0,0,6,6
11424,11419,0,0,1,1
11424,11420,2,0,1,3
11424,11421,0,2,5,7
11424,11422,0,1,8,9
11424,11423,0,1,4,5
11424,11426,0,1,3,4
11424,11427,0,3,2,5
11424,11428,1,0,3,4
11424,11429,2,3,3,8
11424,11430,0,0,1,1
11424,11432,1,3,6,10
11424,11433,0,2,6,8
11424,11434,2,1,6,9
11424,11435,0,1,9,10
11424,11436,0,1,2,3
11424,11691,0,2,4,6
11424,11692,0,1,1,2
11424,11693,0,0,3,3
11424,11694,0,1,4,5
11424,11697,0,0,1,1
11425,11209,0,0,1,1
11425,11220,0,1,0,1
11425,11372,0,1,0,1
11426,10002,1,1,3,5
11426,10003,0,0,3,3
11426,10005,0,0,1,1
11426,10009,0,0,2,2
11426,10010,0,1,0,1
11426,10011,0,0,1,1
11426,10014,0,0,1,1
11426,10016,0,0,2,2
11426,10017,0,0,1,1
11426,10022,0,0,2,2
11426,10023,1,0,2,3
11426,10024,1,0,0,1
11426,10025,3,1,4,8
11426,10026,1,4,2,7
11426,10027,0,1,1,2
11426,10028,0,1,1,2
11426,10029,4,3,1,8
11426,10030,1,1,0,2
11426,10031,1,1,2,4
11426,10032,1,2,0,3
11426,10033,4,1,1,6
11426,10034,1,1,2,4
11426,10035,0,0,3,3
11426,10037,0,1,0,1
11426,10038,1,0,0,1
11426,10039,0,2,1,3
11426,10040,1,1,1,3
11426,10069,0,0,1,1
11426,10128,0,1,3,4
11426,10301,0,2,2,4
11426,10302,1,4,1,6
11426,10303,1,1,2,4
11426,10304,0,0,4,4
11426,10305,1,5,0,6
11426,10306,3,2,5,10
11426,10307,0,1,4,5
11426,10308,1,1,2,4
11426,10309,0,1,1,2
11426,10310,1,0,2,3
11426,10312,2,0,2,4
11426,10314,3,3,3,9
11426,10451,1,0,1,2
11426,10452,6,2,1,9
11426,10453,0,8,2,10
11426,10454,1,0,1,2
11426,10455,0,0,2,2
11426,10456,3,2,7,12
11426,10457,1,4,1,6
11426,10458,1,1,4,6
11426,10459,0,2,1,3
11426,10460,0,3,5,8
11426,10461,1,0,6,7
11426,10462,2,5,5,12
11426,10463,2,3,1,6
11426,10465,6,5,5,16
11426,10466,4,5,3,12
11426,10467,2,3,2,7
11426,10468,2,2,2,6
11426,10469,2,3,0,5
11426,10470,1,0,3,4
11426,10471,0,0,1,1
11426,10472,0,6,7,13
11426,10473,2,3,8,13
11426,10475,6,4,6,16
11426,11001,7,9,4,20
11426,11004,10,21,15,46
11426,11005,1,0,0,1
11426,11040,1,2,3,6
11426,11101,1,1,4,6
11426,11102,1,1,1,3
11426,11103,0,2,2,4
11426,11104,4,0,4,8
11426,11105,3,1,4,8
11426,11106,2,1,3,6
11426,11109,0,0,1,1
11426,11201,1,1,0,2
11426,11203,7,5,6,18
11426,11204,5,2,0,7
11426,11205,1,1,2,4
11426,11206,1,1,6,8
11426,11207,2,17,11,30
11426,11208,9,14,23,46
11426,11209,0,1,4,5
11426,11210,1,0,2,3
11426,11211,0,0,1,1
11426,11212,4,1,5,10
11426,11213,0,1,7,8
11426,11214,4,3,2,9
11426,11215,1,1,4,6
11426,11216,1,4,2,7
11426,11217,0,2,0,2
11426,11218,3,0,2,5
11426,11219,1,1,1,3
11426,11220,6,1,2,9
11426,11221,4,1,6,11
11426,11222,0,0,1,1
11426,11223,0,1,4,5
11426,11224,0,1,2,3
11426,11225,2,2,3,7
11426,11226,2,3,1,6
11426,11228,0,1,2,3
11426,11229,0,2,2,4
11426,11230,2,0,1,3
11426,11231,0,0,4,4
11426,11232,1,1,0,2
11426,11233,3,4,4,11
11426,11234,2,4,7,13
11426,11235,0,2,5,7
11426,11236,3,7,9,19
11426,11237,1,5,2,8
11426,11238,1,2,3,6
11426,11239,1,0,2,3
11426,11354,2,4,7,13
11426,11355,12,15,7,34
11426,11356,1,5,4,10
11426,11357,4,3,9,16
11426,11358,5,8,8,21
11426,11359,0,2,1,3
11426,11360,0,3,5,8
11426,11361,3,11,4,18
11426,11362,13,2,2,17
11426,11363,0,1,0,1
11426,11364,9,6,7,22
11426,11365,10,3,6,19
11426,11366,1,2,3,6
11426,11367,7,4,4,15
11426,11368,6,14,7,27
11426,11369,0,10,2,12
11426,11370,2,1,10,13
11426,11372,3,3,4,10
11426,11373,7,4,9,20
11426,11374,6,4,8,18
11426,11375,3,4,11,18
11426,11377,5,11,6,22
11426,11378,5,5,10,20
11426,11379,1,4,8,13
11426,11385,4,8,16,28
11426,11411,2,9,13,24
11426,11412,10,25,17,52
11426,11413,8,17,13,38
11426,11414,1,2,5,8
11426,11415,3,4,4,11
11426,11416,5,2,4,11
11426,11417,2,4,6,12
11426,11418,5,2,2,9
11426,11419,6,11,12,29
11426,11420,5,9,4,18
11426,11421,8,10,9,27
11426,11422,8,11,9,28
11426,11423,11,16,14,41
11426,11426,52,76,34,162
11426,11427,16,16,7,39
11426,11428,15,19,8,42
11426,11429,10,16,10,36
11426,11432,8,15,7,30
11426,11433,8,9,4,21
11426,11434,2,21,14,37
11426,11435,5,19,8,32
11426,11436,3,7,4,14
11426,11691,1,9,8,18
11426,11692,1,3,2,6
11426,11693,1,1,1,3
11426,11694,2,0,5,7
11426,11697,0,0,1,1
11427,10001,1,0,2,3
11427,10002,6,2,2,10
11427,10003,2,0,2,4
11427,10005,0,0,3,3
11427,10009,4,1,2,7
11427,10010,1,0,1,2
11427,10011,1,0,4,5
11427,10012,0,0,1,1
11427,10013,0,1,4,5
11427,10016,0,0,5,5
11427,10017,0,1,1,2
11427,10018,2,0,1,3
11427,10019,1,0,2,3
11427,10021,2,0,4,6
11427,10022,2,0,1,3
11427,10023,1,0,4,5
11427,10024,0,0,3,3
11427,10025,1,5,11,17
11427,10026,0,1,7,8
11427,10027,0,1,6,7
11427,10028,0,1,3,4
11427,10029,4,4,3,11
11427,10030,3,3,2,8
11427,10031,2,5,3,10
11427,10032,1,2,7,10
11427,10033,4,3,3,10
11427,10034,1,2,2,5
11427,10035,2,2,2,6
11427,10036,0,0,1,1
11427,10037,2,1,4,7
11427,10038,1,1,2,4
11427,10039,3,1,3,7
11427,10040,2,3,5,10
11427,10044,0,0,1,1
11427,10065,0,1,1,2
11427,10075,1,0,3,4
11427,10128,1,1,3,5
11427,10280,0,0,1,1
11427,10301,2,0,3,5
11427,10302,1,0,1,2
11427,10303,3,2,5,10
11427,10304,1,1,4,6
11427,10305,3,2,3,8
11427,10306,3,2,2,7
11427,10307,0,0,2,2
11427,10308,0,0,2,2
11427,10309,2,6,8,16
11427,10310,1,1,2,4
11427,10312,0,0,11,11
11427,10314,5,3,13,21
11427,10451,4,3,2,9
11427,10452,2,4,10,16
11427,10453,3,4,4,11
11427,10454,1,1,3,5
11427,10455,3,4,4,11
11427,10456,3,6,3,12
11427,10457,10,4,2,16
11427,10458,5,5,5,15
11427,10459,3,5,5,13
11427,10460,5,4,6,15
11427,10461,2,7,15,24
11427,10462,5,4,18,27
11427,10463,3,3,7,13
11427,10464,1,1,1,3
11427,10465,10,7,19,36
11427,10466,1,3,12,16
11427,10467,2,6,8,16
11427,10468,1,2,6,9
11427,10469,5,3,13,21
11427,10470,4,0,2,6
11427,10471,1,1,3,5
11427,10472,2,11,12,25
11427,10473,10,14,11,35
11427,10474,0,0,1,1
11427,10475,4,2,17,23
11427,11001,5,6,8,19
11427,11004,21,11,11,43
11427,11005,0,1,2,3
11427,11040,5,0,1,6
11427,11101,1,4,9,14
11427,11102,4,3,5,12
11427,11103,1,5,6,12
11427,11104,2,1,7,10
11427,11105,3,4,6,13
11427,11106,4,6,8,18
11427,11201,2,0,3,5
11427,11203,3,12,15,30
11427,11204,2,2,5,9
11427,11205,0,1,4,5
11427,11206,6,3,5,14
11427,11207,9,8,25,42
11427,11208,7,19,25,51
11427,11209,1,5,6,12
11427,11210,4,3,4,11
11427,11211,2,3,3,8
11427,11212,4,10,19,33
11427,11213,5,1,8,14
11427,11214,2,5,6,13
11427,11215,0,1,2,3
11427,11216,1,4,5,10
11427,11217,2,1,2,5
11427,11218,3,2,6,11
11427,11219,3,2,5,10
11427,11220,4,2,5,11
11427,11221,6,4,5,15
11427,11222,3,1,2,6
11427,11223,2,3,7,12
11427,11224,3,2,3,8
11427,11225,2,4,5,11
11427,11226,1,4,8,13
11427,11228,3,0,2,5
11427,11229,2,2,10,14
11427,11230,3,2,12,17
11427,11231,1,1,3,5
11427,11232,0,1,2,3
11427,11233,4,4,5,13
11427,11234,8,7,16,31
11427,11235,1,5,2,8
11427,11236,7,10,24,41
11427,11237,1,1,3,5
11427,11238,1,1,6,8
11427,11239,1,2,4,7
11427,11354,4,13,15,32
11427,11355,23,20,18,61
11427,11356,5,10,3,18
11427,11357,8,8,16,32
11427,11358,12,6,22,40
11427,11360,6,4,8,18
11427,11361,8,8,15,31
11427,11362,8,7,19,34
11427,11363,2,0,6,8
11427,11364,20,17,28,65
11427,11365,12,6,29,47
11427,11366,3,3,7,13
11427,11367,7,15,19,41
11427,11368,11,23,19,53
11427,11369,4,15,6,25
11427,11370,7,5,3,15
11427,11371,1,0,0,1
11427,11372,6,5,7,18
11427,11373,17,13,20,50
11427,11374,6,15,10,31
11427,11375,11,10,32,53
11427,11377,17,8,13,38
11427,11378,7,8,13,28
11427,11379,3,11,17,31
11427,11385,17,11,27,55
11427,11411,6,16,19,41
11427,11412,12,29,35,76
11427,11413,10,30,20,60
11427,11414,4,6,6,16
11427,11415,8,7,14,29
11427,11416,4,12,12,28
11427,11417,1,7,14,22
11427,11418,9,10,19,38
11427,11419,13,22,27,62
11427,11420,7,27,21,55
11427,11421,9,7,16,32
11427,11422,8,13,21,42
11427,11423,21,32,33,86
11427,11426,30,25,24,79
11427,11427,37,70,47,154
11427,11428,12,33,26,71
11427,11429,10,15,21,46
11427,11430,1,2,1,4
11427,11432,27,44,23,94
11427,11433,17,15,19,51
11427,11434,14,26,32,72
11427,11435,14,15,19,48
11427,11436,4,11,11,26
11427,11691,8,9,8,25
11427,11692,3,4,6,13
11427,11693,2,1,5,8
11427,11694,7,2,9,18
11427,11697,0,1,3,4
11428,10001,0,0,1,1
11428,10002,1,3,1,5
11428,10003,0,0,3,3
11428,10005,0,0,1,1
11428,10009,0,2,2,4
11428,10010,0,0,2,2
11428,10011,1,0,2,3
11428,10013,1,0,3,4
11428,10014,0,0,2,2
11428,10019,1,0,1,2
11428,10023,0,0,1,1
11428,10025,0,0,5,5
11428,10026,1,1,2,4
11428,10027,1,2,2,5
11428,10028,0,0,1,1
11428,10029,2,4,5,11
11428,10031,0,3,2,5
11428,10032,1,1,4,6
11428,10033,3,3,3,9
11428,10034,2,2,1,5
11428,10035,0,1,1,2
11428,10036,0,0,1,1
11428,10037,0,0,2,2
11428,10038,0,0,2,2
11428,10039,1,5,1,7
11428,10040,1,1,0,2
11428,10128,0,1,3,4
11428,10280,0,0,1,1
11428,10301,1,1,4,6
11428,10302,1,1,3,5
11428,10303,1,0,4,5
11428,10304,0,1,3,4
11428,10305,1,1,1,3
11428,10306,1,3,5,9
11428,10307,0,0,2,2
11428,10308,1,1,1,3
11428,10309,0,0,2,2
11428,10310,0,3,3,6
11428,10312,1,1,6,8
11428,10314,0,5,6,11
11428,10451,2,3,0,5
11428,10452,2,6,1,9
11428,10453,6,7,3,16
11428,10454,0,5,0,5
11428,10455,0,3,0,3
11428,10456,3,2,3,8
11428,10457,2,4,2,8
11428,10458,5,3,5,13
11428,10459,2,3,2,7
11428,10460,1,5,3,9
11428,10461,1,1,10,12
11428,10462,3,4,6,13
11428,10463,1,5,5,11
11428,10464,0,2,0,2
11428,10465,0,1,11,12
11428,10466,1,2,0,3
11428,10467,0,5,5,10
11428,10468,4,5,4,13
11428,10469,0,2,2,4
11428,10470,0,3,0,3
11428,10471,2,0,5,7
11428,10472,2,5,4,11
11428,10473,3,2,5,10
11428,10474,0,0,1,1
11428,10475,0,3,4,7
11428,11001,1,1,1,3
11428,11003,0,0,1,1
11428,11004,4,6,6,16
11428,11040,0,0,1,1
11428,11101,3,3,4,10
11428,11102,0,0,2,2
11428,11103,0,2,4,6
11428,11104,2,1,3,6
11428,11105,0,1,3,4
11428,11106,1,2,0,3
11428,11201,0,2,1,3
11428,11203,5,4,4,13
11428,11204,0,3,3,6
11428,11205,0,1,5,6
11428,11206,0,3,6,9
11428,11207,8,10,9,27
11428,11208,5,19,10,34
11428,11209,1,5,4,10
11428,11210,4,6,2,12
11428,11211,0,0,4,4
11428,11212,5,9,6,20
11428,11213,2,1,2,5
11428,11214,1,4,6,11
11428,11215,1,1,3,5
11428,11216,0,2,3,5
11428,11217,0,0,1,1
11428,11218,3,5,4,12
11428,11219,3,1,0,4
11428,11220,3,0,4,7
11428,11221,1,1,2,4
11428,11223,4,1,1,6
11428,11224,0,3,3,6
11428,11225,3,7,3,13
11428,11226,8,8,3,19
11428,11228,1,1,5,7
11428,11229,3,3,2,8
11428,11230,2,4,1,7
11428,11231,0,0,1,1
11428,11232,0,0,5,5
11428,11233,3,6,1,10
11428,11234,7,18,16,41
11428,11235,2,4,3,9
11428,11236,15,13,17,45
11428,11237,1,2,2,5
11428,11238,0,0,2,2
11428,11239,0,1,5,6
11428,11354,5,3,5,13
11428,11355,7,8,7,22
11428,11356,1,2,5,8
11428,11357,2,5,7,14
11428,11358,8,5,13,26
11428,11360,3,4,3,10
11428,11361,2,7,13,22
11428,11362,0,4,7,11
11428,11363,0,2,1,3
11428,11364,2,11,16,29
11428,11365,3,5,13,21
11428,11366,3,0,6,9
11428,11367,2,2,9,13
11428,11368,13,9,9,31
11428,11369,1,4,10,15
11428,11370,2,0,1,3
11428,11372,7,10,4,21
11428,11373,6,8,6,20
11428,11374,6,5,5,16
11428,11375,0,5,11,16
11428,11377,4,6,13,23
11428,11378,2,4,9,15
11428,11379,2,7,10,19
11428,11385,5,10,18,33
11428,11411,14,15,9,38
11428,11412,5,16,24,45
11428,11413,5,24,19,48
11428,11414,3,1,10,14
11428,11415,3,1,6,10
11428,11416,2,8,8,18
11428,11417,2,9,10,21
11428,11418,5,6,14,25
11428,11419,7,10,6,23
11428,11420,9,17,14,40
11428,11421,4,9,3,16
11428,11422,8,13,8,29
11428,11423,18,22,9,49
11428,11426,8,15,11,34
11428,11427,12,33,10,55
11428,11428,35,57,30,122
11428,11429,39,44,10,93
11428,11432,21,16,5,42
11428,11433,4,23,5,32
11428,11434,16,26,23,65
11428,11435,13,15,17,45
11428,11436,6,3,5,14
11428,11451,0,0,1,1
11428,11691,1,4,9,14
11428,11692,0,5,10,15
11428,11693,1,2,5,8
11428,11694,0,3,6,9
11428,11697,0,0,1,1
11429,10002,1,5,0,6
11429,10003,1,2,3,6
11429,10009,1,3,3,7
11429,10010,0,0,1,1
11429,10013,0,1,0,1
11429,10014,0,1,0,1
11429,10017,0,0,1,1
11429,10023,0,0,1,1
11429,10024,0,0,1,1
11429,10025,0,0,1,1
11429,10026,0,5,0,5
11429,10027,1,1,5,7
11429,10029,0,1,2,3
11429,10031,1,3,0,4
11429,10032,0,3,4,7
11429,10033,1,1,1,3
11429,10034,0,1,0,1
11429,10035,0,1,1,2
11429,10036,0,0,1,1
11429,10039,1,1,2,4
11429,10040,1,0,1,2
11429,10065,0,0,1,1
11429,10075,1,0,1,2
11429,10128,0,0,1,1
11429,10301,3,0,2,5
11429,10302,1,2,1,4
11429,10303,0,3,2,5
11429,10304,1,1,0,2
11429,10305,0,1,0,1
11429,10306,0,2,2,4
11429,10307,0,0,1,1
11429,10308,2,2,3,7
11429,10309,0,1,3,4
11429,10310,1,0,1,2
11429,10312,1,0,3,4
11429,10314,1,3,2,6
11429,10451,1,0,0,1
11429,10452,5,4,3,12
11429,10453,2,7,0,9
11429,10454,2,2,2,6
11429,10455,3,3,1,7
11429,10456,4,4,5,13
11429,10457,2,5,3,10
11429,10458,1,8,3,12
11429,10459,4,5,1,10
11429,10460,0,1,0,1
11429,10461,2,4,3,9
11429,10462,1,7,1,9
11429,10463,1,1,1,3
11429,10464,0,2,2,4
11429,10465,3,6,1,10
11429,10466,0,2,1,3
11429,10467,0,5,2,7
11429,10468,2,3,3,8
11429,10469,0,4,5,9
11429,10470,1,1,0,2
11429,10471,1,0,0,1
11429,10472,0,4,2,6
11429,10473,0,2,5,7
11429,10474,2,1,0,3
11429,10475,1,7,5,13
11429,11001,1,0,7,8
11429,11003,0,1,0,1
11429,11004,2,1,2,5
11429,11040,1,0,1,2
11429,11101,6,0,2,8
11429,11102,1,0,0,1
11429,11103,4,1,3,8
11429,11104,0,1,4,5
11429,11105,1,2,2,5
11429,11106,0,2,1,3
11429,11201,2,1,1,4
11429,11203,5,3,4,12
11429,11204,1,2,3,6
11429,11206,2,2,2,6
11429,11207,5,19,15,39
11429,11208,8,18,12,38
11429,11209,0,1,3,4
11429,11210,3,6,3,12
11429,11211,1,1,1,3
11429,11212,14,20,4,38
11429,11213,1,7,7,15
11429,11214,0,1,1,2
11429,11215,1,2,0,3
11429,11216,1,1,4,6
11429,11217,0,0,2,2
11429,11218,1,1,0,2
11429,11219,1,2,2,5
11429,11220,1,9,1,11
11429,11221,1,3,2,6
11429,11222,0,0,3,3
11429,11223,3,1,1,5
11429,11224,0,2,1,3
11429,11225,3,4,4,11
11429,11226,5,5,2,12
11429,11228,0,2,1,3
11429,11229,0,1,4,5
11429,11230,1,0,3,4
11429,11231,1,0,1,2
11429,11232,0,1,0,1
11429,11233,0,7,2,9
11429,11234,10,10,16,36
11429,11235,0,1,2,3
11429,11236,10,18,16,44
11429,11237,1,1,1,3
11429,11238,0,3,3,6
11429,11239,2,2,0,4
11429,11354,5,2,9,16
11429,11355,11,8,6,25
11429,11356,0,7,3,10
11429,11357,2,6,14,22
11429,11358,1,7,8,16
11429,11360,1,2,4,7
11429,11361,3,3,5,11
11429,11362,1,3,3,7
11429,11364,1,3,11,15
11429,11365,5,3,5,13
11429,11366,2,2,0,4
11429,11367,3,6,3,12
11429,11368,2,15,11,28
11429,11369,2,8,7,17
11429,11370,4,2,2,8
11429,11371,0,1,0,1
11429,11372,3,6,3,12
11429,11373,2,13,7,22
11429,11374,4,5,9,18
11429,11375,2,3,8,13
11429,11377,6,10,9,25
11429,11378,4,7,9,20
11429,11379,3,3,8,14
11429,11385,5,9,12,26
11429,11411,6,13,8,27
11429,11412,16,25,20,61
11429,11413,8,27,13,48
11429,11414,0,2,5,7
11429,11415,1,0,3,4
11429,11416,0,2,7,9
11429,11417,2,9,7,18
11429,11418,7,7,6,20
11429,11419,5,14,12,31
11429,11420,6,15,14,35
11429,11421,2,15,7,24
11429,11422,2,14,13,29
11429,11423,11,23,10,44
11429,11426,3,7,13,23
11429,11427,6,13,10,29
11429,11428,10,40,5,55
11429,11429,41,67,26,134
11429,11432,18,13,16,47
11429,11433,6,15,13,34
11429,11434,15,20,21,56
11429,11435,4,17,25,46
11429,11436,2,15,9,26
11429,11451,0,0,1,1
11429,11691,2,9,7,18
11429,11692,0,2,2,4
11429,11693,0,3,6,9
11429,11694,1,3,4,8
11430,10001,6,2,6,14
11430,10002,11,17,17,45
11430,10003,2,7,10,19
11430,10004,0,0,1,1
11430,10005,0,1,2,3
11430,10006,0,0,2,2
11430,10007,0,1,1,2
11430,10009,2,15,18,35
11430,10010,0,3,14,17
11430,10011,9,7,32,48
11430,10012,0,3,6,9
11430,10013,1,6,7,14
11430,10014,2,7,5,14
11430,10016,3,7,10,20
11430,10017,1,2,4,7
11430,10018,0,0,4,4
11430,10019,6,11,30,47
11430,10021,0,3,14,17
11430,10022,0,1,13,14
11430,10023,0,4,10,14
11430,10024,0,6,11,17
11430,10025,4,9,16,29
11430,10026,4,15,13,32
11430,10027,6,18,12,36
11430,10028,0,3,16,19
11430,10029,11,36,22,69
11430,10030,7,17,8,32
11430,10031,7,21,14,42
11430,10032,3,22,15,40
11430,10033,2,15,19,36
11430,10034,4,10,10,24
11430,10035,9,8,16,33
11430,10036,4,6,7,17
11430,10037,2,5,6,13
11430,10038,0,3,15,18
11430,10039,3,10,12,25
11430,10040,0,11,14,25
11430,10044,1,0,3,4
11430,10065,1,2,13,16
11430,10069,1,0,1,2
11430,10075,0,3,9,12
11430,10128,2,12,14,28
11430,10162,0,0,1,1
11430,10280,0,2,6,8
11430,10282,0,1,0,1
11430,10301,4,13,19,36
11430,10302,1,3,9,13
11430,10303,4,7,9,20
11430,10304,5,6,18,29
11430,10305,7,9,26,42
11430,10306,4,8,26,38
11430,10307,0,4,2,6
11430,10308,1,0,5,6
11430,10309,2,3,12,17
11430,10310,2,2,7,11
11430,10312,4,4,18,26
11430,10314,1,11,47,59
11430,10451,10,19,6,35
11430,10452,9,37,15,61
11430,10453,13,45,12,70
11430,10454,5,7,9,21
11430,10455,2,13,9,24
11430,10456,11,35,14,60
11430,10457,10,37,18,65
11430,10458,12,31,14,57
11430,10459,5,18,6,29
11430,10460,5,16,9,30
11430,10461,2,26,25,53
11430,10462,12,36,23,71
11430,10463,5,19,17,41
11430,10464,1,0,4,5
11430,10465,11,10,24,45
11430,10466,5,22,22,49
11430,10467,12,26,27,65
11430,10468,6,22,16,44
11430,10469,8,33,26,67
11430,10470,2,12,4,18
11430,10471,1,5,12,18
11430,10472,10,33,16,59
11430,10473,10,29,21,60
11430,10474,3,5,2,10
11430,10475,3,17,9,29
11430,11001,0,3,6,9
11430,11004,3,10,22,35
11430,11005,0,1,3,4
11430,11040,0,1,3,4
11430,11101,8,29,35,72
11430,11102,17,37,28,82
11430,11103,8,25,44,77
11430,11104,12,29,40,81
11430,11105,7,18,59,84
11430,11106,14,43,45,102
11430,11109,0,3,12,15
11430,11201,11,15,23,49
11430,11203,52,276,128,456
11430,11204,10,17,22,49
11430,11205,6,23,36,65
11430,11206,22,76,65,163
11430,11207,120,392,130,642
11430,11208,106,468,144,718
11430,11209,8,16,28,52
11430,11210,28,108,74,210
11430,11211,16,34,29,79
11430,11212,82,282,92,456
11430,11213,27,112,74,213
11430,11214,12,49,48,109
11430,11215,7,9,24,40
11430,11216,31,98,46,175
11430,11217,6,19,22,47
11430,11218,22,38,45,105
11430,11219,9,10,18,37
11430,11220,13,37,22,72
11430,11221,34,106,61,201
11430,11222,8,20,28,56
11430,11223,12,30,36,78
11430,11224,11,24,20,55
11430,11225,30,118,41,189
11430,11226,69,208,89,366
11430,11228,5,13,22,40
11430,11229,20,36,40,96
11430,11230,11,34,48,93
11430,11231,3,15,18,36
11430,11232,6,12,16,34
11430,11233,56,140,85,281
11430,11234,39,129,99,267
11430,11235,15,29,68,112
11430,11236,95,314,153,562
11430,11237,9,40,39,88
11430,11238,8,31,48,87
11430,11239,18,31,27,76
11430,11354,15,35,47,97
11430,11355,16,58,69,143
11430,11356,2,18,40,60
11430,11357,8,32,63,103
11430,11358,12,18,62,92
11430,11359,0,2,0,2
11430,11360,6,11,26,43
11430,11361,9,25,43,77
11430,11362,4,11,46,61
11430,11363,1,4,7,12
11430,11364,4,38,55,97
11430,11365,20,61,52,133
11430,11366,6,18,10,34
11430,11367,11,46,52,109
11430,11368,41,187,104,332
11430,11369,21,114,80,215
11430,11370,7,29,42,78
11430,11372,25,76,73,174
11430,11373,40,135,75,250
11430,11374,17,42,79,138
11430,11375,16,39,99,154
11430,11377,24,96,84,204
11430,11378,10,37,48,95
11430,11379,16,41,77,134
11430,11385,32,116,145,293
11430,11411,24,92,56,172
11430,11412,83,254,110,447
11430,11413,71,229,132,432
11430,11414,14,31,95,140
11430,11415,14,68,117,199
11430,11416,29,147,86,262
11430,11417,49,133,105,287
11430,11418,62,242,111,415
11430,11419,110,456,165,731
11430,11420,110,472,218,800
11430,11421,36,158,102,296
11430,11422,67,161,110,338
11430,11423,30,149,98,277
11430,11426,7,17,34,58
11430,11427,21,67,47,135
11430,11428,20,83,37,140
11430,11429,34,145,58,237
11430,11432,88,233,104,425
11430,11433,61,223,81,365
11430,11434,129,338,183,650
11430,11435,70,280,151,501
11430,11436,44,138,75,257
11430,11691,54,147,71,272
11430,11692,23,72,29,124
11430,11693,19,30,29,78
11430,11694,3,32,36,71
11430,11697,2,3,5,10
11432,10001,0,2,5,7
11432,10002,6,15,19,40
11432,10003,2,6,21,29
11432,10004,0,1,0,1
11432,10005,1,0,1,2
11432,10006,0,0,2,2
11432,10007,1,1,8,10
11432,10009,5,7,15,27
11432,10010,2,0,12,14
11432,10011,3,3,13,19
11432,10012,1,0,4,5
11432,10013,4,0,8,12
11432,10014,0,1,7,8
11432,10016,5,5,25,35
11432,10017,0,2,11,13
11432,10018,0,1,4,5
11432,10019,4,0,17,21
11432,10021,5,2,20,27
11432,10022,3,2,13,18
11432,10023,8,4,17,29
11432,10024,2,7,17,26
11432,10025,8,8,38,54
11432,10026,4,9,21,34
11432,10027,8,9,25,42
11432,10028,5,2,9,16
11432,10029,14,14,31,59
11432,10030,10,9,13,32
11432,10031,11,16,25,52
11432,10032,7,8,21,36
11432,10033,4,9,20,33
11432,10034,8,5,8,21
11432,10035,6,10,17,33
11432,10036,2,1,10,13
11432,10037,0,1,8,9
11432,10038,1,2,7,10
11432,10039,7,6,17,30
11432,10040,5,5,12,22
11432,10044,4,1,3,8
11432,10065,3,1,13,17
11432,10069,1,0,0,1
11432,10075,0,3,11,14
11432,10128,7,5,28,40
11432,10280,1,0,3,4
11432,10282,0,1,0,1
11432,10301,12,10,16,38
11432,10302,3,3,7,13
11432,10303,3,11,12,26
11432,10304,5,5,15,25
11432,10305,11,7,21,39
11432,10306,5,10,28,43
11432,10307,1,1,9,11
11432,10308,2,3,9,14
11432,10309,8,3,13,24
11432,10310,2,8,10,20
11432,10312,9,9,20,38
11432,10314,18,17,37,72
11432,10451,8,13,16,37
11432,10452,14,22,30,66
11432,10453,11,29,14,54
11432,10454,8,7,12,27
11432,10455,7,11,15,33
11432,10456,9,26,25,60
11432,10457,7,18,16,41
11432,10458,13,27,16,56
11432,10459,5,14,14,33
11432,10460,6,19,20,45
11432,10461,6,14,28,48
11432,10462,15,23,42,80
11432,10463,7,12,25,44
11432,10464,2,1,4,7
11432,10465,2,6,34,42
11432,10466,13,26,40,79
11432,10467,20,25,56,101
11432,10468,13,21,22,56
11432,10469,14,22,28,64
11432,10470,2,3,7,12
11432,10471,1,7,13,21
11432,10472,16,28,25,69
11432,10473,6,25,27,58
11432,10474,2,2,2,6
11432,10475,9,22,40,71
11432,11001,2,3,19,24
11432,11003,0,1,0,1
11432,11004,14,18,45,77
11432,11005,0,3,2,5
11432,11040,2,3,8,13
11432,11101,10,12,22,44
11432,11102,22,14,34,70
11432,11103,15,24,24,63
11432,11104,8,12,29,49
11432,11105,11,8,25,44
11432,11106,10,16,21,47
11432,11109,0,1,6,7
11432,11201,5,9,21,35
11432,11203,28,34,54,116
11432,11204,13,8,14,35
11432,11205,6,15,26,47
11432,11206,18,32,34,84
11432,11207,43,67,77,187
11432,11208,66,104,108,278
11432,11209,10,10,40,60
11432,11210,15,31,46,92
11432,11211,9,11,23,43
11432,11212,29,49,77,155
11432,11213,23,21,30,74
11432,11214,9,11,32,52
11432,11215,11,11,33,55
11432,11216,23,21,16,60
11432,11217,3,5,16,24
11432,11218,9,21,29,59
11432,11219,14,7,5,26
11432,11220,13,14,29,56
11432,11221,17,35,42,94
11432,11222,0,3,7,10
11432,11223,9,15,27,51
11432,11224,4,9,22,35
11432,11225,9,22,49,80
11432,11226,25,38,66,129
11432,11228,5,5,16,26
11432,11229,9,13,33,55
11432,11230,7,8,29,44
11432,11231,3,7,17,27
11432,11232,5,8,5,18
11432,11233,26,32,37,95
11432,11234,24,53,86,163
11432,11235,6,16,45,67
11432,11236,44,65,109,218
11432,11237,5,11,18,34
11432,11238,10,18,33,61
11432,11239,5,10,17,32
11432,11354,26,42,49,117
11432,11355,87,61,70,218
11432,11356,9,21,19,49
11432,11357,29,37,69,135
11432,11358,43,41,59,143
11432,11360,24,12,53,89
11432,11361,23,35,70,128
11432,11362,12,12,64,88
11432,11363,9,5,7,21
11432,11364,27,40,88,155
11432,11365,46,66,88,200
11432,11366,21,32,74,127
11432,11367,38,74,106,218
11432,11368,68,76,70,214
11432,11369,29,45,44,118
11432,11370,19,28,24,71
11432,11371,0,2,2,4
11432,11372,41,44,73,158
11432,11373,72,80,90,242
11432,11374,30,32,93,155
11432,11375,50,57,176,283
11432,11377,62,80,77,219
11432,11378,18,23,40,81
11432,11379,18,33,74,125
11432,11385,52,61,137,250
11432,11411,29,75,70,174
11432,11412,69,116,133,318
11432,11413,60,104,123,287
11432,11414,12,31,57,100
11432,11415,11,25,61,97
11432,11416,32,42,42,116
11432,11417,26,41,53,120
11432,11418,67,48,81,196
11432,11419,70,96,69,235
11432,11420,57,112,82,251
11432,11421,32,54,69,155
11432,11422,32,80,73,185
11432,11423,91,157,115,363
11432,11426,33,31,64,128
11432,11427,73,65,101,239
11432,11428,54,64,62,180
11432,11429,45,86,59,190
11432,11430,2,0,1,3
11432,11432,449,542,260,1251
11432,11433,79,143,89,311
11432,11434,115,189,173,477
11432,11435,121,192,127,440
11432,11436,45,66,40,151
11432,11691,47,54,67,168
11432,11692,24,31,17,72
11432,11693,5,10,20,35
11432,11694,11,9,46,66
11432,11697,9,0,10,19
11433,10001,0,1,1,2
11433,10002,1,1,1,3
11433,10003,0,0,1,1
11433,10007,1,0,0,1
11433,10009,1,4,3,8
11433,10011,0,1,0,1
11433,10012,0,0,2,2
11433,10013,0,1,1,2
11433,10014,1,1,0,2
11433,10016,0,0,2,2
11433,10019,1,0,2,3
11433,10021,0,0,3,3
11433,10022,0,0,2,2
11433,10023,1,1,1,3
11433,10024,0,1,4,5
11433,10025,0,2,3,5
11433,10026,2,2,3,7
11433,10027,3,5,2,10
11433,10028,0,0,6,6
11433,10029,3,5,2,10
11433,10030,0,2,1,3
11433,10031,4,3,5,12
11433,10032,3,4,9,16
11433,10033,1,5,3,9
11433,10034,1,8,4,13
11433,10035,2,2,4,8
11433,10036,1,2,0,3
11433,10037,0,3,0,3
11433,10038,0,0,1,1
11433,10039,1,5,1,7
11433,10040,0,7,3,10
11433,10065,1,0,0,1
11433,10075,0,0,2,2
11433,10128,0,1,6,7
11433,10301,1,6,6,13
11433,10302,1,0,3,4
11433,10303,0,1,3,4
11433,10304,4,5,8,17
11433,10305,2,4,3,9
11433,10306,2,1,10,13
11433,10307,0,0,2,2
11433,10308,1,2,7,10
11433,10309,1,1,5,7
11433,10310,1,0,6,7
11433,10312,2,1,7,10
11433,10314,3,4,10,17
11433,10451,2,4,5,11
11433,10452,2,11,6,19
11433,10453,3,12,6,21
11433,10454,4,5,2,11
11433,10455,5,1,4,10
11433,10456,2,9,6,17
11433,10457,2,4,6,12
11433,10458,8,10,4,22
11433,10459,2,3,6,11
11433,10460,1,4,7,12
11433,10461,1,7,4,12
11433,10462,2,8,8,18
11433,10463,3,4,2,9
11433,10464,1,1,2,4
11433,10465,3,3,9,15
11433,10466,9,5,7,21
11433,10467,4,10,10,24
11433,10468,3,5,4,12
11433,10469,5,7,10,22
11433,10470,2,2,2,6
11433,10471,1,2,1,4
11433,10472,4,5,9,18
11433,10473,5,10,7,22
11433,10475,3,6,7,16
11433,11001,0,0,6,6
11433,11004,2,8,6,16
11433,11005,2,1,0,3
11433,11040,0,0,2,2
11433,11101,1,2,5,8
11433,11102,0,1,5,6
11433,11103,1,1,4,6
11433,11104,0,4,10,14
11433,11105,4,4,4,12
11433,11106,4,6,1,11
11433,11201,2,4,6,12
11433,11203,5,13,10,28
11433,11204,2,2,4,8
11433,11205,3,7,8,18
11433,11206,4,9,10,23
11433,11207,16,34,19,69
11433,11208,9,36,39,84
11433,11209,2,6,8,16
11433,11210,5,6,12,23
11433,11211,10,5,7,22
11433,11212,15,29,14,58
11433,11213,3,5,8,16
11433,11214,1,5,2,8
11433,11215,1,1,10,12
11433,11216,2,10,4,16
11433,11217,2,2,3,7
11433,11218,0,0,3,3
11433,11219,2,3,3,8
11433,11220,1,2,6,9
11433,11221,7,9,18,34
11433,11222,1,3,6,10
11433,11223,2,3,2,7
11433,11224,4,6,4,14
11433,11225,4,9,3,16
11433,11226,11,10,13,34
11433,11228,1,3,1,5
11433,11229,2,5,2,9
11433,11230,4,1,5,10
11433,11231,1,2,2,5
11433,11232,0,1,1,2
11433,11233,3,15,15,33
11433,11234,15,30,43,88
11433,11235,1,3,8,12
11433,11236,17,28,29,74
11433,11237,7,5,11,23
11433,11238,4,5,11,20
11433,11239,2,6,3,11
11433,11354,2,16,12,30
11433,11355,13,29,10,52
11433,11356,2,10,4,16
11433,11357,6,4,5,15
11433,11358,2,15,22,39
11433,11359,2,0,1,3
11433,11360,2,4,10,16
11433,11361,2,7,15,24
11433,11362,2,6,6,14
11433,11363,0,1,1,2
11433,11364,1,9,9,19
11433,11365,6,7,14,27
11433,11366,4,2,11,17
11433,11367,6,16,8,30
11433,11368,22,24,38,84
11433,11369,5,14,9,28
11433,11370,0,8,11,19
11433,11372,10,13,11,34
11433,11373,12,14,18,44
11433,11374,6,5,11,22
11433,11375,9,14,15,38
11433,11377,8,17,14,39
11433,11378,6,12,15,33
11433,11379,8,13,18,39
11433,11385,18,23,33,74
11433,11411,12,17,18,47
11433,11412,27,22,29,78
11433,11413,21,32,29,82
11433,11414,5,9,8,22
11433,11415,8,7,4,19
11433,11416,4,13,10,27
11433,11417,10,23,22,55
11433,11418,16,27,23,66
11433,11419,11,35,24,70
11433,11420,30,23,30,83
11433,11421,8,19,26,53
11433,11422,15,14,14,43
11433,11423,19,41,22,82
11433,11426,5,4,8,17
11433,11427,6,13,5,24
11433,11428,19,15,17,51
11433,11429,8,17,11,36
11433,11432,44,62,36,142
11433,11433,78,87,42,207
11433,11434,41,66,54,161
11433,11435,36,61,34,131
11433,11436,12,23,18,53
11433,11451,0,1,0,1
11433,11691,15,19,14,48
11433,11692,8,7,3,18
11433,11693,0,4,3,7
11433,11694,4,4,5,13
11433,11697,0,2,1,3
11434,10001,0,1,1,2
11434,10002,13,12,6,31
11434,10003,2,1,5,8
11434,10005,0,0,1,1
11434,10007,0,0,1,1
11434,10009,5,5,10,20
11434,10010,0,1,3,4
11434,10011,0,3,8,11
11434,10012,1,1,3,5
11434,10013,3,1,3,7
11434,10014,1,0,3,4
11434,10016,1,2,5,8
11434,10017,1,0,3,4
11434,10018,0,0,2,2
11434,10019,0,0,8,8
11434,10021,0,0,6,6
11434,10022,0,1,1,2
11434,10023,1,1,6,8
11434,10024,0,1,7,8
11434,10025,5,5,12,22
11434,10026,2,5,8,15
11434,10027,2,8,17,27
11434,10028,0,1,3,4
11434,10029,4,7,16,27
11434,10030,0,6,6,12
11434,10031,4,4,10,18
11434,10032,4,7,4,15
11434,10033,3,6,6,15
11434,10034,0,5,3,8
11434,10035,2,2,6,10
11434,10036,0,0,1,1
11434,10037,0,3,4,7
11434,10038,1,0,3,4
11434,10039,3,1,2,6
11434,10040,0,3,4,7
11434,10044,0,0,1,1
11434,10065,0,0,4,4
11434,10069,0,1,0,1
11434,10075,0,0,2,2
11434,10128,0,5,8,13
11434,10280,0,1,1,2
11434,10282,2,0,0,2
11434,10301,2,5,11,18
11434,10302,2,5,5,12
11434,10303,2,3,7,12
11434,10304,3,2,12,17
11434,10305,1,7,13,21
11434,10306,5,5,22,32
11434,10307,1,0,5,6
11434,10308,1,1,11,13
11434,10309,0,2,12,14
11434,10310,2,6,10,18
11434,10312,0,7,27,34
11434,10314,5,9,37,51
11434,10451,6,7,9,22
11434,10452,2,13,10,25
11434,10453,3,13,9,25
11434,10454,2,4,4,10
11434,10455,4,5,6,15
11434,10456,3,10,14,27
11434,10457,5,8,7,20
11434,10458,3,5,14,22
11434,10459,4,7,4,15
11434,10460,5,9,18,32
11434,10461,2,10,16,28
11434,10462,5,11,20,36
11434,10463,2,7,16,25
11434,10464,0,0,3,3
11434,10465,1,4,14,19
11434,10466,7,16,21,44
11434,10467,4,13,19,36
11434,10468,2,8,13,23
11434,10469,7,7,19,33
11434,10470,2,2,4,8
11434,10471,0,3,6,9
11434,10472,8,20,18,46
11434,10473,2,10,11,23
11434,10474,1,1,1,3
11434,10475,5,10,17,32
11434,11001,2,3,8,13
11434,11004,7,8,17,32
11434,11005,0,6,1,7
11434,11040,1,1,1,3
11434,11101,1,10,9,20
11434,11102,2,10,12,24
11434,11103,0,9,12,21
11434,11104,8,7,13,28
11434,11105,4,5,10,19
11434,11106,0,7,15,22
11434,11109,1,0,1,2
11434,11201,1,8,19,28
11434,11203,20,74,65,159
11434,11204,4,15,22,41
11434,11205,7,11,9,27
11434,11206,7,33,27,67
11434,11207,30,91,85,206
11434,11208,30,134,80,244
11434,11209,4,6,18,28
11434,11210,9,37,46,92
11434,11211,2,6,23,31
11434,11212,22,74,72,168
11434,11213,16,37,27,80
11434,11214,13,22,43,78
11434,11215,3,4,15,22
11434,11216,11,25,18,54
11434,11217,0,8,11,19
11434,11218,4,11,13,28
11434,11219,8,7,20,35
11434,11220,14,25,14,53
11434,11221,16,30,25,71
11434,11222,2,1,9,12
11434,11223,6,21,25,52
11434,11224,5,7,11,23
11434,11225,3,22,19,44
11434,11226,15,51,46,112
11434,11228,2,7,15,24
11434,11229,10,10,45,65
11434,11230,5,18,25,48
11434,11231,1,4,5,10
11434,11232,1,4,6,11
11434,11233,19,55,27,101
11434,11234,30,61,100,191
11434,11235,12,22,23,57
11434,11236,49,95,117,261
11434,11237,2,10,16,28
11434,11238,11,16,14,41
11434,11239,4,8,22,34
11434,11354,22,44,44,110
11434,11355,57,71,61,189
11434,11356,8,17,22,47
11434,11357,14,27,48,89
11434,11358,21,23,53,97
11434,11359,2,0,1,3
11434,11360,7,7,16,30
11434,11361,21,32,35,88
11434,11362,13,17,31,61
11434,11363,0,5,4,9
11434,11364,16,34,46,96
11434,11365,21,44,41,106
11434,11366,6,5,15,26
11434,11367,17,32,51,100
11434,11368,38,61,43,142
11434,11369,6,25,24,55
11434,11370,0,15,9,24
11434,11371,0,1,0,1
11434,11372,10,26,17,53
11434,11373,20,40,31,91
11434,11374,12,20,35,67
11434,11375,21,28,77,126
11434,11377,18,28,37,83
11434,11378,9,20,41,70
11434,11379,11,27,52,90
11434,11385,25,43,84,152
11434,11411,27,51,64,142
11434,11412,49,153,113,315
11434,11413,72,137,132,341
11434,11414,9,24,60,93
11434,11415,6,29,18,53
11434,11416,20,47,39,106
11434,11417,18,59,55,132
11434,11418,18,67,32,117
11434,11419,48,159,96,303
11434,11420,53,172,111,336
11434,11421,28,60,47,135
11434,11422,36,91,115,242
11434,11423,28,76,58,162
11434,11426,3,14,20,37
11434,11427,8,30,40,78
11434,11428,16,30,43,89
11434,11429,39,62,65,166
11434,11430,0,2,2,4
11434,11432,42,106,56,204
11434,11433,63,109,100,272
11434,11434,168,325,247,740
11434,11435,50,147,92,289
11434,11436,33,74,57,164
11434,11691,32,93,92,217
11434,11692,9,28,32,69
11434,11693,3,18,26,47
11434,11694,3,15,27,45
11434,11697,0,4,4,8
11435,10001,1,0,1,2
11435,10002,3,10,6,19
11435,10003,0,0,2,2
11435,10004,0,1,0,1
11435,10005,0,0,1,1
11435,10007,0,1,1,2
11435,10009,3,4,5,12
11435,10010,0,1,2,3
11435,10011,1,0,2,3
11435,10012,0,1,4,5
11435,10013,1,1,2,4
11435,10014,0,0,2,2
11435,10016,0,1,6,7
11435,10019,0,6,1,7
11435,10021,1,0,2,3
11435,10022,1,0,6,7
11435,10023,0,3,4,7
11435,10024,1,2,5,8
11435,10025,3,4,2,9
11435,10026,2,5,1,8
11435,10027,3,3,7,13
11435,10028,0,0,4,4
11435,10029,1,6,8,15
11435,10030,1,2,6,9
11435,10031,3,4,8,15
11435,10032,1,3,6,10
11435,10033,0,1,3,4
11435,10034,1,1,4,6
11435,10035,3,4,3,10
11435,10036,1,0,5,6
11435,10037,0,0,2,2
11435,10038,0,1,1,2
11435,10039,2,3,5,10
11435,10040,0,1,4,5
11435,10044,0,2,3,5
11435,10065,0,0,2,2
11435,10075,0,0,5,5
11435,10128,0,1,8,9
11435,10280,1,0,0,1
11435,10301,1,4,1,6
11435,10302,0,2,1,3
11435,10303,1,2,0,3
11435,10304,0,3,6,9
11435,10305,1,0,4,5
11435,10306,0,3,2,5
11435,10307,0,1,0,1
11435,10309,0,2,2,4
11435,10310,1,1,2,4
11435,10312,2,1,8,11
11435,10314,0,6,9,15
11435,10451,4,9,5,18
11435,10452,5,15,5,25
11435,10453,5,12,7,24
11435,10454,3,12,4,19
11435,10455,2,6,1,9
11435,10456,7,22,6,35
11435,10457,4,13,5,22
11435,10458,3,15,3,21
11435,10459,4,11,4,19
11435,10460,8,9,6,23
11435,10461,4,3,7,14
11435,10462,5,11,14,30
11435,10463,0,10,10,20
11435,10464,1,1,0,2
11435,10465,2,4,4,10
11435,10466,4,5,3,12
11435,10467,7,12,17,36
11435,10468,9,21,8,38
11435,10469,3,9,3,15
11435,10470,0,0,4,4
11435,10471,0,4,2,6
11435,10472,9,7,6,22
11435,10473,1,12,7,20
11435,10474,0,2,0,2
11435,10475,4,6,9,19
11435,11001,0,2,2,4
11435,11004,3,11,9,23
11435,11101,3,6,5,14
11435,11102,6,7,12,25
11435,11103,3,6,10,19
11435,11104,11,8,8,27
11435,11105,1,7,9,17
11435,11106,4,9,10,23
11435,11109,0,2,2,4
11435,11201,2,2,6,10
11435,11203,5,20,15,40
11435,11204,3,5,6,14
11435,11205,2,6,6,14
11435,11206,2,9,19,30
11435,11207,29,51,31,111
11435,11208,29,91,29,149
11435,11209,3,7,4,14
11435,11210,5,11,12,28
11435,11211,2,5,6,13
11435,11212,14,44,30,88
11435,11213,7,7,12,26
11435,11214,4,8,4,16
11435,11215,0,3,5,8
11435,11216,4,7,7,18
11435,11217,3,3,4,10
11435,11218,8,8,6,22
11435,11219,6,4,3,13
11435,11220,5,8,3,16
11435,11221,7,31,25,63
11435,11222,1,1,3,5
11435,11223,2,7,5,14
11435,11224,2,4,7,13
11435,11225,4,7,6,17
11435,11226,9,19,14,42
11435,11228,0,4,5,9
11435,11229,7,1,8,16
11435,11230,6,9,10,25
11435,11231,1,1,4,6
11435,11232,2,1,2,5
11435,11233,10,26,17,53
11435,11234,20,42,49,111
11435,11235,1,4,9,14
11435,11236,28,40,32,100
11435,11237,16,20,16,52
11435,11238,2,5,5,12
11435,11239,0,4,9,13
11435,11354,15,18,16,49
11435,11355,19,36,29,84
11435,11356,6,18,7,31
11435,11357,9,13,33,55
11435,11358,15,14,20,49
11435,11359,0,2,0,2
11435,11360,5,10,16,31
11435,11361,7,14,17,38
11435,11362,6,3,14,23
11435,11363,4,0,1,5
11435,11364,3,23,40,66
11435,11365,8,18,29,55
11435,11366,9,10,11,30
11435,11367,13,24,16,53
11435,11368,33,56,46,135
11435,11369,6,28,11,45
11435,11370,9,10,8,27
11435,11371,0,2,0,2
11435,11372,17,22,16,55
11435,11373,33,32,28,93
11435,11374,6,18,32,56
11435,11375,20,43,44,107
11435,11377,19,37,32,88
11435,11378,9,11,21,41
11435,11379,13,12,21,46
11435,11385,12,48,48,108
11435,11411,12,31,28,71
11435,11412,24,54,54,132
11435,11413,23,35,54,112
11435,11414,6,5,7,18
11435,11415,8,20,13,41
11435,11416,19,26,16,61
11435,11417,16,25,14,55
11435,11418,39,50,29,118
11435,11419,23,75,29,127
11435,11420,22,48,47,117
11435,11421,17,33,38,88
11435,11422,13,34,36,83
11435,11423,35,41,33,109
11435,11426,7,2,15,24
11435,11427,19,26,31,76
11435,11428,13,21,31,65
11435,11429,14,33,23,70
11435,11430,0,1,0,1
11435,11432,60,132,65,257
11435,11433,26,76,37,139
11435,11434,46,70,60,176
11435,11435,191,268,128,587
11435,11436,21,37,16,74
11435,11691,19,24,30,73
11435,11692,7,10,7,24
11435,11693,7,9,11,27
11435,11694,1,5,18,24
11435,11697,1,2,1,4
11436,10009,0,0,1,1
11436,10011,0,1,0,1
11436,10013,0,0,1,1
11436,10019,0,0,1,1
11436,10021,0,0,1,1
11436,10023,0,0,1,1
11436,10026,2,0,1,3
11436,10027,0,1,1,2
11436,10029,0,2,1,3
11436,10030,1,0,0,1
11436,10031,0,1,0,1
11436,10032,0,2,0,2
11436,10033,1,0,2,3
11436,10034,0,0,2,2
11436,10035,1,0,0,1
11436,10037,0,0,1,1
11436,10304,0,2,1,3
11436,10305,0,1,1,2
11436,10306,0,1,1,2
11436,10307,0,0,1,1
11436,10308,0,0,1,1
11436,10310,1,0,2,3
11436,10312,0,1,0,1
11436,10314,0,0,2,2
11436,10451,0,1,2,3
11436,10452,0,0,2,2
11436,10455,1,1,0,2
11436,10456,1,1,0,2
11436,10457,1,2,0,3
11436,10458,0,0,2,2
11436,10459,0,2,2,4
11436,10460,0,1,2,3
11436,10461,1,0,0,1
11436,10462,2,2,1,5
11436,10463,0,2,2,4
11436,10465,2,2,0,4
11436,10467,1,1,2,4
11436,10469,0,1,2,3
11436,10470,1,0,0,1
11436,10472,4,2,5,11
11436,10473,2,0,1,3
11436,11001,0,1,1,2
11436,11004,1,1,5,7
11436,11005,0,0,1,1
11436,11101,1,1,1,3
11436,11102,0,1,0,1
11436,11103,0,2,1,3
11436,11104,0,3,0,3
11436,11105,0,0,1,1
11436,11106,0,3,0,3
11436,11201,0,0,2,2
11436,11203,2,4,3,9
11436,11204,1,1,0,2
11436,11205,0,1,0,1
11436,11206,0,1,2,3
11436,11207,2,18,4,24
11436,11208,8,10,8,26
11436,11209,1,0,3,4
11436,11210,0,4,3,7
11436,11211,0,3,1,4
11436,11212,1,3,5,9
11436,11213,1,1,6,8
11436,11214,0,7,3,10
11436,11215,0,1,1,2
11436,11216,2,2,3,7
11436,11217,1,0,3,4
11436,11218,1,2,1,4
11436,11219,0,1,1,2
11436,11220,1,1,1,3
11436,11221,0,4,0,4
11436,11222,0,1,0,1
11436,11223,0,0,1,1
11436,11224,1,0,0,1
11436,11225,0,1,2,3
11436,11226,2,2,3,7
11436,11229,1,0,5,6
11436,11230,0,0,2,2
11436,11231,0,0,1,1
11436,11232,0,0,1,1
11436,11233,1,2,5,8
11436,11234,1,5,4,10
11436,11236,5,16,10,31
11436,11237,0,0,3,3
11436,11238,2,1,3,6
11436,11239,2,0,1,3
11436,11354,1,2,6,9
11436,11355,6,3,2,11
11436,11356,0,0,7,7
11436,11357,0,0,1,1
11436,11358,4,5,3,12
11436,11359,0,1,0,1
11436,11360,1,1,2,4
11436,11361,4,0,5,9
11436,11362,0,1,5,6
11436,11364,2,8,2,12
11436,11365,0,2,0,2
11436,11366,1,2,0,3
11436,11367,2,1,3,6
11436,11368,4,10,12,26
11436,11369,0,1,3,4
11436,11370,0,1,1,2
11436,11372,1,3,3,7
11436,11373,5,6,5,16
11436,11374,2,5,3,10
11436,11375,2,5,4,11
11436,11377,1,6,0,7
11436,11378,1,4,5,10
11436,11379,0,3,5,8
11436,11385,2,6,4,12
11436,11411,0,5,4,9
11436,11412,0,6,3,9
11436,11413,5,6,13,24
11436,11414,1,0,3,4
11436,11415,1,2,1,4
11436,11416,3,2,4,9
11436,11417,3,8,4,15
11436,11418,7,11,3,21
11436,11419,7,22,17,46
11436,11420,7,28,16,51
11436,11421,6,7,4,17
11436,11422,0,2,6,8
11436,11423,3,10,7,20
11436,11426,1,1,5,7
11436,11427,3,3,6,12
11436,11428,4,2,3,9
11436,11429,1,7,3,11
11436,11430,1,0,0,1
11436,11432,4,13,9,26
11436,11433,5,16,3,24
11436,11434,10,17,16,43
11436,11435,13,28,8,49
11436,11436,35,50,13,98
11436,11691,1,5,5,11
11436,11692,0,9,1,10
11436,11693,0,0,1,1
11436,11694,1,0,3,4
11436,11697,0,0,1,1
11451,10002,1,0,0,1
11451,10010,1,0,0,1
11451,10013,1,1,0,2
11451,10022,1,0,0,1
11451,10023,1,0,1,2
11451,10025,1,0,0,1
11451,10027,0,0,1,1
11451,10029,1,0,1,2
11451,10032,2,0,1,3
11451,10034,2,0,0,2
11451,10035,1,0,0,1
11451,10036,0,1,0,1
11451,10037,1,0,0,1
11451,10301,1,0,0,1
11451,10303,2,0,0,2
11451,10304,1,0,0,1
11451,10305,2,0,1,3
11451,10314,3,0,0,3
11451,10451,3,1,0,4
11451,10453,1,0,0,1
11451,10454,1,0,0,1
11451,10456,0,2,0,2
11451,10457,3,0,0,3
11451,10458,1,0,0,1
11451,10460,1,0,0,1
11451,10461,1,0,0,1
11451,10462,1,0,1,2
11451,10466,4,0,0,4
11451,10467,2,0,1,3
11451,10468,0,2,0,2
11451,10469,3,1,1,5
11451,10472,1,0,1,2
11451,10473,3,0,0,3
11451,10474,1,0,0,1
11451,10475,1,0,0,1
11451,11001,2,0,0,2
11451,11101,1,0,0,1
11451,11102,0,1,0,1
11451,11104,0,0,1,1
11451,11203,2,0,0,2
11451,11204,2,0,0,2
11451,11205,1,0,0,1
11451,11206,1,1,2,4
11451,11207,3,0,2,5
11451,11208,2,1,0,3
11451,11210,3,0,0,3
11451,11211,0,1,0,1
11451,11212,4,0,0,4
11451,11213,2,0,0,2
11451,11215,1,0,0,1
11451,11218,0,0,1,1
11451,11219,0,0,1,1
11451,11220,3,1,0,4
11451,11221,0,0,1,1
11451,11222,0,0,1,1
11451,11224,1,0,1,2
11451,11226,1,0,0,1
11451,11228,0,1,1,2
11451,11229,1,0,0,1
11451,11230,1,0,1,2
11451,11231,0,0,1,1
11451,11234,4,0,1,5
11451,11236,4,1,0,5
11451,11237,1,0,0,1
11451,11238,1,0,0,1
11451,11354,2,0,0,2
11451,11355,6,0,0,6
11451,11358,2,0,0,2
11451,11361,1,1,0,2
11451,11365,1,0,1,2
11451,11367,1,0,1,2
11451,11369,2,0,0,2
11451,11372,4,0,0,4
11451,11375,3,0,0,3
11451,11377,1,0,0,1
11451,11378,1,0,1,2
11451,11379,1,0,0,1
11451,11385,5,0,0,5
11451,11411,0,2,0,2
11451,11412,4,0,0,4
11451,11413,2,0,1,3
11451,11416,2,0,0,2
11451,11417,1,0,0,1
11451,11419,1,0,1,2
11451,11421,1,0,0,1
11451,11422,1,0,1,2
11451,11423,1,1,0,2
11451,11428,1,0,0,1
11451,11429,0,0,1,1
11451,11432,4,0,0,4
11451,11433,1,1,0,2
11451,11434,2,1,1,4
11451,11435,3,0,0,3
11451,11436,3,0,0,3
11451,11691,2,0,0,2
11451,11694,1,1,0,2
11691,10001,0,1,0,1
11691,10002,4,1,5,10
11691,10003,2,3,7,12
11691,10005,1,1,0,2
11691,10009,3,6,8,17
11691,10010,0,1,1,2
11691,10011,0,2,4,6
11691,10013,2,1,2,5
11691,10014,1,0,4,5
11691,10016,0,2,5,7
11691,10017,0,0,1,1
11691,10018,1,0,0,1
11691,10019,0,1,6,7
11691,10021,0,0,1,1
11691,10022,0,2,3,5
11691,10023,0,0,6,6
11691,10024,0,0,1,1
11691,10025,1,7,4,12
11691,10026,3,4,0,7
11691,10027,2,5,5,12
11691,10028,0,1,0,1
11691,10029,3,12,4,19
11691,10030,2,3,1,6
11691,10031,2,5,4,11
11691,10032,1,7,7,15
11691,10033,2,2,7,11
11691,10034,1,6,3,10
11691,10035,3,5,2,10
11691,10036,0,2,0,2
11691,10037,0,1,1,2
11691,10038,1,1,2,4
11691,10039,2,5,4,11
11691,10040,0,0,7,7
11691,10044,0,0,1,1
11691,10065,1,0,1,2
11691,10075,0,1,2,3
11691,10128,0,0,3,3
11691,10301,6,6,7,19
11691,10302,1,0,5,6
11691,10303,0,2,5,7
11691,10304,4,4,12,20
11691,10305,2,3,9,14
11691,10306,4,7,14,25
11691,10307,0,1,6,7
11691,10308,0,2,8,10
11691,10309,0,5,14,19
11691,10310,1,4,5,10
11691,10312,1,7,20,28
11691,10314,2,6,27,35
11691,10451,1,6,1,8
11691,10452,3,11,4,18
11691,10453,2,9,7,18
11691,10454,1,4,2,7
11691,10455,0,4,6,10
11691,10456,10,19,11,40
11691,10457,7,12,3,22
11691,10458,7,11,4,22
11691,10459,1,5,3,9
11691,10460,2,7,6,15
11691,10461,1,4,10,15
11691,10462,4,10,11,25
11691,10463,2,10,8,20
11691,10464,0,0,1,1
11691,10465,1,1,6,8
11691,10466,6,10,6,22
11691,10467,9,14,9,32
11691,10468,6,12,5,23
11691,10469,2,10,14,26
11691,10470,3,2,4,9
11691,10471,0,4,3,7
11691,10472,3,2,7,12
11691,10473,2,8,8,18
11691,10474,1,1,0,2
11691,10475,0,5,9,14
11691,11001,2,1,5,8
11691,11004,3,7,11,21
11691,11005,0,1,0,1
11691,11040,2,4,8,14
11691,11101,2,1,6,9
11691,11102,1,6,1,8
11691,11103,1,4,3,8
11691,11104,3,0,6,9
11691,11105,2,5,6,13
11691,11106,2,0,9,11
11691,11109,0,1,5,6
11691,11201,6,3,8,17
11691,11203,9,34,17,60
11691,11204,7,12,15,34
11691,11205,3,6,10,19
11691,11206,4,17,11,32
11691,11207,22,46,37,105
11691,11208,43,105,40,188
11691,11209,9,5,11,25
11691,11210,17,33,42,92
11691,11211,5,9,11,25
11691,11212,17,36,21,74
11691,11213,5,10,17,32
11691,11214,7,15,17,39
11691,11215,0,2,11,13
11691,11216,9,12,21,42
11691,11217,2,2,5,9
11691,11218,11,11,18,40
11691,11219,10,13,26,49
11691,11220,10,7,12,29
11691,11221,5,18,23,46
11691,11222,1,5,3,9
11691,11223,6,13,15,34
11691,11224,8,16,10,34
11691,11225,9,12,16,37
11691,11226,14,35,35,84
11691,11228,6,8,10,24
11691,11229,9,15,34,58
11691,11230,18,28,40,86
11691,11231,0,4,4,8
11691,11232,1,2,2,5
11691,11233,7,23,9,39
11691,11234,19,46,64,129
11691,11235,6,15,25,46
11691,11236,20,84,67,171
11691,11237,1,8,6,15
11691,11238,5,19,11,35
11691,11239,5,9,8,22
11691,11354,3,4,13,20
11691,11355,5,12,21,38
11691,11356,3,7,8,18
11691,11357,1,4,6,11
11691,11358,2,3,6,11
11691,11360,3,0,3,6
11691,11361,1,3,7,11
11691,11362,2,1,5,8
11691,11363,0,0,2,2
11691,11364,6,10,16,32
11691,11365,5,16,22,43
11691,11366,4,5,11,20
11691,11367,4,18,33,55
11691,11368,13,16,8,37
11691,11369,2,17,3,22
11691,11370,1,8,4,13
11691,11372,5,16,9,30
11691,11373,13,25,13,51
11691,11374,5,6,7,18
11691,11375,5,14,21,40
11691,11377,7,10,16,33
11691,11378,3,2,14,19
11691,11379,4,5,11,20
11691,11385,9,26,18,53
11691,11411,13,49,33,95
11691,11412,19,58,55,132
11691,11413,28,67,36,131
11691,11414,4,16,18,38
11691,11415,8,6,18,32
11691,11416,14,31,15,60
11691,11417,16,36,26,78
11691,11418,8,46,15,69
11691,11419,28,57,35,120
11691,11420,19,77,41,137
11691,11421,19,20,22,61
11691,11422,31,64,56,151
11691,11423,15,28,27,70
11691,11426,20,14,11,45
11691,11427,10,19,14,43
11691,11428,15,18,12,45
11691,11429,13,33,22,68
11691,11432,22,46,34,102
11691,11433,10,35,31,76
11691,11434,25,106,101,232
11691,11435,10,59,24,93
11691,11436,10,16,14,40
11691,11691,447,1082,524,2053
11691,11692,59,162,79,300
11691,11693,15,85,50,150
11691,11694,24,49,58,131
11691,11697,2,4,22,28
11692,10002,1,0,0,1
11692,10003,0,0,1,1
11692,10009,1,1,0,2
11692,10014,1,0,0,1
11692,10019,0,0,1,1
11692,10021,1,0,4,5
11692,10024,0,0,1,1
11692,10025,0,0,1,1
11692,10026,1,1,1,3
11692,10027,1,1,0,2
11692,10028,0,0,2,2
11692,10029,0,1,1,2
11692,10030,0,1,1,2
11692,10031,0,3,0,3
11692,10033,0,1,0,1
11692,10035,0,3,2,5
11692,10036,0,0,1,1
11692,10065,0,0,1,1
11692,10075,0,0,1,1
11692,10128,1,0,3,4
11692,10301,2,0,1,3
11692,10302,1,0,0,1
11692,10303,1,0,0,1
11692,10305,0,1,1,2
11692,10306,3,0,5,8
11692,10307,0,0,1,1
11692,10308,0,0,1,1
11692,10309,0,0,2,2
11692,10310,0,1,0,1
11692,10312,0,0,1,1
11692,10314,3,0,4,7
11692,10451,1,0,1,2
11692,10452,0,1,1,2
11692,10453,1,0,2,3
11692,10454,0,1,0,1
11692,10455,0,1,1,2
11692,10456,0,1,1,2
11692,10457,0,3,1,4
11692,10458,0,2,1,3
11692,10459,0,2,0,2
11692,10460,1,0,0,1
11692,10461,0,0,1,1
11692,10462,1,1,1,3
11692,10463,1,1,1,3
11692,10464,1,0,0,1
11692,10465,0,1,1,2
11692,10468,1,0,2,3
11692,10469,0,1,0,1
11692,10470,0,0,1,1
11692,10471,0,0,1,1
11692,10475,0,2,0,2
11692,11004,1,0,0,1
11692,11005,0,1,0,1
11692,11101,0,0,2,2
11692,11102,1,1,3,5
11692,11103,0,0,1,1
11692,11105,0,2,0,2
11692,11201,3,1,0,4
11692,11203,2,8,16,26
11692,11204,2,0,1,3
11692,11205,0,2,0,2
11692,11206,2,6,2,10
11692,11207,4,10,4,18
11692,11208,6,22,16,44
11692,11209,0,1,2,3
11692,11210,2,4,11,17
11692,11211,2,3,2,7
11692,11212,5,10,4,19
11692,11213,1,7,3,11
11692,11214,0,2,2,4
11692,11215,0,0,3,3
11692,11216,0,4,5,9
11692,11217,2,1,4,7
11692,11218,4,5,5,14
11692,11219,0,1,0,1
11692,11220,2,4,0,6
11692,11221,1,3,1,5
11692,11222,0,0,1,1
11692,11223,3,2,2,7
11692,11224,3,4,2,9
11692,11225,2,8,5,15
11692,11226,5,10,15,30
11692,11228,0,2,0,2
11692,11229,2,10,13,25
11692,11230,5,4,4,13
11692,11231,0,0,3,3
11692,11232,0,0,1,1
11692,11233,4,8,6,18
11692,11234,7,12,17,36
11692,11235,1,3,9,13
11692,11236,2,15,31,48
11692,11237,1,1,1,3
11692,11238,0,3,2,5
11692,11239,2,2,2,6
11692,11354,0,1,2,3
11692,11355,1,2,4,7
11692,11356,0,5,1,6
11692,11357,0,1,1,2
11692,11358,0,1,0,1
11692,11361,0,0,1,1
11692,11365,2,4,4,10
11692,11366,0,1,2,3
11692,11367,1,1,3,5
11692,11368,0,6,5,11
11692,11369,0,2,1,3
11692,11372,2,1,1,4
11692,11373,0,1,5,6
11692,11374,0,2,2,4
11692,11375,1,0,1,2
11692,11377,2,1,3,6
11692,11378,0,2,1,3
11692,11379,0,5,2,7
11692,11385,1,5,9,15
11692,11411,3,6,5,14
11692,11412,7,17,8,32
11692,11413,2,15,21,38
11692,11414,0,1,0,1
11692,11415,1,2,2,5
11692,11416,6,4,2,12
11692,11417,3,10,5,18
11692,11418,0,2,3,5
11692,11419,0,3,7,10
11692,11420,4,13,5,22
11692,11421,1,5,8,14
11692,11422,2,14,15,31
11692,11423,3,3,2,8
11692,11426,2,1,6,9
11692,11427,1,0,5,6
11692,11428,0,0,2,2
11692,11429,0,4,7,11
11692,11430,0,1,0,1
11692,11432,4,1,3,8
11692,11433,3,4,5,12
11692,11434,6,16,15,37
11692,11435,3,12,9,24
11692,11436,2,7,8,17
11692,11451,0,0,1,1
11692,11691,37,104,62,203
11692,11692,42,91,44,177
11692,11693,9,29,14,52
11692,11694,10,19,15,44
11692,11697,0,0,7,7
11693,10001,0,0,1,1
11693,10002,0,1,1,2
11693,10003,0,1,2,3
11693,10009,2,1,1,4
11693,10011,1,1,0,2
11693,10016,1,1,1,3
11693,10019,0,1,3,4
11693,10021,0,0,2,2
11693,10022,0,1,1,2
11693,10024,1,0,1,2
11693,10025,1,2,3,6
11693,10026,1,1,4,6
11693,10027,0,0,4,4
11693,10029,1,0,1,2
11693,10030,0,0,1,1
11693,10031,0,1,2,3
11693,10032,0,0,3,3
11693,10033,0,5,1,6
11693,10034,1,3,0,4
11693,10035,0,0,2,2
11693,10036,0,1,0,1
11693,10037,0,1,0,1
11693,10038,0,0,1,1
11693,10039,2,0,0,2
11693,10040,3,0,2,5
11693,10044,0,0,1,1
11693,10075,0,0,1,1
11693,10128,0,0,4,4
11693,10301,3,2,1,6
11693,10302,3,0,1,4
11693,10303,0,1,4,5
11693,10304,1,0,4,5
11693,10305,0,1,8,9
11693,10306,2,3,4,9
11693,10307,0,0,4,4
11693,10308,0,0,3,3
11693,10309,1,1,6,8
11693,10310,0,2,2,4
11693,10312,0,4,10,14
11693,10314,2,3,10,15
11693,10451,1,2,0,3
11693,10452,3,1,0,4
11693,10453,4,4,3,11
11693,10454,0,1,0,1
11693,10455,1,1,1,3
11693,10456,2,2,1,5
11693,10457,2,3,0,5
11693,10458,1,1,4,6
11693,10459,1,0,1,2
11693,10460,0,1,1,2
11693,10461,1,1,4,6
11693,10462,2,2,4,8
11693,10463,1,2,2,5
11693,10464,0,0,1,1
11693,10465,0,3,4,7
11693,10466,0,2,1,3
11693,10467,0,3,1,4
11693,10468,3,2,4,9
11693,10469,2,2,2,6
11693,10470,0,0,2,2
11693,10471,1,0,0,1
11693,10472,3,3,4,10
11693,10473,2,3,2,7
11693,10475,1,3,3,7
11693,11001,0,1,1,2
11693,11004,0,0,5,5
11693,11005,1,0,0,1
11693,11101,0,0,2,2
11693,11102,2,0,1,3
11693,11103,0,1,2,3
11693,11104,0,0,1,1
11693,11105,1,1,1,3
11693,11201,1,1,4,6
11693,11203,6,6,11,23
11693,11204,1,0,5,6
11693,11205,2,0,6,8
11693,11206,4,3,3,10
11693,11207,6,20,15,41
11693,11208,9,26,21,56
11693,11209,3,2,5,10
11693,11210,2,3,5,10
11693,11211,3,5,2,10
11693,11212,4,6,17,27
11693,11213,3,2,4,9
11693,11214,2,2,5,9
11693,11215,0,0,2,2
11693,11216,3,1,4,8
11693,11217,1,1,0,2
11693,11218,1,2,6,9
11693,11219,2,4,2,8
11693,11220,1,5,3,9
11693,11221,2,1,6,9
11693,11222,0,0,2,2
11693,11223,3,9,8,20
11693,11224,2,2,7,11
11693,11225,2,8,2,12
11693,11226,5,6,13,24
11693,11228,0,0,4,4
11693,11229,4,17,18,39
11693,11230,3,2,6,11
11693,11231,0,1,3,4
11693,11232,0,3,1,4
11693,11233,4,4,2,10
11693,11234,5,13,24,42
11693,11235,3,4,10,17
11693,11236,10,12,19,41
11693,11237,3,6,2,11
11693,11238,2,2,1,5
11693,11239,2,1,1,4
11693,11354,2,2,3,7
11693,11355,3,4,3,10
11693,11356,1,0,1,2
11693,11357,1,1,4,6
11693,11358,0,1,3,4
11693,11360,1,0,2,3
11693,11361,0,0,5,5
11693,11362,2,3,1,6
11693,11364,3,0,3,6
11693,11365,6,4,4,14
11693,11366,0,1,0,1
11693,11367,4,2,7,13
11693,11368,1,10,5,16
11693,11369,0,3,1,4
11693,11370,1,1,3,5
11693,11372,0,2,5,7
11693,11373,1,5,3,9
11693,11374,1,4,4,9
11693,11375,1,5,6,12
11693,11377,1,1,7,9
11693,11378,0,8,10,18
11693,11379,0,3,11,14
11693,11385,5,11,21,37
11693,11411,12,3,7,22
11693,11412,5,7,9,21
11693,11413,7,11,9,27
11693,11414,5,8,11,24
11693,11415,1,3,5,9
11693,11416,4,7,15,26
11693,11417,5,11,6,22
11693,11418,2,7,9,18
11693,11419,3,9,4,16
11693,11420,3,20,5,28
11693,11421,9,13,13,35
11693,11422,2,6,12,20
11693,11423,2,2,3,7
11693,11426,1,0,3,4
11693,11427,2,2,6,10
11693,11428,1,3,5,9
11693,11429,7,8,10,25
11693,11430,1,0,0,1
11693,11432,2,5,5,12
11693,11433,5,5,7,17
11693,11434,4,10,12,26
11693,11435,5,8,7,20
11693,11436,1,1,4,6
11693,11691,54,95,15,164
11693,11692,35,37,16,88
11693,11693,51,68,33,152
11693,11694,36,34,25,95
11693,11697,3,5,1,9
11694,10001,0,1,0,1
11694,10002,3,0,3,6
11694,10005,0,1,0,1
11694,10009,0,0,2,2
11694,10011,0,1,0,1
11694,10012,1,0,0,1
11694,10013,1,0,2,3
11694,10014,1,0,1,2
11694,10018,0,0,1,1
11694,10019,0,1,1,2
11694,10022,0,0,2,2
11694,10024,0,0,1,1
11694,10025,0,0,2,2
11694,10026,1,1,1,3
11694,10027,0,1,0,1
11694,10028,0,0,3,3
11694,10029,0,2,0,2
11694,10030,1,1,0,2
11694,10031,2,0,0,2
11694,10032,1,1,0,2
11694,10033,3,0,2,5
11694,10034,0,1,0,1
11694,10036,0,0,3,3
11694,10038,0,0,1,1
11694,10040,1,0,2,3
11694,10044,0,0,2,2
11694,10065,1,0,0,1
11694,10075,0,0,3,3
11694,10280,1,0,1,2
11694,10282,0,0,1,1
11694,10301,2,3,2,7
11694,10302,0,1,0,1
11694,10303,0,1,1,2
11694,10304,1,6,0,7
11694,10305,1,1,7,9
11694,10306,1,2,6,9
11694,10307,0,1,6,7
11694,10308,0,2,6,8
11694,10309,1,1,5,7
11694,10310,1,2,3,6
11694,10312,1,2,3,6
11694,10314,2,8,11,21
11694,10451,1,4,0,5
11694,10452,2,1,0,3
11694,10453,3,6,0,9
11694,10454,0,1,0,1
11694,10455,0,1,1,2
11694,10456,3,5,5,13
11694,10457,1,1,3,5
11694,10458,2,1,2,5
11694,10459,0,1,0,1
11694,10460,2,1,2,5
11694,10461,1,1,5,7
11694,10462,0,2,1,3
11694,10463,3,2,5,10
11694,10465,0,2,2,4
11694,10466,0,1,1,2
11694,10467,1,5,1,7
11694,10468,1,0,2,3
11694,10469,3,1,3,7
11694,10471,0,1,1,2
11694,10472,1,0,2,3
11694,10473,2,0,1,3
11694,10475,1,0,1,2
11694,11004,1,1,2,4
11694,11040,1,0,1,2
11694,11101,1,0,1,2
11694,11102,2,3,3,8
11694,11103,1,1,2,4
11694,11104,1,1,0,2
11694,11105,0,0,1,1
11694,11106,1,4,0,5
11694,11109,1,1,0,2
11694,11201,0,1,2,3
11694,11203,6,18,15,39
11694,11204,0,6,6,12
11694,11205,1,1,2,4
11694,11206,1,8,4,13
11694,11207,11,25,8,44
11694,11208,11,32,19,62
11694,11209,2,5,2,9
11694,11210,9,24,21,54
11694,11211,0,1,4,5
11694,11212,14,16,9,39
11694,11213,1,6,5,12
11694,11214,6,8,6,20
11694,11215,1,3,4,8
11694,11216,2,4,1,7
11694,11217,1,1,3,5
11694,11218,6,5,4,15
11694,11219,2,7,5,14
11694,11220,2,4,3,9
11694,11221,4,6,4,14
11694,11222,0,1,4,5
11694,11223,8,10,14,32
11694,11224,3,6,7,16
11694,11225,3,7,2,12
11694,11226,11,28,20,59
11694,11228,2,4,8,14
11694,11229,5,3,22,30
11694,11230,4,13,16,33
11694,11231,0,2,2,4
11694,11232,3,2,0,5
11694,11233,4,9,11,24
11694,11234,10,23,37,70
11694,11235,4,7,14,25
11694,11236,8,20,34,62
11694,11237,0,2,2,4
11694,11238,6,3,2,11
11694,11239,0,2,3,5
11694,11354,4,2,4,10
11694,11355,11,9,3,23
11694,11356,4,1,3,8
11694,11357,3,1,5,9
11694,11358,5,2,1,8
11694,11360,2,1,2,5
11694,11361,0,3,3,6
11694,11362,0,0,3,3
11694,11363,0,0,1,1
11694,11364,0,2,2,4
11694,11365,4,1,4,9
11694,11366,0,1,1,2
11694,11367,3,2,3,8
11694,11368,4,4,3,11
11694,11369,1,1,2,4
11694,11370,2,0,4,6
11694,11372,0,1,4,5
11694,11373,4,7,2,13
11694,11374,1,2,3,6
11694,11375,0,5,9,14
11694,11377,4,3,6,13
11694,11378,2,5,2,9
11694,11379,0,2,4,6
11694,11385,3,9,11,23
11694,11411,3,3,5,11
11694,11412,5,8,8,21
11694,11413,7,11,12,30
11694,11414,6,7,9,22
11694,11415,1,2,3,6
11694,11416,4,6,8,18
11694,11417,5,16,9,30
11694,11418,3,4,7,14
11694,11419,9,15,2,26
11694,11420,5,8,9,22
11694,11421,2,6,12,20
11694,11422,3,10,12,25
11694,11423,4,7,3,14
11694,11426,3,2,3,8
11694,11427,2,1,4,7
11694,11428,4,2,5,11
11694,11429,7,9,5,21
11694,11432,2,3,9,14
11694,11433,5,7,9,21
11694,11434,9,26,11,46
11694,11435,7,7,2,16
11694,11436,2,7,10,19
11694,11691,44,82,33,159
11694,11692,13,36,14,63
11694,11693,41,44,34,119
11694,11694,167,167,91,425
11694,11697,7,9,17,33
11697,10016,0,0,1,1
11697,10024,0,0,1,1
11697,10025,0,0,1,1
11697,10301,0,0,2,2
11697,10302,0,0,1,1
11697,10303,0,2,0,2
11697,10305,1,0,0,1
11697,10306,0,0,1,1
11697,10307,1,0,0,1
11697,10309,1,0,2,3
11697,10312,0,0,5,5
11697,10314,3,1,1,5
11697,10452,1,0,1,2
11697,10458,0,0,3,3
11697,10462,0,0,1,1
11697,10466,1,0,0,1
11697,10468,0,1,0,1
11697,10469,0,1,2,3
11697,11203,1,1,2,4
11697,11204,1,3,3,7
11697,11206,0,1,1,2
11697,11208,0,2,1,3
11697,11209,2,0,4,6
11697,11210,1,2,3,6
11697,11211,0,0,2,2
11697,11212,0,0,5,5
11697,11213,0,0,2,2
11697,11214,0,1,2,3
11697,11215,2,1,1,4
11697,11218,1,1,2,4
11697,11219,1,1,2,4
11697,11220,0,0,3,3
11697,11221,0,0,1,1
11697,11223,0,1,2,3
11697,11224,0,4,4,8
11697,11225,0,0,1,1
11697,11226,1,1,2,4
11697,11228,0,6,0,6
11697,11229,1,4,4,9
11697,11230,0,3,1,4
11697,11233,0,2,2,4
11697,11234,1,7,5,13
11697,11235,0,1,3,4
11697,11236,1,2,0,3
11697,11238,0,0,2,2
11697,11358,0,0,1,1
11697,11360,0,0,1,1
11697,11365,0,0,2,2
11697,11368,0,0,1,1
11697,11369,0,0,1,1
11697,11372,0,0,1,1
11697,11374,0,1,1,2
11697,11378,0,1,0,1
11697,11379,0,2,0,2
11697,11385,0,2,0,2
11697,11411,0,0,1,1
11697,11413,0,0,3,3
11697,11414,1,1,0,2
11697,11416,0,1,0,1
11697,11417,0,0,1,1
11697,11419,0,1,0,1
11697,11420,0,1,4,5
11697,11422,0,0,3,3
11697,11428,0,0,1,1
11697,11432,0,0,3,3
11697,11433,1,0,0,1
11697,11435,0,0,1,1
11697,11691,1,1,3,5
11697,11692,0,1,0,1
11697,11693,2,6,4,12
11697,11694,11,26,13,50
11697,11697,32,37,42,111
